app_id,review_score,review_score_desc,total_positive,total_negative,total_reviews
10,9,Overwhelmingly Positive,19908,753,20661
20,8,Very Positive,1889,385,2274
30,8,Very Positive,1169,169,1338
40,8,Very Positive,548,131,679
50,9,Overwhelmingly Positive,4047,192,4239
60,8,Very Positive,1420,284,1704
70,9,Overwhelmingly Positive,18643,735,19378
80,8,Very Positive,3777,420,4197
100,8,Very Positive,293,22,315
130,8,Very Positive,2897,311,3208
220,9,Overwhelmingly Positive,34040,1123,35163
240,9,Overwhelmingly Positive,24541,1192,25733
280,6,Mostly Positive,2535,971,3506
300,8,Very Positive,3995,472,4467
320,8,Very Positive,2178,317,2495
340,8,Very Positive,2639,418,3057
360,6,Mostly Positive,684,230,914
380,8,Very Positive,4391,255,4646
400,9,Overwhelmingly Positive,30233,452,30685
420,9,Overwhelmingly Positive,7486,317,7803
440,8,Very Positive,5318,413,5731
500,8,Very Positive,8025,469,8494
550,9,Overwhelmingly Positive,85465,2697,88162
570,8,Very Positive,5506,653,6159
620,9,Overwhelmingly Positive,74754,861,75615
630,8,Very Positive,123,7,130
660,0,1 user reviews,1,0,1
730,8,Very Positive,815676,110706,926382
1002,6,Mostly Positive,18,5,23
1200,8,Very Positive,503,86,589
1230,8,Very Positive,53,9,62
1250,9,Overwhelmingly Positive,18679,710,19389
1256,7,Positive,21,3,24
1257,7,Positive,27,2,29
1280,8,Very Positive,549,58,607
1300,8,Very Positive,206,34,240
1313,8,Very Positive,56,14,70
1500,6,Mostly Positive,276,79,355
1510,8,Very Positive,997,105,1102
1520,8,Very Positive,1429,214,1643
1530,8,Very Positive,208,31,239
1600,6,Mostly Positive,118,44,162
1610,8,Very Positive,115,20,135
1630,6,Mostly Positive,192,53,245
1640,6,Mostly Positive,250,99,349
1670,5,Mixed,70,47,117
1690,5,Mixed,158,73,231
1700,8,Very Positive,376,74,450
1840,8,Very Positive,189,13,202
1900,5,Mixed,153,109,262
1930,5,Mixed,712,309,1021
2100,8,Very Positive,2303,230,2533
2130,0,5 user reviews,5,0,5
2200,9,Overwhelmingly Positive,1017,50,1067
2210,8,Very Positive,564,118,682
2270,8,Very Positive,1221,74,1295
2280,8,Very Positive,4454,246,4700
2290,8,Very Positive,452,78,530
2300,8,Very Positive,2200,168,2368
2310,9,Overwhelmingly Positive,2584,130,2714
2320,8,Very Positive,1181,103,1284
2330,8,Very Positive,60,14,74
2340,5,Mixed,38,38,76
2350,6,Mostly Positive,83,23,106
2360,8,Very Positive,220,31,251
2370,6,Mostly Positive,56,17,73
2390,8,Very Positive,356,24,380
2400,8,Very Positive,1514,266,1780
2420,5,Mixed,162,90,252
2450,6,Mostly Positive,330,118,448
2500,6,Mostly Positive,355,103,458
2520,5,Mixed,29,27,56
2525,0,2 user reviews,1,1,2
2540,5,Mixed,63,54,117
2545,0,2 user reviews,0,2,2
2550,0,2 user reviews,0,2,2
2570,2,Very Negative,7,71,78
2590,5,Mixed,221,155,376
2600,8,Very Positive,5672,300,5972
2610,8,Very Positive,531,73,604
2620,8,Very Positive,1197,71,1268
2630,8,Very Positive,1681,151,1832
2640,8,Very Positive,404,55,459
2690,0,1 user reviews,1,0,1
2700,8,Very Positive,2442,280,2722
2710,8,Very Positive,122,22,144
2720,7,Positive,13,1,14
2760,8,Very Positive,183,8,191
2780,6,Mostly Positive,82,33,115
2790,0,1 user reviews,1,0,1
2800,6,Mostly Positive,107,31,138
2810,5,Mixed,132,66,198
2820,8,Very Positive,762,136,898
2840,5,Mixed,76,34,110
2850,6,Mostly Positive,21,9,30
2870,4,Mostly Negative,1195,2135,3330
2900,6,Mostly Positive,63,18,81
2910,8,Very Positive,125,27,152
2920,6,Mostly Positive,32,11,43
2930,0,1 user reviews,1,0,1
2990,8,Very Positive,1632,117,1749
3000,6,Mostly Positive,33,12,45
3010,6,Mostly Positive,87,26,113
3020,6,Mostly Positive,347,119,466
3050,6,Mostly Positive,51,15,66
3130,6,Mostly Positive,122,32,154
3150,0,2 user reviews,1,1,2
3160,0,3 user reviews,3,0,3
3170,8,Very Positive,205,27,232
3200,7,Positive,41,3,44
3220,5,Mixed,37,40,77
3230,4,Mostly Negative,20,62,82
3260,5,Mixed,129,104,233
3270,5,Mixed,123,61,184
3300,8,Very Positive,167,10,177
3310,8,Very Positive,242,19,261
3320,9,Overwhelmingly Positive,1504,50,1554
3322,0,1 user reviews,1,0,1
3330,8,Very Positive,370,39,409
3340,6,Mostly Positive,30,9,39
3350,8,Very Positive,64,11,75
3360,7,Positive,33,2,35
3370,7,Positive,37,3,40
3380,8,Very Positive,72,5,77
3390,8,Very Positive,266,11,277
3400,7,Positive,28,2,30
3410,6,Mostly Positive,66,27,93
3420,7,Positive,12,1,13
3430,8,Very Positive,53,2,55
3450,8,Very Positive,104,26,130
3460,0,9 user reviews,9,0,9
3470,8,Very Positive,69,3,72
3480,9,Overwhelmingly Positive,1308,48,1356
3490,7,Positive,11,2,13
3500,5,Mixed,9,4,13
3510,7,Positive,25,6,31
3520,6,Mostly Positive,13,4,17
3530,7,Positive,30,5,35
3540,8,Very Positive,379,23,402
3560,8,Very Positive,122,24,146
3570,6,Mostly Positive,8,3,11
3580,7,Positive,18,2,20
3590,9,Overwhelmingly Positive,11630,325,11955
3600,6,Mostly Positive,43,13,56
3610,7,Positive,12,2,14
3620,8,Very Positive,286,16,302
3630,7,Positive,31,3,34
3700,6,Mostly Positive,485,202,687
3710,8,Very Positive,464,64,528
3720,9,Overwhelmingly Positive,1795,85,1880
3730,8,Very Positive,1008,142,1150
3800,8,Very Positive,183,44,227
3810,6,Mostly Positive,206,77,283
3820,5,Mixed,122,72,194
3830,9,Overwhelmingly Positive,4314,163,4477
3838,0,3 user reviews,3,0,3
3839,0,3 user reviews,3,0,3
3900,8,Very Positive,973,73,1046
3910,8,Very Positive,1862,164,2026
3920,8,Very Positive,2345,138,2483
3960,5,Mixed,42,43,85
3970,0,4 user reviews,4,0,4
3980,6,Mostly Positive,187,73,260
3990,8,Very Positive,102,10,112
4000,9,Overwhelmingly Positive,256769,8925,265694
4100,5,Mixed,5,5,10
4230,7,Positive,29,4,33
4290,0,1 user reviews,1,0,1
4300,6,Mostly Positive,17,5,22
4320,0,4 user reviews,2,2,4
4420,5,Mixed,25,30,55
4460,5,Mixed,38,25,63
4470,5,Mixed,20,10,30
4500,8,Very Positive,5827,331,6158
4520,5,Mixed,66,30,96
4530,5,Mixed,48,24,72
4540,8,Very Positive,615,110,725
4550,8,Very Positive,873,66,939
4560,8,Very Positive,1911,135,2046
4570,9,Overwhelmingly Positive,2163,103,2266
4580,9,Overwhelmingly Positive,2257,82,2339
4700,9,Overwhelmingly Positive,8230,383,8613
4720,8,Very Positive,726,119,845
4720,8,Very Positive,726,120,846
4760,8,Very Positive,5778,345,6123
4770,5,Mixed,235,105,340
4780,8,Very Positive,414,14,428
4800,8,Very Positive,71,12,83
4830,7,Positive,35,0,35
4850,8,Very Positive,369,50,419
4856,0,1 user reviews,0,1,1
4870,8,Very Positive,50,12,62
4880,6,Mostly Positive,66,24,90
4890,5,Mixed,105,52,157
4900,8,Very Positive,64,8,72
4920,8,Very Positive,3913,640,4553
6000,8,Very Positive,5335,281,5616
6010,8,Very Positive,502,29,531
6020,9,Overwhelmingly Positive,4819,240,5059
6030,8,Very Positive,1650,165,1815
6040,8,Very Positive,449,44,493
6060,8,Very Positive,24929,1573,26502
6080,8,Very Positive,314,21,335
6090,8,Very Positive,104,7,111
6100,7,Positive,27,6,33
6120,8,Very Positive,482,85,567
6200,8,Very Positive,648,86,734
6210,6,Mostly Positive,58,23,81
6220,8,Very Positive,687,70,757
6250,8,Very Positive,275,68,343
6260,0,1 user reviews,1,0,1
6270,5,Mixed,31,43,74
6300,8,Very Positive,455,89,544
6310,8,Very Positive,863,80,943
6340,0,3 user reviews,3,0,3
6370,0,4 user reviews,4,0,4
6400,8,Very Positive,57,9,66
6420,8,Very Positive,358,56,414
6510,6,Mostly Positive,271,96,367
6550,5,Mixed,455,504,959
6570,5,Mixed,27,26,53
6600,5,Mixed,27,29,56
6800,8,Very Positive,629,88,717
6810,8,Very Positive,168,35,203
6830,8,Very Positive,544,126,670
6840,5,Mixed,129,120,249
6850,8,Very Positive,658,147,805
6860,8,Very Positive,3654,235,3889
6870,6,Mostly Positive,188,69,257
6880,5,Mixed,753,450,1203
6900,5,Mixed,574,313,887
6910,9,Overwhelmingly Positive,5622,267,5889
6920,5,Mixed,549,376,925
6980,8,Very Positive,856,176,1032
7000,8,Very Positive,845,127,972
7010,6,Mostly Positive,150,52,202
7020,8,Very Positive,157,9,166
7060,5,Mixed,7,4,11
7110,6,Mostly Positive,760,273,1033
7200,8,Very Positive,599,39,638
7210,5,Mixed,119,64,183
7220,5,Mixed,34,39,73
7260,5,Mixed,33,30,63
7340,0,9 user reviews,7,2,9
7500,7,Positive,24,0,24
7510,5,Mixed,254,232,486
7520,5,Mixed,934,868,1802
7530,4,Mostly Negative,37,58,95
7600,5,Mixed,721,337,1058
7610,8,Very Positive,395,95,490
7620,8,Very Positive,496,62,558
7650,8,Very Positive,299,23,322
7660,8,Very Positive,353,44,397
7670,8,Very Positive,9060,587,9647
7730,5,Mixed,36,32,68
7760,9,Overwhelmingly Positive,1666,55,1721
7770,5,Mixed,78,87,165
7800,7,Positive,25,2,27
7830,8,Very Positive,735,138,873
7840,5,Mixed,14,16,30
7850,8,Very Positive,91,5,96
7860,5,Mixed,234,101,335
7870,0,8 user reviews,8,0,8
7880,0,1 user reviews,1,0,1
7910,0,1 user reviews,1,0,1
7940,8,Very Positive,5268,494,5762
7980,0,2 user reviews,1,1,2
7990,0,2 user reviews,1,1,2
8000,8,Very Positive,1044,254,1298
8040,7,Positive,12,1,13
8060,7,Positive,35,7,42
8080,5,Mixed,427,304,731
8100,5,Mixed,45,57,102
8140,6,Mostly Positive,794,302,1096
8160,5,Mixed,15,12,27
8170,5,Mixed,639,362,1001
8190,8,Very Positive,14693,1234,15927
8200,8,Very Positive,216,26,242
8210,7,Positive,30,1,31
8220,7,Positive,22,2,24
8230,0,9 user reviews,9,0,9
8240,7,Positive,26,1,27
8250,7,Positive,22,0,22
8260,8,Very Positive,61,5,66
8270,7,Positive,18,4,22
8280,7,Positive,19,1,20
8290,7,Positive,23,0,23
8300,7,Positive,16,2,18
8310,5,Mixed,35,20,55
8320,5,Mixed,18,8,26
8330,5,Mixed,24,16,40
8340,8,Very Positive,176,10,186
8350,7,Positive,9,2,11
8360,0,8 user reviews,7,1,8
8370,0,8 user reviews,7,1,8
8380,0,7 user reviews,6,1,7
8400,8,Very Positive,490,47,537
8500,8,Very Positive,3572,751,4323
8600,8,Very Positive,362,38,400
8660,7,Positive,21,2,23
8690,0,4 user reviews,3,1,4
8790,8,Very Positive,89,6,95
8800,9,Overwhelmingly Positive,1291,48,1339
8840,0,3 user reviews,2,1,3
8850,8,Very Positive,3871,521,4392
8870,8,Very Positive,32559,2106,34665
8880,5,Mixed,159,103,262
8890,8,Very Positive,101,15,116
8930,9,Overwhelmingly Positive,59911,2500,62411
8970,5,Mixed,21,11,32
8980,8,Very Positive,9468,680,10148
8990,8,Very Positive,172,34,206
9000,8,Very Positive,177,28,205
9010,8,Very Positive,2028,187,2215
9030,8,Very Positive,124,12,136
9040,8,Very Positive,183,13,196
9050,8,Very Positive,2087,276,2363
9060,6,Mostly Positive,167,44,211
9070,8,Very Positive,255,40,295
9160,6,Mostly Positive,218,59,277
9180,8,Very Positive,704,46,750
9200,6,Mostly Positive,3714,1463,5177
9310,8,Very Positive,413,47,460
9340,8,Very Positive,268,31,299
9350,8,Very Positive,559,82,641
9400,0,5 user reviews,3,2,5
9420,9,Overwhelmingly Positive,2949,103,3052
9450,9,Overwhelmingly Positive,3533,182,3715
9460,5,Mixed,195,116,311
9480,6,Mostly Positive,3476,1040,4516
9500,5,Mixed,63,34,97
9710,5,Mixed,17,24,41
9730,4,Mostly Negative,35,62,97
9740,7,Positive,26,4,30
9760,6,Mostly Positive,92,25,117
9800,5,Mixed,170,73,243
9850,5,Mixed,25,21,46
9860,8,Very Positive,163,12,175
9870,8,Very Positive,955,65,1020
9880,5,Mixed,82,62,144
9900,6,Mostly Positive,460,161,621
9908,5,Mixed,20,10,30
9940,8,Very Positive,427,96,523
9960,5,Mixed,7,8,15
9970,4,Mostly Negative,4,15,19
9980,5,Mixed,29,14,43
9990,5,Mixed,27,40,67
10000,0,8 user reviews,8,0,8
10080,0,9 user reviews,9,0,9
10090,8,Very Positive,19096,1210,20306
10100,8,Very Positive,96,24,120
10110,8,Very Positive,119,27,146
10120,5,Mixed,10,15,25
10130,6,Mostly Positive,284,106,390
10140,5,Mixed,44,24,68
10150,6,Mostly Positive,1803,600,2403
10170,7,Positive,32,1,33
10180,8,Very Positive,8537,1002,9539
10190,8,Very Positive,1487,131,1618
10195,5,Mixed,26,18,44
10196,5,Mixed,15,19,34
10220,4,Mostly Negative,239,538,777
10230,4,Mostly Negative,19,47,66
10240,5,Mixed,9,6,15
10250,5,Mixed,10,13,23
10260,0,9 user reviews,4,5,9
10270,5,Mixed,108,100,208
10430,8,Very Positive,41,9,50
10460,5,Mixed,30,27,57
10500,8,Very Positive,5823,785,6608
10540,0,1 user reviews,1,0,1
10600,7,Positive,36,4,40
10604,7,Positive,32,8,40
10606,5,Mixed,36,26,62
10607,6,Mostly Positive,42,13,55
10608,7,Positive,16,1,17
10650,0,5 user reviews,3,2,5
10680,8,Very Positive,3894,550,4444
10690,0,2 user reviews,2,0,2
10695,5,Mixed,14,7,21
10697,6,Mostly Positive,12,4,16
11020,8,Very Positive,45,7,52
11040,5,Mixed,69,30,99
11050,5,Mixed,46,23,69
11060,0,1 user reviews,0,1,1
11130,2,Very Negative,9,58,67
11140,6,Mostly Positive,104,42,146
11150,5,Mixed,64,45,109
11170,7,Positive,14,3,17
11180,4,Mostly Negative,29,66,95
11190,6,Mostly Positive,173,63,236
11200,5,Mixed,134,90,224
11230,5,Mixed,78,39,117
11240,5,Mixed,173,147,320
11250,0,6 user reviews,4,2,6
11260,5,Mixed,38,43,81
11280,8,Very Positive,381,36,417
11330,8,Very Positive,223,51,274
11340,6,Mostly Positive,170,56,226
11360,6,Mostly Positive,149,58,207
11370,5,Mixed,68,58,126
11390,5,Mixed,204,173,377
11420,8,Very Positive,140,13,153
11440,7,Positive,26,2,28
11450,8,Very Positive,1313,130,1443
11480,6,Mostly Positive,121,31,152
11500,0,2 user reviews,1,1,2
11550,7,Positive,15,0,15
11560,5,Mixed,23,16,39
11590,5,Mixed,69,100,169
11610,5,Mixed,12,15,27
11900,6,Mostly Positive,33,9,42
11920,6,Mostly Positive,9,3,12
12100,8,Very Positive,2234,409,2643
12110,8,Very Positive,4543,541,5084
12120,8,Very Positive,12482,1752,14234
12130,5,Mixed,490,261,751
12140,8,Very Positive,2688,343,3031
12150,8,Very Positive,1686,118,1804
12170,6,Mostly Positive,94,27,121
12180,8,Very Positive,78,11,89
12190,0,3 user reviews,3,0,3
12200,6,Mostly Positive,4701,1179,5880
12210,5,Mixed,15294,8454,23748
12240,8,Very Positive,4544,541,5085
12250,7,Positive,37,1,38
12310,6,Mostly Positive,34,12,46
12320,6,Mostly Positive,550,173,723
12330,8,Very Positive,201,48,249
12340,5,Mixed,28,17,45
12360,8,Very Positive,697,171,868
12370,7,Positive,27,4,31
12380,0,1 user reviews,1,0,1
12390,5,Mixed,34,31,65
12420,3,Negative,5,25,30
12430,4,Mostly Negative,13,52,65
12440,5,Mixed,10,13,23
12450,5,Mixed,9,7,16
12460,5,Mixed,41,32,73
12470,5,Mixed,107,52,159
12480,5,Mixed,32,41,73
12500,8,Very Positive,410,62,472
12510,2,Very Negative,15,81,96
12520,6,Mostly Positive,157,54,211
12530,6,Mostly Positive,19,5,24
12540,7,Positive,9,1,10
12550,5,Mixed,4,6,10
12560,5,Mixed,11,16,27
12570,0,5 user reviews,4,1,5
12580,0,2 user reviews,1,1,2
12590,5,Mixed,20,12,32
12600,3,Negative,3,18,21
12630,0,7 user reviews,4,3,7
12640,6,Mostly Positive,114,36,150
12650,0,2 user reviews,0,2,2
12660,0,4 user reviews,3,1,4
12670,0,5 user reviews,2,3,5
12690,6,Mostly Positive,80,21,101
12710,8,Very Positive,471,39,510
12750,8,Very Positive,964,151,1115
12770,6,Mostly Positive,87,34,121
12790,5,Mixed,51,55,106
12800,8,Very Positive,75,6,81
12810,8,Very Positive,946,193,1139
12830,5,Mixed,364,225,589
12840,8,Very Positive,244,13,257
12860,0,2 user reviews,2,0,2
12900,9,Overwhelmingly Positive,5176,235,5411
13000,7,Positive,34,3,37
13140,0,7 user reviews,3,4,7
13200,5,Mixed,131,65,196
13210,8,Very Positive,926,148,1074
13230,9,Overwhelmingly Positive,1574,44,1618
13240,9,Overwhelmingly Positive,1570,46,1616
13250,8,Very Positive,579,36,615
13500,8,Very Positive,404,90,494
13510,5,Mixed,51,29,80
13520,6,Mostly Positive,1653,465,2118
13530,6,Mostly Positive,234,89,323
13540,6,Mostly Positive,259,81,340
13560,8,Very Positive,727,110,837
13570,8,Very Positive,1547,124,1671
13580,4,Mostly Negative,182,370,552
13600,8,Very Positive,627,116,743
13620,7,Positive,35,2,37
13630,7,Positive,36,4,40
13640,5,Mixed,29,31,60
13700,7,Positive,10,2,12
15000,5,Mixed,64,60,124
15060,0,2 user reviews,2,0,2
15080,6,Mostly Positive,175,46,221
15100,8,Very Positive,3124,756,3880
15120,8,Very Positive,1840,296,2136
15130,8,Very Positive,1045,190,1235
15140,0,4 user reviews,1,3,4
15150,7,Positive,37,8,45
15160,5,Mixed,34,16,50
15170,8,Very Positive,557,110,667
15190,8,Very Positive,421,79,500
15200,6,Mostly Positive,258,105,363
15210,8,Very Positive,660,118,778
15220,5,Mixed,10,12,22
15240,8,Very Positive,84,14,98
15260,0,2 user reviews,2,0,2
15270,8,Very Positive,167,35,202
15290,0,2 user reviews,1,1,2
15300,8,Very Positive,499,27,526
15310,6,Mostly Positive,55,22,77
15320,8,Very Positive,970,110,1080
15350,0,5 user reviews,3,2,5
15370,8,Very Positive,368,33,401
15380,8,Very Positive,44,10,54
15390,8,Very Positive,572,72,644
15400,6,Mostly Positive,61,17,78
15500,6,Mostly Positive,284,91,375
15520,8,Very Positive,424,84,508
15522,0,4 user reviews,2,2,4
15540,4,Mostly Negative,111,289,400
15560,8,Very Positive,309,52,361
15620,8,Very Positive,2095,327,2422
15700,8,Very Positive,883,86,969
15710,9,Overwhelmingly Positive,547,22,569
15740,6,Mostly Positive,387,120,507
15750,8,Very Positive,650,103,753
15800,0,2 user reviews,1,1,2
15900,6,Mostly Positive,12,4,16
15910,0,8 user reviews,6,2,8
15920,3,Negative,2,10,12
15930,7,Positive,21,2,23
15940,0,2 user reviews,2,0,2
15960,5,Mixed,8,5,13
15970,5,Mixed,13,8,21
15990,0,5 user reviews,5,0,5
16000,0,5 user reviews,2,3,5
16020,0,7 user reviews,5,2,7
16030,7,Positive,10,1,11
16040,5,Mixed,8,5,13
16060,5,Mixed,7,6,13
16100,7,Positive,30,7,37
16110,7,Positive,19,2,21
16120,8,Very Positive,52,5,57
16130,7,Positive,36,5,41
16180,7,Positive,41,8,49
16200,6,Mostly Positive,20,6,26
16300,8,Very Positive,80,7,87
16450,8,Very Positive,1114,243,1357
16465,5,Mixed,45,22,67
16500,0,8 user reviews,6,2,8
16600,8,Very Positive,116,28,144
16620,5,Mixed,18,12,30
16700,8,Very Positive,90,5,95
16710,6,Mostly Positive,115,49,164
16720,5,Mixed,471,363,834
16730,5,Mixed,503,440,943
16810,8,Very Positive,343,60,403
16860,5,Mixed,13,10,23
16861,5,Mixed,15,7,22
16862,5,Mixed,15,11,26
16863,6,Mostly Positive,14,4,18
16866,7,Positive,21,5,26
16867,7,Positive,29,6,35
16868,8,Very Positive,48,5,53
16870,8,Very Positive,157,19,176
16900,8,Very Positive,1002,167,1169
17020,6,Mostly Positive,207,66,273
17080,5,Mixed,24,17,41
17095,7,Positive,11,0,11
17097,5,Mixed,6,9,15
17100,8,Very Positive,164,34,198
17120,8,Very Positive,54,12,66
17140,6,Mostly Positive,86,28,114
17180,7,Positive,16,4,20
17300,8,Very Positive,3385,826,4211
17330,8,Very Positive,803,163,966
17340,0,7 user reviews,7,0,7
17390,8,Very Positive,12620,1513,14133
17400,0,1 user reviews,1,0,1
17410,8,Very Positive,8587,1349,9936
17420,0,5 user reviews,4,1,5
17430,5,Mixed,1247,577,1824
17440,8,Very Positive,411,72,483
17450,8,Very Positive,2257,205,2462
17460,8,Very Positive,7709,466,8175
17470,8,Very Positive,5040,646,5686
17480,8,Very Positive,2177,532,2709
17500,7,Positive,23,3,26
17510,7,Positive,12,2,14
17520,7,Positive,36,3,39
17530,0,1 user reviews,1,0,1
17550,0,4 user reviews,4,0,4
17570,8,Very Positive,50,3,53
17580,0,1 user reviews,1,0,1
17700,6,Mostly Positive,10,3,13
17710,6,Mostly Positive,680,189,869
17730,0,1 user reviews,1,0,1
17740,6,Mostly Positive,11,3,14
18000,8,Very Positive,249,22,271
18020,8,Very Positive,85,14,99
18040,8,Very Positive,261,17,278
18050,8,Very Positive,62,10,72
18070,6,Mostly Positive,66,21,87
18080,0,3 user reviews,3,0,3
18110,8,Very Positive,213,26,239
18120,6,Mostly Positive,90,30,120
18300,6,Mostly Positive,166,53,219
18400,5,Mixed,35,26,61
18407,0,4 user reviews,2,2,4
18408,0,2 user reviews,1,1,2
18420,7,Positive,33,6,39
18450,0,2 user reviews,2,0,2
18460,0,2 user reviews,2,0,2
18470,5,Mixed,19,9,28
18480,5,Mixed,12,8,20
18490,7,Positive,38,7,45
18500,9,Overwhelmingly Positive,2441,76,2517
18508,0,4 user reviews,4,0,4
18509,0,1 user reviews,1,0,1
18520,0,2 user reviews,1,1,2
18521,0,1 user reviews,1,0,1
18522,7,Positive,21,1,22
18523,0,7 user reviews,7,0,7
18600,7,Positive,8,2,10
18700,6,Mostly Positive,122,47,169
18820,8,Very Positive,135,33,168
19000,5,Mixed,200,225,425
19020,5,Mixed,8,5,13
19030,5,Mixed,47,21,68
19080,0,7 user reviews,1,6,7
19090,7,Positive,10,0,10
19200,6,Mostly Positive,135,52,187
19320,0,3 user reviews,2,1,3
19500,3,Negative,4,38,42
19680,8,Very Positive,3107,488,3595
19800,8,Very Positive,224,43,267
19810,7,Positive,18,3,21
19830,8,Very Positive,648,52,700
19900,6,Mostly Positive,3774,1105,4879
19930,6,Mostly Positive,88,33,121
19980,6,Mostly Positive,610,172,782
20200,0,7 user reviews,1,6,7
20500,8,Very Positive,3220,316,3536
20510,8,Very Positive,1856,408,2264
20530,8,Very Positive,851,128,979
20540,8,Very Positive,565,34,599
20550,5,Mixed,200,189,389
20570,8,Very Positive,551,61,612
20590,7,Positive,14,0,14
20700,8,Very Positive,47,11,58
20710,8,Very Positive,47,9,56
20820,8,Very Positive,344,14,358
20828,0,7 user reviews,7,0,7
20840,7,Positive,10,0,10
20900,8,Very Positive,14028,2509,16537
20902,0,1 user reviews,1,0,1
20920,8,Very Positive,15609,2185,17794
21000,8,Very Positive,831,183,1014
21010,5,Mixed,100,59,159
21030,5,Mixed,35,19,54
21070,0,2 user reviews,1,1,2
21080,0,3 user reviews,2,1,3
21090,8,Very Positive,3366,211,3577
21100,5,Mixed,1101,648,1749
21110,8,Very Positive,94,15,109
21120,8,Very Positive,56,8,64
21130,6,Mostly Positive,1017,275,1292
21140,0,2 user reviews,2,0,2
21170,8,Very Positive,129,19,148
21200,0,3 user reviews,3,0,3
21201,0,1 user reviews,1,0,1
21204,0,1 user reviews,1,0,1
21209,0,1 user reviews,1,0,1
21210,0,1 user reviews,1,0,1
21212,0,1 user reviews,1,0,1
21213,0,1 user reviews,1,0,1
21214,0,1 user reviews,1,0,1
21215,0,1 user reviews,1,0,1
21222,0,1 user reviews,1,0,1
21300,7,Positive,17,4,21
21400,0,3 user reviews,2,1,3
21500,0,6 user reviews,3,3,6
21600,4,Mostly Negative,51,94,145
21610,0,2 user reviews,2,0,2
21620,0,1 user reviews,0,1,1
21640,6,Mostly Positive,45,14,59
21660,5,Mixed,182,87,269
21670,6,Mostly Positive,303,117,420
21680,6,Mostly Positive,266,101,367
21690,8,Very Positive,3817,756,4573
21730,5,Mixed,7,4,11
21750,0,1 user reviews,1,0,1
21760,6,Mostly Positive,286,105,391
21780,8,Very Positive,227,35,262
21800,6,Mostly Positive,231,71,302
21900,6,Mostly Positive,79,28,107
21910,8,Very Positive,294,50,344
21920,0,1 user reviews,1,0,1
21950,0,1 user reviews,1,0,1
21970,8,Very Positive,787,75,862
21980,6,Mostly Positive,625,159,784
21990,0,1 user reviews,1,0,1
21995,0,5 user reviews,4,1,5
21996,7,Positive,9,2,11
22000,8,Very Positive,1573,136,1709
22100,8,Very Positive,1482,137,1619
22120,8,Very Positive,942,64,1006
22130,8,Very Positive,153,34,187
22140,5,Mixed,167,162,329
22180,8,Very Positive,1061,134,1195
22200,8,Very Positive,987,136,1123
22230,8,Very Positive,1350,113,1463
22300,6,Mostly Positive,4970,1476,6446
22310,6,Mostly Positive,334,127,461
22320,9,Overwhelmingly Positive,8513,435,8948
22330,9,Overwhelmingly Positive,14815,669,15484
22340,5,Mixed,750,424,1174
22350,5,Mixed,748,589,1337
22361,0,6 user reviews,5,1,6
22363,0,7 user reviews,7,0,7
22364,0,7 user reviews,7,0,7
22370,6,Mostly Positive,12097,3423,15520
22380,9,Overwhelmingly Positive,63997,2416,66413
22400,7,Positive,31,5,36
22410,8,Very Positive,54,13,67
22420,7,Positive,24,3,27
22430,6,Mostly Positive,24,10,34
22440,7,Positive,28,6,34
22450,5,Mixed,261,114,375
22470,8,Very Positive,279,45,324
22490,6,Mostly Positive,618,261,879
22500,8,Very Positive,96,15,111
22510,0,1 user reviews,0,1,1
22520,0,1 user reviews,0,1,1
22521,0,1 user reviews,1,0,1
22600,8,Very Positive,1043,223,1266
22610,6,Mostly Positive,241,82,323
22630,0,5 user reviews,4,1,5
22631,0,6 user reviews,4,2,6
22632,0,6 user reviews,5,1,6
22633,0,5 user reviews,4,1,5
22634,0,4 user reviews,4,0,4
22650,6,Mostly Positive,80,30,110
22670,5,Mixed,74,33,107
22803,0,1 user reviews,1,0,1
22813,0,1 user reviews,1,0,1
22815,0,1 user reviews,1,0,1
22821,0,1 user reviews,1,0,1
22845,0,1 user reviews,1,0,1
23100,0,3 user reviews,2,1,3
23120,8,Very Positive,68,14,82
23130,0,3 user reviews,3,0,3
23140,7,Positive,14,1,15
23150,6,Mostly Positive,7,3,10
23200,5,Mixed,36,20,56
23300,6,Mostly Positive,31,10,41
23310,6,Mostly Positive,1268,333,1601
23380,5,Mixed,70,41,111
23390,0,9 user reviews,8,1,9
23400,8,Very Positive,81,20,101
23420,5,Mixed,77,45,122
23450,6,Mostly Positive,204,72,276
23460,6,Mostly Positive,54,15,69
23490,8,Very Positive,329,37,366
23500,5,Mixed,89,115,204
23510,0,4 user reviews,4,0,4
23530,8,Very Positive,457,60,517
23600,8,Very Positive,48,10,58
23700,5,Mixed,45,27,72
24010,5,Mixed,4800,2337,7137
24012,4,Mostly Negative,5,10,15
24021,8,Very Positive,45,6,51
24028,0,4 user reviews,1,3,4
24029,6,Mostly Positive,9,3,12
24036,5,Mixed,8,9,17
24055,5,Mixed,7,4,11
24065,5,Mixed,11,16,27
24070,0,4 user reviews,3,1,4
24075,0,9 user reviews,8,1,9
24081,0,1 user reviews,1,0,1
24082,6,Mostly Positive,11,4,15
24083,5,Mixed,34,22,56
24095,7,Positive,19,4,23
24096,7,Positive,21,5,26
24110,0,1 user reviews,1,0,1
24120,0,1 user reviews,1,0,1
24150,0,3 user reviews,3,0,3
24170,0,7 user reviews,6,1,7
24200,5,Mixed,72,39,111
24220,0,2 user reviews,1,1,2
24240,8,Very Positive,6624,582,7206
24400,5,Mixed,176,82,258
24410,5,Mixed,8,8,16
24420,8,Very Positive,320,36,356
24440,0,3 user reviews,1,2,3
24441,0,2 user reviews,1,1,2
24447,0,3 user reviews,2,1,3
24449,0,5 user reviews,2,3,5
24460,4,Mostly Negative,6,11,17
24470,5,Mixed,20,10,30
24480,5,Mixed,95,84,179
24488,0,7 user reviews,6,1,7
24500,6,Mostly Positive,26,10,36
24600,0,1 user reviews,1,0,1
24630,0,1 user reviews,1,0,1
24640,0,8 user reviews,3,5,8
24650,5,Mixed,10,6,16
24660,5,Mixed,7,4,11
24670,5,Mixed,346,149,495
24676,0,1 user reviews,1,0,1
24677,0,1 user reviews,1,0,1
24679,0,1 user reviews,0,1,1
24700,0,1 user reviews,1,0,1
24720,8,Very Positive,1482,217,1699
24780,6,Mostly Positive,2379,684,3063
24790,8,Very Positive,1588,219,1807
24800,8,Very Positive,534,94,628
24810,8,Very Positive,844,50,894
24840,6,Mostly Positive,998,266,1264
24850,0,1 user reviews,1,0,1
24860,8,Very Positive,846,84,930
24870,5,Mixed,438,220,658
24960,8,Very Positive,9245,1492,10737
24963,8,Very Positive,60,12,72
24980,8,Very Positive,7294,457,7751
25000,6,Mostly Positive,2210,592,2802
25010,8,Very Positive,141,20,161
25500,5,Mixed,32,45,77
25600,8,Very Positive,73,14,87
25620,7,Positive,38,7,45
25700,8,Very Positive,111,18,129
25758,0,1 user reviews,1,0,1
25759,0,1 user reviews,1,0,1
25800,8,Very Positive,677,99,776
25806,7,Positive,13,1,14
25808,7,Positive,16,0,16
25809,0,2 user reviews,1,1,2
25810,0,2 user reviews,1,1,2
25811,0,3 user reviews,2,1,3
25812,0,5 user reviews,2,3,5
25813,0,5 user reviews,2,3,5
25814,0,3 user reviews,2,1,3
25815,0,2 user reviews,1,1,2
25816,0,2 user reviews,2,0,2
25817,0,2 user reviews,1,1,2
25830,8,Very Positive,679,63,742
25840,0,2 user reviews,2,0,2
25850,6,Mostly Positive,39,13,52
25860,0,2 user reviews,1,1,2
25890,6,Mostly Positive,1817,516,2333
25892,0,4 user reviews,1,3,4
25896,0,4 user reviews,1,3,4
25897,0,4 user reviews,1,3,4
25898,0,2 user reviews,1,1,2
25899,0,4 user reviews,2,2,4
25900,8,Very Positive,502,70,572
25910,8,Very Positive,101,23,124
25920,0,3 user reviews,3,0,3
25930,5,Mixed,41,28,69
25940,0,1 user reviews,1,0,1
25960,0,2 user reviews,0,2,2
25962,0,8 user reviews,5,3,8
25980,5,Mixed,236,138,374
25990,8,Very Positive,248,10,258
26000,8,Very Positive,96,18,114
26005,0,5 user reviews,3,2,5
26006,0,2 user reviews,2,0,2
26007,0,3 user reviews,3,0,3
26300,4,Mostly Negative,11,20,31
26500,8,Very Positive,166,21,187
26800,8,Very Positive,2421,196,2617
26803,0,2 user reviews,2,0,2
26900,8,Very Positive,91,10,101
27000,6,Mostly Positive,301,109,410
27020,5,Mixed,101,87,188
27050,5,Mixed,33,34,67
27200,0,9 user reviews,7,2,9
27220,0,5 user reviews,5,0,5
27300,7,Positive,13,3,16
27400,6,Mostly Positive,65,22,87
27800,6,Mostly Positive,34,11,45
27810,8,Very Positive,44,8,52
27900,4,Mostly Negative,39,67,106
27920,5,Mixed,39,44,83
27940,4,Mostly Negative,64,132,196
28000,5,Mixed,892,577,1469
28010,0,7 user reviews,6,1,7
28011,0,7 user reviews,6,1,7
28012,0,7 user reviews,5,2,7
28050,9,Overwhelmingly Positive,2822,22,2844
28060,0,3 user reviews,3,0,3
28061,0,4 user reviews,4,0,4
29120,0,5 user reviews,5,0,5
29130,8,Very Positive,57,6,63
29160,5,Mixed,58,25,83
29180,8,Very Positive,248,34,282
29540,0,5 user reviews,5,0,5
29570,7,Positive,28,1,29
29600,0,5 user reviews,5,0,5
29620,7,Positive,28,1,29
29640,7,Positive,9,2,11
29650,0,1 user reviews,0,1,1
29680,0,6 user reviews,6,0,6
29700,0,1 user reviews,1,0,1
29720,8,Very Positive,152,3,155
29800,6,Mostly Positive,994,282,1276
29900,8,Very Positive,125,27,152
31100,0,9 user reviews,8,1,9
31110,0,2 user reviews,2,0,2
31120,0,2 user reviews,2,0,2
31130,0,2 user reviews,2,0,2
31170,8,Very Positive,243,34,277
31180,7,Positive,19,3,22
31190,7,Positive,21,2,23
31200,6,Mostly Positive,17,5,22
31210,7,Positive,24,3,27
31220,8,Very Positive,158,12,170
31230,7,Positive,14,2,16
31240,7,Positive,12,1,13
31250,7,Positive,12,1,13
31260,7,Positive,14,1,15
31270,8,Very Positive,738,111,849
31280,8,Very Positive,3767,566,4333
31290,8,Very Positive,692,83,775
31300,3,Negative,4,17,21
31410,8,Very Positive,201,7,208
31420,0,3 user reviews,3,0,3
31500,0,1 user reviews,1,0,1
31700,8,Very Positive,155,25,180
31800,6,Mostly Positive,26,10,36
31810,8,Very Positive,95,6,101
31820,8,Very Positive,56,7,63
31830,8,Very Positive,101,9,110
31840,8,Very Positive,66,7,73
31850,8,Very Positive,70,5,75
31860,8,Very Positive,48,6,54
31870,5,Mixed,14,8,22
31880,8,Very Positive,62,5,67
31890,8,Very Positive,47,7,54
31900,6,Mostly Positive,32,11,43
31910,6,Mostly Positive,47,12,59
31920,8,Very Positive,40,10,50
31930,6,Mostly Positive,45,19,64
32000,3,Negative,0,13,13
32110,7,Positive,13,1,14
32120,0,4 user reviews,2,2,4
32140,6,Mostly Positive,32,10,42
32150,8,Very Positive,256,4,260
32160,8,Very Positive,66,7,73
32200,6,Mostly Positive,49,18,67
32310,6,Mostly Positive,86,25,111
32330,8,Very Positive,345,67,412
32340,8,Very Positive,248,29,277
32350,5,Mixed,132,135,267
32360,9,Overwhelmingly Positive,1538,61,1599
32370,8,Very Positive,12234,1331,13565
32380,6,Mostly Positive,619,231,850
32390,5,Mixed,260,163,423
32400,8,Very Positive,1074,127,1201
32410,5,Mixed,18,9,27
32420,4,Mostly Negative,96,200,296
32430,5,Mixed,1676,822,2498
32440,9,Overwhelmingly Positive,5735,251,5986
32450,8,Very Positive,157,39,196
32460,8,Very Positive,769,52,821
32469,8,Very Positive,769,52,821
32470,9,Overwhelmingly Positive,11115,336,11451
32500,5,Mixed,1017,883,1900
32510,8,Very Positive,1187,112,1299
32610,5,Mixed,33,26,59
32620,8,Very Positive,153,21,174
32630,8,Very Positive,122,19,141
32640,8,Very Positive,74,9,83
32650,5,Mixed,32,16,48
32660,7,Positive,26,6,32
32670,8,Very Positive,143,12,155
32680,8,Very Positive,116,16,132
32690,0,7 user reviews,5,2,7
32700,0,4 user reviews,3,1,4
32710,5,Mixed,16,13,29
32720,6,Mostly Positive,26,9,35
32730,5,Mixed,30,25,55
32740,6,Mostly Positive,20,8,28
32750,8,Very Positive,79,10,89
32760,8,Very Positive,107,11,118
32770,8,Very Positive,104,9,113
32800,6,Mostly Positive,996,338,1334
32900,6,Mostly Positive,81,26,107
33100,8,Very Positive,190,26,216
33110,6,Mostly Positive,48,20,68
33120,8,Very Positive,204,20,224
33130,8,Very Positive,115,19,134
33180,6,Mostly Positive,74,20,94
33220,5,Mixed,840,378,1218
33229,5,Mixed,840,378,1218
33230,8,Very Positive,6426,1254,7680
33260,5,Mixed,6,6,12
33280,7,Positive,14,0,14
33320,5,Mixed,322,142,464
33372,7,Positive,12,3,15
33390,6,Mostly Positive,10,3,13
33420,5,Mixed,55,65,120
33460,5,Mixed,953,608,1561
33520,8,Very Positive,263,34,297
33530,7,Positive,28,6,34
33540,4,Mostly Negative,4,10,14
33550,4,Mostly Negative,4,10,14
33570,6,Mostly Positive,200,60,260
33580,5,Mixed,45,21,66
33600,8,Very Positive,194,32,226
33610,5,Mixed,110,78,188
33620,8,Very Positive,118,21,139
33650,8,Very Positive,164,26,190
33660,5,Mixed,11,6,17
33670,5,Mixed,71,67,138
33680,8,Very Positive,639,64,703
33710,0,5 user reviews,4,1,5
33720,7,Positive,10,1,11
33730,6,Mostly Positive,41,13,54
33740,0,3 user reviews,3,0,3
33750,4,Mostly Negative,5,17,22
33760,0,5 user reviews,1,4,5
33770,8,Very Positive,92,23,115
33780,6,Mostly Positive,10,4,14
33790,0,9 user reviews,6,3,9
33900,8,Very Positive,1347,260,1607
33910,5,Mixed,68,47,115
33930,8,Very Positive,7720,594,8314
33934,6,Mostly Positive,49,16,65
33950,7,Positive,34,2,36
33980,5,Mixed,37,36,73
33990,5,Mixed,50,58,108
34000,0,1 user reviews,1,0,1
34010,8,Very Positive,1844,361,2205
34030,8,Very Positive,3874,421,4295
34050,0,1 user reviews,1,0,1
34174,7,Positive,20,1,21
34178,7,Positive,18,2,20
34179,7,Positive,31,3,34
34180,0,2 user reviews,1,1,2
34190,8,Very Positive,413,91,504
34220,7,Positive,32,0,32
34270,8,Very Positive,1891,339,2230
34272,0,6 user reviews,6,0,6
34273,0,4 user reviews,4,0,4
34274,0,2 user reviews,2,0,2
34275,0,3 user reviews,3,0,3
34276,0,4 user reviews,3,1,4
34277,0,2 user reviews,2,0,2
34278,0,6 user reviews,6,0,6
34279,0,3 user reviews,3,0,3
34280,0,4 user reviews,4,0,4
34281,0,3 user reviews,3,0,3
34282,0,4 user reviews,4,0,4
34283,0,2 user reviews,1,1,2
34284,0,3 user reviews,3,0,3
34285,0,3 user reviews,2,1,3
34286,0,5 user reviews,5,0,5
34287,0,3 user reviews,2,1,3
34288,0,2 user reviews,2,0,2
34289,0,5 user reviews,5,0,5
34310,0,2 user reviews,1,1,2
34311,0,2 user reviews,2,0,2
34312,0,2 user reviews,2,0,2
34313,0,5 user reviews,5,0,5
34314,0,2 user reviews,1,1,2
34315,0,2 user reviews,2,0,2
34316,0,2 user reviews,2,0,2
34317,0,3 user reviews,2,1,3
34318,0,2 user reviews,2,0,2
34319,0,2 user reviews,2,0,2
34330,8,Very Positive,11179,1031,12210
34342,7,Positive,20,2,22
34343,5,Mixed,25,13,38
34345,0,9 user reviews,7,2,9
34348,7,Positive,15,0,15
34410,8,Very Positive,99,23,122
34420,5,Mixed,14,17,31
34440,7,Positive,23,2,25
34450,0,5 user reviews,5,0,5
34460,7,Positive,25,0,25
34500,6,Mostly Positive,17,5,22
34600,5,Mixed,76,43,119
34630,0,9 user reviews,7,2,9
34640,7,Positive,15,1,16
34650,0,3 user reviews,3,0,3
34670,0,1 user reviews,1,0,1
34800,6,Mostly Positive,20,8,28
34810,6,Mostly Positive,48,13,61
34820,6,Mostly Positive,129,35,164
34830,5,Mixed,564,533,1097
34841,6,Mostly Positive,9,3,12
34842,7,Positive,16,0,16
34860,0,2 user reviews,2,0,2
34870,5,Mixed,1764,951,2715
34900,8,Very Positive,4012,993,5005
34910,0,3 user reviews,2,1,3
34920,2,Very Negative,12,56,68
35000,8,Very Positive,605,99,704
35010,0,3 user reviews,1,2,3
35030,6,Mostly Positive,21,8,29
35050,0,2 user reviews,2,0,2
35070,5,Mixed,46,27,73
35080,5,Mixed,26,14,40
35083,5,Mixed,19,14,33
35089,6,Mostly Positive,13,5,18
35090,7,Positive,21,4,25
35091,7,Positive,37,3,40
35101,7,Positive,36,9,45
35102,7,Positive,34,4,38
35110,0,1 user reviews,1,0,1
35130,8,Very Positive,1062,93,1155
35135,7,Positive,9,2,11
35136,7,Positive,8,2,10
35137,0,6 user reviews,3,3,6
35138,0,6 user reviews,3,3,6
35140,9,Overwhelmingly Positive,8198,373,8571
35300,5,Mixed,22,11,33
35310,7,Positive,26,5,31
35320,6,Mostly Positive,48,17,65
35417,7,Positive,12,1,13
35419,7,Positive,14,2,16
35420,5,Mixed,102,143,245
35425,7,Positive,12,1,13
35429,0,4 user reviews,3,1,4
35450,8,Very Positive,9713,602,10315
35460,6,Mostly Positive,338,105,443
35480,6,Mostly Positive,293,84,377
35500,5,Mixed,12,9,21
35510,5,Mixed,6,4,10
35600,5,Mixed,29,29,58
35700,8,Very Positive,3276,189,3465
35720,9,Overwhelmingly Positive,4695,231,4926
35725,7,Positive,9,1,10
35800,8,Very Positive,44,7,51
36000,5,Mixed,92,68,160
36100,8,Very Positive,52,1,53
36110,0,6 user reviews,6,0,6
36120,0,7 user reviews,7,0,7
36130,0,5 user reviews,4,1,5
36140,0,5 user reviews,3,2,5
36150,7,Positive,10,0,10
36160,0,2 user reviews,2,0,2
36170,0,1 user reviews,1,0,1
36180,5,Mixed,28,15,43
36190,0,3 user reviews,2,1,3
36200,0,2 user reviews,1,1,2
36210,6,Mostly Positive,11,3,14
36240,0,7 user reviews,6,1,7
36270,6,Mostly Positive,8,3,11
36280,0,2 user reviews,2,0,2
36290,0,1 user reviews,1,0,1
36300,6,Mostly Positive,14,4,18
36310,7,Positive,14,1,15
36320,0,5 user reviews,1,4,5
36700,6,Mostly Positive,12,4,16
36900,0,3 user reviews,0,3,3
36910,3,Negative,2,9,11
37000,8,Very Positive,364,79,443
37010,5,Mixed,51,43,94
37030,6,Mostly Positive,70,19,89
37100,6,Mostly Positive,45,19,64
37200,0,6 user reviews,5,1,6
37210,5,Mixed,51,35,86
37220,6,Mostly Positive,30,10,40
37230,0,7 user reviews,3,4,7
37240,4,Mostly Negative,28,71,99
37250,0,1 user reviews,1,0,1
37260,8,Very Positive,48,3,51
37270,7,Positive,17,1,18
37280,6,Mostly Positive,11,4,15
37290,0,6 user reviews,5,1,6
37300,5,Mixed,8,6,14
37310,4,Mostly Negative,4,9,13
37320,0,5 user reviews,2,3,5
37330,0,3 user reviews,3,0,3
37340,0,6 user reviews,5,1,6
37350,0,2 user reviews,2,0,2
37360,0,5 user reviews,3,2,5
37370,0,4 user reviews,3,1,4
37380,0,7 user reviews,3,4,7
37390,7,Positive,15,1,16
37400,8,Very Positive,308,44,352
37420,5,Mixed,7,4,11
37500,6,Mostly Positive,17,7,24
37600,8,Very Positive,372,34,406
37700,6,Mostly Positive,140,54,194
37800,5,Mixed,23,10,33
37900,0,2 user reviews,2,0,2
37920,0,1 user reviews,1,0,1
37940,0,1 user reviews,1,0,1
37960,7,Positive,18,3,21
37970,0,6 user reviews,6,0,6
37980,0,5 user reviews,5,0,5
37990,0,2 user reviews,2,0,2
38000,7,Positive,17,3,20
38020,0,3 user reviews,3,0,3
38050,0,1 user reviews,1,0,1
38060,0,3 user reviews,3,0,3
38070,0,7 user reviews,7,0,7
38080,7,Positive,16,1,17
38090,0,4 user reviews,4,0,4
38100,0,2 user reviews,2,0,2
38110,0,6 user reviews,4,2,6
38120,0,9 user reviews,8,1,9
38130,7,Positive,17,1,18
38140,0,5 user reviews,5,0,5
38150,0,3 user reviews,2,1,3
38160,0,1 user reviews,1,0,1
38170,7,Positive,13,1,14
38180,0,1 user reviews,1,0,1
38185,7,Positive,26,2,28
38190,0,5 user reviews,3,2,5
38200,0,1 user reviews,1,0,1
38210,6,Mostly Positive,98,29,127
38220,5,Mixed,40,20,60
38230,5,Mixed,38,50,88
38240,0,5 user reviews,3,2,5
38400,8,Very Positive,4062,279,4341
38410,8,Very Positive,3488,244,3732
38420,8,Very Positive,664,161,825
38430,6,Mostly Positive,134,37,171
38440,8,Very Positive,273,25,298
38450,6,Mostly Positive,97,28,125
38460,6,Mostly Positive,57,16,73
38480,4,Mostly Negative,23,40,63
38490,5,Mixed,24,17,41
38530,0,9 user reviews,9,0,9
38600,8,Very Positive,763,77,840
38700,8,Very Positive,578,92,670
38720,8,Very Positive,441,56,497
38740,8,Very Positive,687,61,748
38830,5,Mixed,10,10,20
38900,5,Mixed,41,42,83
38924,0,1 user reviews,1,0,1
39000,8,Very Positive,125,21,146
39110,6,Mostly Positive,96,26,122
39120,6,Mostly Positive,542,189,731
39140,8,Very Positive,8956,814,9770
39150,8,Very Positive,3023,496,3519
39160,5,Mixed,467,418,885
39190,6,Mostly Positive,911,290,1201
39200,5,Mixed,519,234,753
39210,8,Very Positive,16716,2265,18981
39250,7,Positive,24,2,26
39260,7,Positive,10,0,10
39270,7,Positive,21,1,22
39500,5,Mixed,739,364,1103
39510,8,Very Positive,962,203,1165
39520,5,Mixed,75,51,126
39530,8,Very Positive,261,43,304
39540,6,Mostly Positive,342,100,442
39550,5,Mixed,157,101,258
39560,4,Mostly Negative,34,80,114
39610,0,1 user reviews,1,0,1
39630,5,Mixed,64,28,92
39640,6,Mostly Positive,44,16,60
39650,5,Mixed,155,84,239
39660,5,Mixed,48,28,76
39670,6,Mostly Positive,266,104,370
39680,6,Mostly Positive,1028,274,1302
39690,5,Mixed,257,225,482
39710,0,7 user reviews,5,2,7
39800,8,Very Positive,980,105,1085
39900,5,Mixed,10,5,15
40000,7,Positive,12,0,12
40100,8,Very Positive,2560,453,3013
40135,8,Very Positive,130,9,139
40200,0,9 user reviews,6,3,9
40210,0,6 user reviews,6,0,6
40300,8,Very Positive,1090,251,1341
40320,7,Positive,37,6,43
40330,8,Very Positive,57,13,70
40340,6,Mostly Positive,30,12,42
40350,8,Very Positive,113,17,130
40370,0,3 user reviews,3,0,3
40380,6,Mostly Positive,243,73,316
40390,6,Mostly Positive,485,168,653
40391,0,8 user reviews,5,3,8
40392,0,8 user reviews,7,1,8
40393,0,7 user reviews,5,2,7
40400,8,Very Positive,678,98,776
40403,0,3 user reviews,3,0,3
40406,0,4 user reviews,3,1,4
40407,0,5 user reviews,5,0,5
40408,0,3 user reviews,3,0,3
40420,6,Mostly Positive,48,18,66
40500,4,Mostly Negative,5,9,14
40700,8,Very Positive,2077,120,2197
40703,0,9 user reviews,8,1,9
40720,8,Very Positive,241,53,294
40800,8,Very Positive,8970,540,9510
40920,0,4 user reviews,2,2,4
40930,8,Very Positive,204,31,235
40940,4,Mostly Negative,82,186,268
40950,8,Very Positive,1444,103,1547
40960,8,Very Positive,704,103,807
40970,9,Overwhelmingly Positive,2267,82,2349
40980,8,Very Positive,307,68,375
40990,8,Very Positive,930,140,1070
41000,8,Very Positive,1506,128,1634
41010,8,Very Positive,460,21,481
41014,8,Very Positive,57,7,64
41019,0,7 user reviews,4,3,7
41050,9,Overwhelmingly Positive,610,31,641
41060,8,Very Positive,255,18,273
41070,8,Very Positive,3998,594,4592
41074,6,Mostly Positive,54,16,70
41100,8,Very Positive,190,25,215
41210,8,Very Positive,333,25,358
41300,8,Very Positive,441,24,465
41400,4,Mostly Negative,5,12,17
41500,8,Very Positive,2289,190,2479
41600,5,Mixed,30,34,64
41660,0,7 user reviews,3,4,7
41680,0,7 user reviews,1,6,7
41700,9,Overwhelmingly Positive,5076,252,5328
41730,6,Mostly Positive,35,10,45
41740,8,Very Positive,127,27,154
41800,8,Very Positive,313,73,386
41802,0,1 user reviews,1,0,1
41803,0,1 user reviews,1,0,1
41804,0,1 user reviews,1,0,1
41814,0,1 user reviews,0,1,1
41816,0,2 user reviews,1,1,2
41817,0,1 user reviews,1,0,1
41900,6,Mostly Positive,353,103,456
42000,0,7 user reviews,4,3,7
42120,6,Mostly Positive,367,148,515
42140,5,Mixed,57,35,92
42160,5,Mixed,587,363,950
42170,5,Mixed,195,150,345
42200,6,Mostly Positive,31,8,39
42210,6,Mostly Positive,83,32,115
42220,8,Very Positive,75,11,86
42230,5,Mixed,35,16,51
42500,5,Mixed,86,54,140
42640,8,Very Positive,225,4,229
42670,8,Very Positive,1822,163,1985
42680,8,Very Positive,2752,560,3312
42690,0,2 user reviews,1,1,2
42695,0,8 user reviews,7,1,8
42696,7,Positive,10,0,10
42697,7,Positive,10,2,12
42698,0,5 user reviews,5,0,5
42700,8,Very Positive,4240,599,4839
42710,8,Very Positive,291,27,318
42716,7,Positive,31,7,38
42718,6,Mostly Positive,40,12,52
42719,8,Very Positive,135,18,153
42722,6,Mostly Positive,27,7,34
42730,7,Positive,16,1,17
42800,0,1 user reviews,0,1,1
42810,6,Mostly Positive,39,15,54
42820,0,2 user reviews,0,2,2
42850,8,Very Positive,121,23,144
42881,0,1 user reviews,1,0,1
42890,8,Very Positive,311,35,346
42900,0,1 user reviews,1,0,1
42902,0,1 user reviews,1,0,1
42903,0,4 user reviews,4,0,4
42904,0,9 user reviews,4,5,9
42905,0,1 user reviews,1,0,1
42910,8,Very Positive,6186,814,7000
42918,8,Very Positive,47,9,56
42920,4,Mostly Negative,21,33,54
42930,0,5 user reviews,4,1,5
42940,0,7 user reviews,5,2,7
42950,0,9 user reviews,8,1,9
42960,8,Very Positive,4595,392,4987
42964,7,Positive,13,2,15
42965,0,7 user reviews,6,1,7
42966,5,Mixed,6,4,10
42967,0,2 user reviews,2,0,2
42968,6,Mostly Positive,26,9,35
42980,6,Mostly Positive,60,23,83
42990,4,Mostly Negative,174,290,464
43000,5,Mixed,191,137,328
43005,0,2 user reviews,0,2,2
43006,0,2 user reviews,0,2,2
43011,0,1 user reviews,0,1,1
43013,0,2 user reviews,1,1,2
43014,0,2 user reviews,1,1,2
43100,6,Mostly Positive,69,20,89
43110,8,Very Positive,2736,207,2943
43160,8,Very Positive,3792,277,4069
43190,8,Very Positive,183,33,216
43500,4,Mostly Negative,24,49,73
43600,8,Very Positive,85,12,97
44100,8,Very Positive,53,10,63
44320,5,Mixed,626,321,947
44340,5,Mixed,230,189,419
44350,6,Mostly Positive,2069,676,2745
44360,5,Mixed,104,46,150
44600,5,Mixed,18,14,32
44620,0,3 user reviews,3,0,3
44650,0,7 user reviews,5,2,7
44660,7,Positive,9,1,10
44670,0,5 user reviews,5,0,5
44680,0,2 user reviews,2,0,2
44690,8,Very Positive,78,13,91
45000,8,Very Positive,193,12,205
45100,8,Very Positive,433,90,523
45200,7,Positive,11,0,11
45300,5,Mixed,198,108,306
45302,4,Mostly Negative,4,8,12
45400,8,Very Positive,290,23,313
45410,5,Mixed,23,23,46
45420,0,1 user reviews,0,1,1
45450,8,Very Positive,131,12,143
45700,8,Very Positive,681,79,760
45710,5,Mixed,136,128,264
45720,5,Mixed,80,64,144
45730,5,Mixed,63,82,145
45740,6,Mostly Positive,1366,435,1801
45750,5,Mixed,724,352,1076
45760,8,Very Positive,3132,401,3533
45770,8,Very Positive,721,166,887
45773,5,Mixed,11,15,26
45774,4,Mostly Negative,4,11,15
45775,4,Mostly Negative,6,18,24
45776,4,Mostly Negative,7,14,21
45790,0,2 user reviews,1,1,2
45791,0,2 user reviews,2,0,2
45792,0,1 user reviews,1,0,1
45793,0,2 user reviews,2,0,2
45795,0,2 user reviews,1,1,2
45796,0,2 user reviews,1,1,2
45797,0,1 user reviews,1,0,1
45900,3,Negative,2,11,13
46000,5,Mixed,46,22,68
46200,5,Mixed,11,10,21
46210,0,2 user reviews,2,0,2
46220,0,2 user reviews,1,1,2
46230,0,7 user reviews,3,4,7
46250,6,Mostly Positive,74,26,100
46260,6,Mostly Positive,86,34,120
46270,5,Mixed,59,32,91
46280,4,Mostly Negative,11,28,39
46290,5,Mixed,47,42,89
46320,0,1 user reviews,1,0,1
46330,7,Positive,45,0,45
46340,5,Mixed,39,19,58
46342,0,2 user reviews,1,1,2
46350,5,Mixed,10,15,25
46360,5,Mixed,32,20,52
46370,5,Mixed,65,53,118
46380,5,Mixed,14,21,35
46400,5,Mixed,44,64,108
46410,5,Mixed,75,35,110
46420,5,Mixed,83,48,131
46430,6,Mostly Positive,36,14,50
46440,4,Mostly Negative,40,93,133
46450,5,Mixed,103,91,194
46460,8,Very Positive,177,33,210
46480,8,Very Positive,227,48,275
46490,5,Mixed,67,85,152
46500,8,Very Positive,699,132,831
46510,8,Very Positive,277,54,331
46520,5,Mixed,42,31,73
46540,4,Mostly Negative,85,158,243
46550,5,Mixed,49,53,102
46560,5,Mixed,176,140,316
46570,5,Mixed,40,52,92
46600,6,Mostly Positive,26,9,35
46700,4,Mostly Negative,4,16,20
46710,5,Mixed,9,10,19
46720,4,Mostly Negative,3,9,12
46730,4,Mostly Negative,9,28,37
46740,4,Mostly Negative,10,32,42
46750,5,Mixed,74,49,123
46760,0,5 user reviews,2,3,5
46770,8,Very Positive,147,34,181
46790,5,Mixed,18,12,30
46830,0,9 user reviews,4,5,9
46840,0,2 user reviews,0,2,2
46850,6,Mostly Positive,17,7,24
47000,8,Very Positive,259,51,310
47110,0,7 user reviews,5,2,7
47120,0,1 user reviews,1,0,1
47130,0,7 user reviews,6,1,7
47400,4,Mostly Negative,306,1009,1315
47410,5,Mixed,52,28,80
47500,0,9 user reviews,7,2,9
47520,0,3 user reviews,2,1,3
47540,8,Very Positive,183,42,225
47570,0,2 user reviews,2,0,2
47700,1,Overwhelmingly Negative,205,1274,1479
47730,7,Positive,41,2,43
47780,8,Very Positive,4734,275,5009
47790,6,Mostly Positive,790,242,1032
47810,8,Very Positive,8631,824,9455
47830,7,Positive,10,1,11
47850,0,1 user reviews,0,1,1
47870,6,Mostly Positive,3597,1113,4710
47880,8,Very Positive,149,2,151
47890,8,Very Positive,10834,1850,12684
47892,6,Mostly Positive,37,10,47
47893,7,Positive,35,3,38
47894,8,Very Positive,51,7,58
47895,5,Mixed,6,5,11
47896,6,Mostly Positive,8,3,11
47897,0,8 user reviews,7,1,8
47898,8,Very Positive,41,9,50
47899,5,Mixed,5,7,12
47900,8,Very Positive,120,12,132
47920,5,Mixed,493,368,861
47930,8,Very Positive,162,36,198
47931,7,Positive,10,2,12
47932,5,Mixed,18,13,31
48000,8,Very Positive,6610,518,7128
48110,4,Mostly Negative,424,642,1066
48120,5,Mixed,30,29,59
48150,0,4 user reviews,4,0,4
48160,4,Mostly Negative,48,83,131
48167,0,1 user reviews,1,0,1
48180,4,Mostly Negative,48,83,131
48187,0,1 user reviews,0,1,1
48190,8,Very Positive,3192,510,3702
48220,4,Mostly Negative,1086,1836,2922
48231,0,5 user reviews,1,4,5
48232,0,3 user reviews,1,2,3
48240,5,Mixed,3152,2607,5759
48700,9,Overwhelmingly Positive,43749,1009,44758
48705,8,Very Positive,1487,151,1638
48720,8,Very Positive,2109,489,2598
48800,5,Mixed,356,405,761
48802,0,5 user reviews,5,0,5
48803,6,Mostly Positive,13,5,18
48804,0,3 user reviews,2,1,3
48805,0,5 user reviews,3,2,5
48806,6,Mostly Positive,10,3,13
48900,7,Positive,33,4,37
48950,8,Very Positive,211,30,241
49000,6,Mostly Positive,25,10,35
49300,5,Mixed,33,41,74
49310,0,2 user reviews,2,0,2
49311,0,4 user reviews,4,0,4
49320,5,Mixed,20,12,32
49330,5,Mixed,44,27,71
49337,0,2 user reviews,1,1,2
49400,8,Very Positive,80,3,83
49470,8,Very Positive,493,72,565
49473,0,3 user reviews,3,0,3
49474,0,2 user reviews,2,0,2
49475,0,4 user reviews,2,2,4
49476,0,3 user reviews,2,1,3
49490,0,1 user reviews,1,0,1
49491,0,1 user reviews,1,0,1
49492,0,1 user reviews,1,0,1
49493,0,1 user reviews,1,0,1
49494,0,1 user reviews,1,0,1
49495,0,1 user reviews,1,0,1
49496,0,1 user reviews,1,0,1
49497,0,1 user reviews,1,0,1
49498,0,1 user reviews,1,0,1
49499,0,1 user reviews,1,0,1
49520,9,Overwhelmingly Positive,81948,3388,85336
49540,5,Mixed,1463,1430,2893
49600,9,Overwhelmingly Positive,3107,161,3268
49604,8,Very Positive,53,4,57
49700,0,2 user reviews,1,1,2
49800,4,Mostly Negative,65,116,181
49810,8,Very Positive,48,10,58
49900,5,Mixed,94,46,140
50000,8,Very Positive,115,6,121
50110,6,Mostly Positive,156,49,205
50120,0,7 user reviews,5,2,7
50130,8,Very Positive,7264,638,7902
50280,0,1 user reviews,1,0,1
50300,8,Very Positive,10191,788,10979
50310,0,9 user reviews,9,0,9
50400,0,5 user reviews,4,1,5
50510,4,Mostly Negative,27,42,69
50620,8,Very Positive,2380,337,2717
50650,8,Very Positive,1579,225,1804
50820,6,Mostly Positive,16,5,21
50900,0,1 user reviews,1,0,1
50910,7,Positive,13,0,13
50920,5,Mixed,9,4,13
50930,0,5 user reviews,1,4,5
50940,0,5 user reviews,4,1,5
50960,7,Positive,18,4,22
50970,5,Mixed,16,7,23
50980,7,Positive,15,3,18
50990,7,Positive,29,1,30
51000,6,Mostly Positive,14,6,20
51010,5,Mixed,38,17,55
51020,0,6 user reviews,6,0,6
51030,0,4 user reviews,4,0,4
51060,8,Very Positive,57,10,67
51100,5,Mixed,30,19,49
55000,8,Very Positive,135,22,157
55020,0,2 user reviews,1,1,2
55040,8,Very Positive,651,80,731
55100,5,Mixed,836,581,1417
55110,5,Mixed,656,334,990
55115,5,Mixed,11,14,25
55140,8,Very Positive,789,150,939
55150,8,Very Positive,4073,282,4355
55203,0,3 user reviews,0,3,3
55204,0,1 user reviews,1,0,1
55205,7,Positive,14,2,16
55230,8,Very Positive,13821,776,14597
55340,7,Positive,11,1,12
55341,0,5 user reviews,5,0,5
55343,0,6 user reviews,5,1,6
55344,0,7 user reviews,7,0,7
55345,7,Positive,9,2,11
55347,5,Mixed,12,8,20
55348,5,Mixed,10,9,19
55380,7,Positive,30,5,35
55381,7,Positive,37,6,43
55382,5,Mixed,30,20,50
55385,6,Mostly Positive,14,4,18
55386,5,Mixed,10,15,25
55387,7,Positive,17,4,21
55388,5,Mixed,18,9,27
55389,7,Positive,21,4,25
55390,4,Mostly Negative,11,39,50
55391,5,Mixed,9,11,20
55392,6,Mostly Positive,15,4,19
55393,5,Mixed,15,11,26
55394,4,Mostly Negative,20,41,61
55395,5,Mixed,10,6,16
55396,6,Mostly Positive,17,7,24
55397,5,Mixed,11,9,20
55398,5,Mixed,23,13,36
55399,6,Mostly Positive,19,6,25
55400,5,Mixed,15,7,22
55470,0,6 user reviews,6,0,6
55471,0,9 user reviews,9,0,9
55472,7,Positive,10,2,12
55473,0,6 user reviews,6,0,6
55475,7,Positive,9,2,11
55476,0,3 user reviews,3,0,3
56400,8,Very Positive,2739,287,3026
56431,0,2 user reviews,2,0,2
56432,0,2 user reviews,2,0,2
56433,0,2 user reviews,2,0,2
56434,0,3 user reviews,3,0,3
56435,0,1 user reviews,1,0,1
56436,0,7 user reviews,5,2,7
56437,8,Very Positive,2739,287,3026
56438,7,Positive,15,0,15
56480,0,4 user reviews,4,0,4
56481,0,3 user reviews,2,1,3
56482,0,3 user reviews,3,0,3
56483,0,1 user reviews,1,0,1
56484,0,1 user reviews,1,0,1
56485,0,3 user reviews,3,0,3
56487,0,4 user reviews,4,0,4
56488,0,3 user reviews,3,0,3
56489,7,Positive,8,2,10
56493,5,Mixed,9,4,13
56536,0,4 user reviews,4,0,4
56538,0,2 user reviews,2,0,2
57000,8,Very Positive,56,8,64
57200,8,Very Positive,185,19,204
57300,9,Overwhelmingly Positive,8861,372,9233
57400,9,Overwhelmingly Positive,1025,12,1037
57600,8,Very Positive,185,4,189
57620,5,Mixed,79,58,137
57640,8,Very Positive,584,43,627
57650,5,Mixed,136,189,325
57655,0,2 user reviews,2,0,2
57656,0,2 user reviews,2,0,2
57680,5,Mixed,143,62,205
57690,8,Very Positive,3844,371,4215
57695,7,Positive,11,0,11
57696,7,Positive,12,2,14
57697,7,Positive,13,0,13
57700,6,Mostly Positive,50,20,70
57730,5,Mixed,50,34,84
57740,5,Mixed,282,139,421
57800,4,Mostly Negative,26,48,74
57900,5,Mixed,1621,889,2510
57923,6,Mostly Positive,11,4,15
57925,6,Mostly Positive,23,6,29
58200,8,Very Positive,140,21,161
58230,7,Positive,27,2,29
58300,6,Mostly Positive,16,6,22
58400,4,Mostly Negative,17,37,54
58510,6,Mostly Positive,70,22,92
58520,6,Mostly Positive,377,98,475
58540,8,Very Positive,179,5,184
58550,4,Mostly Negative,66,168,234
58560,8,Very Positive,71,14,85
58570,8,Very Positive,165,41,206
58610,6,Mostly Positive,837,281,1118
58643,0,8 user reviews,5,3,8
58645,0,4 user reviews,3,1,4
58646,0,3 user reviews,2,1,3
58648,0,3 user reviews,2,1,3
60340,6,Mostly Positive,7,3,10
60350,7,Positive,24,2,26
60600,4,Mostly Negative,3,8,11
60700,4,Mostly Negative,7,13,20
60800,5,Mixed,35,43,78
61000,7,Positive,35,3,38
61010,8,Very Positive,77,2,79
61100,6,Mostly Positive,58,16,74
61220,5,Mixed,32,36,68
61230,0,1 user reviews,1,0,1
61310,7,Positive,30,6,36
61500,6,Mostly Positive,248,84,332
61510,6,Mostly Positive,72,22,94
61520,8,Very Positive,185,22,207
61600,8,Very Positive,167,7,174
61700,8,Very Positive,581,107,688
61710,0,5 user reviews,3,2,5
61730,8,Very Positive,147,10,157
62000,8,Very Positive,274,26,300
62100,8,Very Positive,403,20,423
63000,8,Very Positive,297,52,349
63003,0,1 user reviews,1,0,1
63004,0,1 user reviews,1,0,1
63110,5,Mixed,48,27,75
63200,8,Very Positive,482,117,599
63380,8,Very Positive,1919,286,2205
63398,6,Mostly Positive,15,5,20
63399,6,Mostly Positive,14,6,20
63500,8,Very Positive,167,16,183
63600,5,Mixed,120,70,190
63610,8,Very Positive,414,83,497
63620,6,Mostly Positive,49,13,62
63630,6,Mostly Positive,20,6,26
63640,6,Mostly Positive,19,6,25
63650,8,Very Positive,71,17,88
63660,6,Mostly Positive,259,67,326
63700,8,Very Positive,380,85,465
63710,8,Very Positive,897,140,1037
63800,5,Mixed,118,87,205
63802,0,1 user reviews,1,0,1
63900,6,Mostly Positive,47,13,60
63910,8,Very Positive,247,20,267
63940,5,Mixed,201,158,359
63950,5,Mixed,234,122,356
63960,4,Mostly Negative,29,49,78
64000,8,Very Positive,1341,185,1526
64005,0,4 user reviews,2,2,4
64013,0,9 user reviews,7,2,9
64014,0,3 user reviews,2,1,3
64016,0,3 user reviews,2,1,3
64017,0,7 user reviews,5,2,7
65070,5,Mixed,24,24,48
65080,5,Mixed,29,16,45
65100,0,6 user reviews,6,0,6
65200,4,Mostly Negative,20,35,55
65215,6,Mostly Positive,8,3,11
65216,7,Positive,25,2,27
65217,5,Mixed,27,15,42
65218,8,Very Positive,46,5,51
65224,5,Mixed,11,8,19
65226,0,7 user reviews,5,2,7
65227,0,1 user reviews,1,0,1
65228,0,9 user reviews,8,1,9
65229,6,Mostly Positive,13,5,18
65231,5,Mixed,23,13,36
65232,5,Mixed,32,31,63
65233,6,Mostly Positive,24,9,33
65235,0,1 user reviews,1,0,1
65237,0,1 user reviews,1,0,1
65239,5,Mixed,20,26,46
65241,0,1 user reviews,1,0,1
65242,7,Positive,12,1,13
65243,7,Positive,11,0,11
65244,7,Positive,22,3,25
65246,4,Mostly Negative,5,13,18
65247,7,Positive,14,3,17
65249,0,4 user reviews,2,2,4
65250,0,7 user reviews,4,3,7
65252,7,Positive,14,2,16
65253,7,Positive,24,2,26
65254,0,5 user reviews,3,2,5
65255,6,Mostly Positive,27,7,34
65256,0,7 user reviews,4,3,7
65258,0,6 user reviews,4,2,6
65259,7,Positive,15,1,16
65260,0,1 user reviews,1,0,1
65270,8,Very Positive,126,22,148
65300,8,Very Positive,766,42,808
65302,0,9 user reviews,9,0,9
65400,8,Very Positive,80,11,91
65500,5,Mixed,32,30,62
65530,5,Mixed,34,18,52
65540,6,Mostly Positive,924,267,1191
65560,5,Mixed,59,85,144
65600,4,Mostly Negative,64,107,171
65610,5,Mixed,59,74,133
65700,8,Very Positive,133,15,148
65720,8,Very Positive,112,23,135
65730,5,Mixed,133,90,223
65733,0,5 user reviews,2,3,5
65734,0,3 user reviews,3,0,3
65735,0,1 user reviews,1,0,1
65740,5,Mixed,180,234,414
65780,6,Mostly Positive,204,73,277
65790,8,Very Positive,614,78,692
65800,8,Very Positive,5456,460,5916
65920,8,Very Positive,115,16,131
65930,5,Mixed,1580,923,2503
65950,7,Positive,28,1,29
65980,5,Mixed,4602,3927,8529
66000,4,Mostly Negative,7,22,29
66001,4,Mostly Negative,3,10,13
66002,5,Mixed,22,15,37
67000,6,Mostly Positive,264,80,344
67370,8,Very Positive,2041,283,2324
70000,8,Very Positive,3869,551,4420
70100,5,Mixed,146,74,220
70110,5,Mixed,39,31,70
70120,4,Mostly Negative,31,97,128
70200,6,Mostly Positive,35,9,44
70210,6,Mostly Positive,56,15,71
70300,9,Overwhelmingly Positive,3029,103,3132
70400,9,Overwhelmingly Positive,4295,153,4448
70420,6,Mostly Positive,318,100,418
70500,7,Positive,19,3,22
70600,8,Very Positive,724,130,854
70616,0,7 user reviews,5,2,7
70617,0,5 user reviews,4,1,5
70620,8,Very Positive,126,20,146
70640,8,Very Positive,142,23,165
70650,6,Mostly Positive,42,18,60
70660,5,Mixed,47,25,72
70900,8,Very Positive,174,26,200
71000,6,Mostly Positive,247,77,324
71110,0,2 user reviews,2,0,2
71111,0,3 user reviews,3,0,3
71112,0,5 user reviews,4,1,5
71113,7,Positive,17,2,19
71114,0,3 user reviews,3,0,3
71115,0,4 user reviews,2,2,4
71116,0,6 user reviews,6,0,6
71117,0,4 user reviews,4,0,4
71118,0,4 user reviews,4,0,4
71119,0,4 user reviews,4,0,4
71120,0,9 user reviews,9,0,9
71160,0,4 user reviews,4,0,4
71161,0,2 user reviews,2,0,2
71162,7,Positive,13,0,13
71163,7,Positive,9,1,10
71164,0,6 user reviews,6,0,6
71165,0,7 user reviews,7,0,7
71166,0,5 user reviews,5,0,5
71167,0,2 user reviews,2,0,2
71168,0,3 user reviews,3,0,3
71230,8,Very Positive,607,119,726
71240,8,Very Positive,173,21,194
71250,8,Very Positive,2880,340,3220
71260,8,Very Positive,345,49,394
71270,8,Very Positive,100,0,100
71340,8,Very Positive,5135,402,5537
71390,6,Mostly Positive,68,25,93
71420,0,9 user reviews,8,1,9
72000,8,Very Positive,194,35,229
72200,8,Very Positive,1398,330,1728
72300,5,Mixed,39,23,62
72400,6,Mostly Positive,54,17,71
72709,0,4 user reviews,3,1,4
72730,5,Mixed,970,534,1504
72740,8,Very Positive,582,119,701
72750,8,Very Positive,673,72,745
72760,8,Very Positive,475,43,518
72770,0,4 user reviews,2,2,4
72771,8,Very Positive,582,119,701
72772,0,9 user reviews,7,2,9
72773,0,2 user reviews,1,1,2
72774,0,3 user reviews,2,1,3
72840,8,Very Positive,295,17,312
72850,8,Very Positive,88209,7433,95642
72900,5,Mixed,70,38,108
72902,0,2 user reviews,1,1,2
73010,6,Mostly Positive,227,89,316
73012,0,1 user reviews,1,0,1
73013,0,1 user reviews,1,0,1
73014,0,1 user reviews,0,1,1
73020,6,Mostly Positive,346,139,485
73030,7,Positive,17,4,21
73031,7,Positive,20,3,23
73033,0,6 user reviews,4,2,6
73035,0,9 user reviews,6,3,9
73036,0,8 user reviews,5,3,8
73037,5,Mixed,7,4,11
73039,0,3 user reviews,3,0,3
73041,0,6 user reviews,2,4,6
73054,0,8 user reviews,6,2,8
73057,0,6 user reviews,6,0,6
73058,4,Mostly Negative,10,23,33
73060,4,Mostly Negative,9,26,35
73071,0,2 user reviews,1,1,2
73091,0,6 user reviews,4,2,6
73092,0,4 user reviews,3,1,4
73093,5,Mixed,9,6,15
73095,0,3 user reviews,3,0,3
73096,0,2 user reviews,2,0,2
73097,0,4 user reviews,4,0,4
73098,0,2 user reviews,2,0,2
73115,0,8 user reviews,5,3,8
73119,0,3 user reviews,2,1,3
73120,0,5 user reviews,5,0,5
73170,8,Very Positive,623,72,695
73183,0,5 user reviews,4,1,5
73187,0,1 user reviews,1,0,1
73190,5,Mixed,28,30,58
73193,0,1 user reviews,1,0,1
73195,0,2 user reviews,2,0,2
73210,5,Mixed,117,66,183
73220,5,Mixed,69,36,105
73230,8,Very Positive,134,2,136
78000,9,Overwhelmingly Positive,1338,70,1408
80000,4,Mostly Negative,17,65,82
80010,0,1 user reviews,0,1,1
80200,6,Mostly Positive,229,60,289
80202,0,1 user reviews,1,0,1
80204,0,1 user reviews,1,0,1
80207,0,1 user reviews,1,0,1
80300,7,Positive,37,7,44
80310,8,Very Positive,612,81,693
80330,8,Very Positive,573,74,647
80340,8,Very Positive,234,22,256
80350,8,Very Positive,193,9,202
80360,8,Very Positive,208,6,214
90100,7,Positive,17,0,17
90200,8,Very Positive,169,38,207
90207,0,1 user reviews,1,0,1
90208,0,1 user reviews,1,0,1
90400,7,Positive,40,6,46
90500,5,Mixed,38,51,89
90503,0,1 user reviews,0,1,1
90504,0,1 user reviews,0,1,1
90800,0,5 user reviews,4,1,5
91100,8,Very Positive,285,36,321
91104,0,6 user reviews,6,0,6
91106,0,2 user reviews,2,0,2
91200,8,Very Positive,366,67,433
91310,8,Very Positive,4614,1115,5729
91330,5,Mixed,196,134,330
91333,0,7 user reviews,5,2,7
91342,0,5 user reviews,3,2,5
91346,0,5 user reviews,5,0,5
91600,8,Very Positive,1085,109,1194
91604,0,3 user reviews,2,1,3
91612,0,1 user reviews,1,0,1
91614,0,1 user reviews,1,0,1
91618,0,3 user reviews,3,0,3
91700,8,Very Positive,3147,555,3702
91800,7,Positive,40,8,48
91810,7,Positive,16,3,19
91900,8,Very Positive,248,48,296
92000,5,Mixed,698,453,1151
92100,5,Mixed,210,227,437
92200,8,Very Positive,68,6,74
92210,8,Very Positive,76,14,90
92220,8,Very Positive,56,10,66
92300,6,Mostly Positive,252,106,358
92302,0,3 user reviews,2,1,3
92303,0,1 user reviews,1,0,1
92400,6,Mostly Positive,21,6,27
92502,0,6 user reviews,6,0,6
92503,0,1 user reviews,1,0,1
92600,8,Very Positive,47,10,57
92700,4,Mostly Negative,13,28,41
92800,9,Overwhelmingly Positive,1441,59,1500
92803,7,Positive,13,1,14
92900,5,Mixed,34,35,69
93200,8,Very Positive,302,70,372
93206,0,3 user reviews,3,0,3
93207,0,2 user reviews,2,0,2
94000,5,Mixed,199,178,377
94200,8,Very Positive,435,23,458
94202,0,8 user reviews,7,1,8
94300,8,Very Positive,723,69,792
94303,0,8 user reviews,7,1,8
94304,0,6 user reviews,5,1,6
94400,8,Very Positive,3149,359,3508
94500,7,Positive,35,4,39
94510,7,Positive,35,5,40
94520,7,Positive,37,2,39
94530,7,Positive,45,4,49
94590,8,Very Positive,210,37,247
94600,7,Positive,29,5,34
94610,7,Positive,12,2,14
94620,8,Very Positive,58,2,60
95300,8,Very Positive,293,62,355
95400,8,Very Positive,771,58,829
95500,0,7 user reviews,7,0,7
95700,7,Positive,10,0,10
95900,5,Mixed,70,36,106
96000,8,Very Positive,1103,158,1261
96100,8,Very Positive,2278,427,2705
96200,6,Mostly Positive,33,13,46
96300,5,Mixed,97,143,240
96308,0,2 user reviews,2,0,2
96800,5,Mixed,78,48,126
96831,0,1 user reviews,1,0,1
96900,0,9 user reviews,4,5,9
97000,8,Very Positive,847,89,936
97110,8,Very Positive,43,10,53
97120,8,Very Positive,60,5,65
97130,8,Very Positive,76,10,86
97300,0,1 user reviews,1,0,1
97301,0,1 user reviews,1,0,1
97302,0,1 user reviews,1,0,1
97303,0,1 user reviews,1,0,1
97304,0,1 user reviews,1,0,1
97305,0,1 user reviews,1,0,1
97306,0,1 user reviews,1,0,1
97307,0,1 user reviews,1,0,1
97308,0,1 user reviews,1,0,1
97309,0,1 user reviews,1,0,1
97310,0,1 user reviews,1,0,1
97311,0,1 user reviews,1,0,1
97312,0,1 user reviews,1,0,1
97313,0,1 user reviews,1,0,1
97314,0,1 user reviews,1,0,1
97315,0,1 user reviews,1,0,1
97316,0,1 user reviews,1,0,1
97317,0,1 user reviews,1,0,1
97318,0,1 user reviews,1,0,1
97319,0,1 user reviews,1,0,1
97320,0,1 user reviews,1,0,1
97321,0,1 user reviews,1,0,1
97322,0,1 user reviews,1,0,1
97323,0,1 user reviews,1,0,1
97324,0,1 user reviews,1,0,1
97325,0,1 user reviews,1,0,1
97326,0,1 user reviews,1,0,1
97327,0,1 user reviews,1,0,1
97330,8,Very Positive,562,98,660
97350,0,1 user reviews,1,0,1
97364,0,1 user reviews,0,1,1
97366,0,1 user reviews,1,0,1
97370,0,1 user reviews,0,1,1
97380,0,1 user reviews,0,1,1
98100,6,Mostly Positive,112,44,156
98200,8,Very Positive,733,83,816
98211,0,7 user reviews,5,2,7
98300,8,Very Positive,620,66,686
98400,8,Very Positive,1354,278,1632
98421,7,Positive,33,1,34
98500,5,Mixed,43,42,85
98510,6,Mostly Positive,54,21,75
98600,6,Mostly Positive,131,34,165
98800,8,Very Positive,2476,137,2613
98820,0,8 user reviews,7,1,8
98822,7,Positive,10,0,10
98900,5,Mixed,31,14,45
99100,4,Mostly Negative,47,121,168
99120,5,Mixed,19,15,34
99300,8,Very Positive,311,57,368
99400,5,Mixed,69,64,133
99410,4,Mostly Negative,10,25,35
99610,7,Positive,36,7,43
99611,7,Positive,37,8,45
99612,6,Mostly Positive,44,12,56
99614,6,Mostly Positive,21,8,29
99700,8,Very Positive,143,12,155
99810,6,Mostly Positive,1608,463,2071
99830,8,Very Positive,88,7,95
99890,6,Mostly Positive,53,14,67
99900,6,Mostly Positive,91,29,120
99910,5,Mixed,8,6,14
100400,6,Mostly Positive,31,10,41
100410,6,Mostly Positive,54,16,70
100970,0,1 user reviews,1,0,1
100980,8,Very Positive,68,9,77
101001,0,1 user reviews,1,0,1
102200,6,Mostly Positive,117,32,149
102400,0,7 user reviews,6,1,7
102500,8,Very Positive,6614,864,7478
102600,9,Overwhelmingly Positive,2580,78,2658
102622,7,Positive,24,2,26
102623,7,Positive,16,3,19
102700,5,Mixed,46,48,94
102810,8,Very Positive,46,9,55
102820,4,Mostly Negative,158,317,475
102822,0,4 user reviews,1,3,4
102840,6,Mostly Positive,357,100,457
102850,5,Mixed,110,52,162
104000,5,Mixed,64,28,92
104020,7,Positive,33,8,41
104100,5,Mixed,42,21,63
104200,8,Very Positive,1162,264,1426
104600,8,Very Positive,254,52,306
104700,5,Mixed,16,12,28
104900,6,Mostly Positive,9142,2618,11760
105000,5,Mixed,273,163,436
105100,5,Mixed,92,95,187
105300,6,Mostly Positive,123,44,167
105400,8,Very Positive,349,72,421
105411,0,2 user reviews,2,0,2
105412,0,1 user reviews,1,0,1
105415,0,1 user reviews,1,0,1
105420,8,Very Positive,68,13,81
105430,8,Very Positive,108,4,112
105450,8,Very Positive,8864,982,9846
105600,9,Overwhelmingly Positive,266322,5300,271622
105700,6,Mostly Positive,34,12,46
105800,8,Very Positive,270,49,319
106000,5,Mixed,34,28,62
107000,0,4 user reviews,3,1,4
107100,9,Overwhelmingly Positive,14359,478,14837
107104,8,Very Positive,59,1,60
107200,8,Very Positive,1480,109,1589
107300,8,Very Positive,681,123,804
107310,8,Very Positive,1804,133,1937
107410,8,Very Positive,59587,5920,65507
107430,0,1 user reviews,1,0,1
107600,9,Overwhelmingly Positive,586,22,608
107800,8,Very Positive,430,48,478
107820,0,2 user reviews,2,0,2
107821,5,Mixed,10,5,15
108100,5,Mixed,55,42,97
108110,4,Mostly Negative,22,54,76
108200,8,Very Positive,1204,161,1365
108210,0,2 user reviews,0,2,2
108230,6,Mostly Positive,7,3,10
108231,0,5 user reviews,5,0,5
108232,0,5 user reviews,5,0,5
108233,0,6 user reviews,6,0,6
108500,8,Very Positive,191,24,215
108600,8,Very Positive,9591,1424,11015
108700,5,Mixed,172,87,259
108710,8,Very Positive,7563,880,8443
108726,7,Positive,33,4,37
108800,8,Very Positive,1931,455,2386
109200,8,Very Positive,54,13,67
109400,4,Mostly Negative,7,20,27
109500,5,Mixed,38,32,70
109600,5,Mixed,80,35,115
109700,5,Mixed,27,16,43
110400,7,Positive,37,5,42
110500,7,Positive,16,3,19
110600,6,Mostly Positive,9,3,12
110610,7,Positive,13,1,14
110630,6,Mostly Positive,15,4,19
110800,8,Very Positive,6802,1407,8209
110810,8,Very Positive,81,8,89
111000,5,Mixed,28,25,53
111010,5,Mixed,26,20,46
111100,8,Very Positive,93,7,100
111300,6,Mostly Positive,16,6,22
111400,4,Mostly Negative,63,106,169
111402,0,1 user reviews,1,0,1
111600,8,Very Positive,194,38,232
111800,6,Mostly Positive,185,50,235
111900,2,Very Negative,32,132,164
112100,8,Very Positive,219,49,268
113020,8,Very Positive,2238,182,2420
113200,9,Overwhelmingly Positive,18398,865,19263
113203,0,5 user reviews,5,0,5
113204,8,Very Positive,314,19,333
113400,5,Mixed,91,105,196
113404,7,Positive,9,2,11
113405,6,Mostly Positive,11,3,14
113420,4,Mostly Negative,11,17,28
115100,8,Very Positive,1294,72,1366
115110,8,Very Positive,481,43,524
115120,8,Very Positive,384,72,456
115200,5,Mixed,57,70,127
115210,6,Mostly Positive,97,41,138
115220,5,Mixed,76,37,113
115300,8,Very Positive,2752,560,3312
115320,5,Mixed,1604,825,2429
115340,5,Mixed,12,8,20
115800,8,Very Positive,1696,214,1910
116100,5,Mixed,61,36,97
116120,7,Positive,37,3,40
200000,0,1 user reviews,1,0,1
200002,0,1 user reviews,1,0,1
200010,8,Very Positive,847,163,1010
200020,4,Mostly Negative,19,33,52
200050,4,Mostly Negative,28,48,76
200080,6,Mostly Positive,118,41,159
200130,8,Very Positive,100,25,125
200150,5,Mixed,97,100,197
200170,8,Very Positive,1323,301,1624
200185,0,3 user reviews,3,0,3
200188,0,2 user reviews,2,0,2
200189,0,1 user reviews,1,0,1
200190,5,Mixed,14,11,25
200210,6,Mostly Positive,102,27,129
200230,5,Mixed,141,84,225
200260,8,Very Positive,9425,566,9991
200300,0,1 user reviews,1,0,1
200330,7,Positive,20,1,21
200350,5,Mixed,9,12,21
200370,5,Mixed,146,93,239
200390,5,Mixed,30,33,63
200397,0,1 user reviews,1,0,1
200410,5,Mixed,27,20,47
200440,5,Mixed,18,11,29
200490,5,Mixed,29,28,57
200510,8,Very Positive,17748,1038,18786
200530,0,7 user reviews,5,2,7
200550,4,Mostly Negative,40,70,110
200590,6,Mostly Positive,70,21,91
200610,0,6 user reviews,6,0,6
200620,0,2 user reviews,1,1,2
200630,4,Mostly Negative,25,82,107
200670,4,Mostly Negative,28,59,87
200710,8,Very Positive,13747,841,14588
200860,0,4 user reviews,3,1,4
200870,0,3 user reviews,1,2,3
200880,0,3 user reviews,1,2,3
200890,0,1 user reviews,0,1,1
200891,6,Mostly Positive,11,3,14
200900,8,Very Positive,2539,145,2684
200910,8,Very Positive,748,83,831
200940,8,Very Positive,1443,172,1615
200960,8,Very Positive,233,14,247
200980,7,Positive,33,1,34
200990,7,Positive,26,1,27
201000,7,Positive,21,0,21
201010,8,Very Positive,60,2,62
201020,8,Very Positive,51,8,59
201040,0,9 user reviews,2,7,9
201070,5,Mixed,60,39,99
201100,0,2 user reviews,1,1,2
201210,0,2 user reviews,1,1,2
201230,5,Mixed,10,7,17
201270,8,Very Positive,11179,1031,12210
201271,5,Mixed,231,133,364
201272,5,Mixed,38,32,70
201273,0,4 user reviews,4,0,4
201274,7,Positive,13,1,14
201275,0,2 user reviews,1,1,2
201277,7,Positive,13,3,16
201279,7,Positive,12,2,14
201280,8,Very Positive,232,13,245
201290,6,Mostly Positive,370,106,476
201310,8,Very Positive,801,63,864
201330,8,Very Positive,2688,343,3031
201420,8,Very Positive,236,50,286
201480,5,Mixed,125,135,260
201490,2,Very Negative,29,174,203
201510,1,Overwhelmingly Negative,75,618,693
201570,6,Mostly Positive,99,40,139
201700,6,Mostly Positive,448,144,592
201760,8,Very Positive,52,13,65
201790,8,Very Positive,4578,317,4895
201802,7,Positive,13,3,16
201804,6,Mostly Positive,10,4,14
201805,6,Mostly Positive,8,3,11
201809,0,4 user reviews,4,0,4
201810,8,Very Positive,14179,1882,16061
201830,5,Mixed,457,232,689
201870,8,Very Positive,2154,492,2646
201877,5,Mixed,7,9,16
201881,5,Mixed,5,7,12
201882,5,Mixed,26,28,54
201966,0,1 user reviews,1,0,1
201972,0,1 user reviews,1,0,1
202070,8,Very Positive,91,14,105
202090,8,Very Positive,283,35,318
202130,5,Mixed,95,132,227
202170,8,Very Positive,5440,352,5792
202191,0,2 user reviews,0,2,2
202193,0,2 user reviews,0,2,2
202200,6,Mostly Positive,518,144,662
202270,5,Mixed,77,79,156
202290,0,2 user reviews,1,1,2
202310,5,Mixed,178,147,325
202370,5,Mixed,21,12,33
202390,0,1 user reviews,1,0,1
202410,8,Very Positive,50,9,59
202450,0,1 user reviews,1,0,1
202452,0,1 user reviews,0,1,1
202454,0,1 user reviews,1,0,1
202485,6,Mostly Positive,17,5,22
202520,0,5 user reviews,4,1,5
202521,0,4 user reviews,3,1,4
202523,0,1 user reviews,1,0,1
202524,0,4 user reviews,3,1,4
202530,5,Mixed,314,403,717
202570,8,Very Positive,2688,343,3031
202652,0,1 user reviews,0,1,1
202670,8,Very Positive,85,11,96
202690,8,Very Positive,99,4,103
202710,5,Mixed,298,131,429
202730,8,Very Positive,71,10,81
202750,6,Mostly Positive,1307,488,1795
202860,4,Mostly Negative,9,19,28
202941,0,1 user reviews,1,0,1
202951,0,1 user reviews,0,1,1
202961,0,3 user reviews,3,0,3
202970,8,Very Positive,4749,1055,5804
202990,8,Very Positive,1091,116,1207
203140,8,Very Positive,6757,1185,7942
203160,8,Very Positive,30984,1853,32837
203210,8,Very Positive,331,26,357
203250,5,Mixed,160,85,245
203290,6,Mostly Positive,64,20,84
203340,0,3 user reviews,0,3,3
203341,0,3 user reviews,0,3,3
203342,0,2 user reviews,0,2,2
203343,0,5 user reviews,2,3,5
203344,0,5 user reviews,3,2,5
203345,0,4 user reviews,2,2,4
203350,6,Mostly Positive,178,56,234
203358,0,9 user reviews,8,1,9
203510,8,Very Positive,404,77,481
203560,8,Very Positive,67,10,77
203630,8,Very Positive,447,70,517
203650,6,Mostly Positive,337,110,447
203680,6,Mostly Positive,144,56,200
203700,0,6 user reviews,4,2,6
203701,6,Mostly Positive,11,4,15
203702,0,3 user reviews,2,1,3
203730,8,Very Positive,420,23,443
203733,0,3 user reviews,3,0,3
203750,8,Very Positive,920,195,1115
203765,0,6 user reviews,2,4,6
203766,0,4 user reviews,2,2,4
203770,8,Very Positive,19755,1513,21268
203772,6,Mostly Positive,10,4,14
203773,6,Mostly Positive,21,9,30
203774,0,6 user reviews,2,4,6
203775,0,6 user reviews,3,3,6
203776,4,Mostly Negative,50,123,173
203777,0,5 user reviews,1,4,5
203778,5,Mixed,53,23,76
203810,6,Mostly Positive,2341,678,3019
203830,8,Very Positive,480,97,577
203850,7,Positive,41,1,42
203881,0,1 user reviews,1,0,1
203990,8,Very Positive,91,11,102
204030,8,Very Positive,2798,290,3088
204060,6,Mostly Positive,661,175,836
204080,5,Mixed,231,124,355
204100,6,Mostly Positive,8864,2310,11174
204106,0,2 user reviews,1,1,2
204107,0,3 user reviews,0,3,3
204108,0,1 user reviews,0,1,1
204109,0,1 user reviews,0,1,1
204110,0,2 user reviews,0,2,2
204111,0,1 user reviews,0,1,1
204120,8,Very Positive,337,56,393
204140,6,Mostly Positive,44,18,62
204180,8,Very Positive,602,122,724
204182,0,5 user reviews,3,2,5
204185,0,4 user reviews,4,0,4
204220,7,Positive,24,6,30
204240,8,Very Positive,926,143,1069
204281,0,2 user reviews,0,2,2
204282,0,4 user reviews,3,1,4
204283,0,2 user reviews,2,0,2
204284,0,2 user reviews,2,0,2
204285,0,3 user reviews,2,1,3
204286,0,2 user reviews,2,0,2
204287,0,5 user reviews,3,2,5
204288,0,1 user reviews,1,0,1
204289,0,6 user reviews,0,6,6
204290,6,Mostly Positive,10,3,13
204300,8,Very Positive,5855,1035,6890
204303,7,Positive,14,2,16
204304,0,1 user reviews,1,0,1
204305,0,2 user reviews,2,0,2
204306,0,4 user reviews,4,0,4
204307,0,2 user reviews,2,0,2
204308,0,5 user reviews,5,0,5
204309,0,1 user reviews,1,0,1
204310,0,6 user reviews,5,1,6
204311,0,5 user reviews,5,0,5
204312,0,4 user reviews,3,1,4
204314,0,4 user reviews,2,2,4
204315,0,6 user reviews,6,0,6
204317,0,6 user reviews,6,0,6
204318,0,2 user reviews,2,0,2
204319,0,3 user reviews,2,1,3
204340,8,Very Positive,1604,269,1873
204360,9,Overwhelmingly Positive,20621,727,21348
204371,8,Very Positive,223,1,224
204372,8,Very Positive,224,6,230
204380,5,Mixed,7,4,11
204381,0,8 user reviews,5,3,8
204382,0,4 user reviews,2,2,4
204383,0,5 user reviews,3,2,5
204384,0,7 user reviews,3,4,7
204385,7,Positive,9,2,11
204386,7,Positive,9,1,10
204387,0,4 user reviews,3,1,4
204388,0,5 user reviews,5,0,5
204390,8,Very Positive,61,10,71
204440,8,Very Positive,49,6,55
204450,8,Very Positive,5568,310,5878
204510,0,9 user reviews,5,4,9
204530,8,Very Positive,1406,76,1482
204560,4,Mostly Negative,18,33,51
204580,7,Positive,9,2,11
204630,8,Very Positive,900,117,1017
204732,0,2 user reviews,1,1,2
204734,0,2 user reviews,0,2,2
204760,4,Mostly Negative,18,62,80
204840,4,Mostly Negative,17,26,43
204860,5,Mixed,52,29,81
204880,8,Very Positive,5106,308,5414
204900,0,9 user reviews,4,5,9
204901,0,9 user reviews,4,5,9
204902,0,4 user reviews,4,0,4
204940,5,Mixed,45,37,82
205020,8,Very Positive,221,31,252
205060,5,Mixed,46,31,77
205063,0,1 user reviews,1,0,1
205070,6,Mostly Positive,34,11,45
205073,0,3 user reviews,3,0,3
205080,5,Mixed,42,21,63
205083,0,1 user reviews,1,0,1
205100,9,Overwhelmingly Positive,23491,747,24238
205140,0,1 user reviews,1,0,1
205170,0,1 user reviews,0,1,1
205190,8,Very Positive,273,41,314
205230,6,Mostly Positive,163,44,207
205250,7,Positive,10,1,11
205270,6,Mostly Positive,16,5,21
205330,8,Very Positive,52,13,65
205350,5,Mixed,188,210,398
205530,5,Mixed,30,27,57
205550,5,Mixed,51,36,87
205590,4,Mostly Negative,8,24,32
205610,6,Mostly Positive,272,112,384
205630,7,Positive,33,6,39
205632,7,Positive,9,1,10
205633,6,Mostly Positive,11,3,14
205634,7,Positive,12,1,13
205635,5,Mixed,5,5,10
205636,5,Mixed,10,5,15
205637,0,9 user reviews,8,1,9
205638,0,9 user reviews,7,2,9
205650,6,Mostly Positive,545,155,700
205690,6,Mostly Positive,76,20,96
205710,5,Mixed,4,6,10
205730,8,Very Positive,254,35,289
205810,5,Mixed,39,19,58
205830,8,Very Positive,62,1,63
205840,8,Very Positive,227,56,283
205870,6,Mostly Positive,58,17,75
205890,7,Positive,12,1,13
205910,8,Very Positive,1374,124,1498
205930,8,Very Positive,263,41,304
205950,8,Very Positive,1822,191,2013
205990,5,Mixed,325,190,515
206020,7,Positive,40,9,49
206040,7,Positive,16,4,20
206060,7,Positive,34,3,37
206092,0,3 user reviews,1,2,3
206095,0,1 user reviews,1,0,1
206099,0,1 user reviews,1,0,1
206107,0,2 user reviews,1,1,2
206108,0,1 user reviews,1,0,1
206118,0,2 user reviews,2,0,2
206124,0,1 user reviews,1,0,1
206125,0,2 user reviews,2,0,2
206127,0,3 user reviews,3,0,3
206138,0,2 user reviews,2,0,2
206139,0,1 user reviews,1,0,1
206142,0,1 user reviews,0,1,1
206143,0,1 user reviews,1,0,1
206148,0,1 user reviews,1,0,1
206150,0,1 user reviews,1,0,1
206151,0,2 user reviews,2,0,2
206153,0,1 user reviews,1,0,1
206154,0,1 user reviews,1,0,1
206155,0,1 user reviews,1,0,1
206160,0,1 user reviews,1,0,1
206163,0,1 user reviews,1,0,1
206164,0,1 user reviews,1,0,1
206165,0,1 user reviews,1,0,1
206166,0,3 user reviews,2,1,3
206172,0,3 user reviews,1,2,3
206174,0,1 user reviews,1,0,1
206176,0,2 user reviews,1,1,2
206177,0,1 user reviews,1,0,1
206178,0,1 user reviews,1,0,1
206179,0,2 user reviews,1,1,2
206190,9,Overwhelmingly Positive,6857,174,7031
206193,0,2 user reviews,2,0,2
206195,0,1 user reviews,1,0,1
206210,8,Very Positive,215,38,253
206230,5,Mixed,17,11,28
206250,6,Mostly Positive,58,20,78
206370,8,Very Positive,153,8,161
206410,7,Positive,12,2,14
206420,8,Very Positive,17022,2070,19092
206440,9,Overwhelmingly Positive,13204,546,13750
206450,8,Very Positive,77,2,79
206480,6,Mostly Positive,41,12,53
206500,6,Mostly Positive,34,13,47
206521,7,Positive,32,4,36
206522,5,Mixed,8,7,15
206550,0,2 user reviews,2,0,2
206610,4,Mostly Negative,17,47,64
206690,8,Very Positive,69,12,81
206712,0,4 user reviews,2,2,4
206714,0,1 user reviews,1,0,1
206716,0,1 user reviews,0,1,1
206718,0,3 user reviews,3,0,3
206720,0,1 user reviews,0,1,1
206740,7,Positive,18,4,22
206760,5,Mixed,35,38,73
206787,0,1 user reviews,1,0,1
207000,5,Mixed,9,13,22
207020,6,Mostly Positive,86,24,110
207040,8,Very Positive,230,45,275
207060,7,Positive,12,3,15
207080,9,Overwhelmingly Positive,512,23,535
207111,0,1 user reviews,1,0,1
207112,0,2 user reviews,2,0,2
207113,0,2 user reviews,1,1,2
207114,0,1 user reviews,1,0,1
207140,8,Very Positive,6781,396,7177
207150,4,Mostly Negative,121,189,310
207170,8,Very Positive,2341,179,2520
207190,5,Mixed,22,21,43
207210,5,Mixed,547,381,928
207221,7,Positive,18,4,22
207230,5,Mixed,15,8,23
207250,5,Mixed,151,70,221
207320,8,Very Positive,693,46,739
207350,9,Overwhelmingly Positive,1148,57,1205
207370,5,Mixed,92,95,187
207380,8,Very Positive,89,11,100
207400,8,Very Positive,231,13,244
207420,6,Mostly Positive,241,75,316
207430,5,Mixed,127,104,231
207490,8,Very Positive,932,74,1006
207530,8,Very Positive,265,14,279
207570,8,Very Positive,97,4,101
207610,9,Overwhelmingly Positive,16231,600,16831
207620,6,Mostly Positive,257,87,344
207650,6,Mostly Positive,34,13,47
207670,5,Mixed,10,8,18
207690,9,Overwhelmingly Positive,1275,59,1334
207710,5,Mixed,7,4,11
207730,4,Mostly Negative,42,115,157
207750,8,Very Positive,489,65,554
207790,4,Mostly Negative,59,144,203
207815,8,Very Positive,229,15,244
207816,8,Very Positive,114,1,115
207870,6,Mostly Positive,147,50,197
207890,8,Very Positive,117,1,118
207930,5,Mixed,109,58,167
208030,0,2 user reviews,2,0,2
208110,5,Mixed,51,38,89
208140,6,Mostly Positive,3099,835,3934
208200,8,Very Positive,2194,438,2632
208280,8,Very Positive,50,8,58
208281,0,3 user reviews,2,1,3
208282,7,Positive,8,2,10
208283,0,8 user reviews,6,2,8
208284,6,Mostly Positive,15,4,19
208286,7,Positive,40,5,45
208287,6,Mostly Positive,7,3,10
208288,5,Mixed,12,11,23
208289,0,9 user reviews,9,0,9
208292,6,Mostly Positive,10,3,13
208293,7,Positive,13,2,15
208294,6,Mostly Positive,10,3,13
208295,0,4 user reviews,4,0,4
208296,7,Positive,19,2,21
208298,7,Positive,10,0,10
208300,7,Positive,35,8,43
208301,6,Mostly Positive,22,9,31
208302,7,Positive,17,3,20
208303,7,Positive,14,2,16
208304,6,Mostly Positive,14,5,19
208306,7,Positive,18,4,22
208307,7,Positive,18,4,22
208318,0,8 user reviews,8,0,8
208319,7,Positive,13,0,13
208341,0,3 user reviews,2,1,3
208342,0,3 user reviews,3,0,3
208343,4,Mostly Negative,16,25,41
208346,6,Mostly Positive,9,3,12
208348,6,Mostly Positive,13,4,17
208349,5,Mixed,5,5,10
208350,5,Mixed,24,13,37
208351,0,9 user reviews,8,1,9
208352,7,Positive,26,6,32
208353,0,7 user reviews,5,2,7
208354,0,8 user reviews,4,4,8
208355,5,Mixed,9,5,14
208356,6,Mostly Positive,12,5,17
208361,5,Mixed,35,24,59
208362,5,Mixed,6,4,10
208363,7,Positive,26,2,28
208364,7,Positive,26,3,29
208365,6,Mostly Positive,17,5,22
208366,0,4 user reviews,3,1,4
208367,0,7 user reviews,7,0,7
208369,7,Positive,10,1,11
208370,0,8 user reviews,6,2,8
208371,7,Positive,13,0,13
208374,0,6 user reviews,1,5,6
208375,7,Positive,15,0,15
208376,0,9 user reviews,9,0,9
208377,7,Positive,13,1,14
208379,7,Positive,15,1,16
208400,8,Very Positive,579,52,631
208460,3,Negative,3,21,24
208480,5,Mixed,3162,1533,4695
208491,5,Mixed,14,13,27
208500,8,Very Positive,429,59,488
208520,5,Mixed,434,313,747
208540,0,4 user reviews,3,1,4
208541,7,Positive,10,2,12
208542,0,4 user reviews,2,2,4
208543,0,5 user reviews,4,1,5
208544,7,Positive,19,2,21
208545,0,5 user reviews,4,1,5
208546,0,7 user reviews,7,0,7
208570,5,Mixed,64,68,132
208575,8,Very Positive,231,23,254
208580,8,Very Positive,9587,744,10331
208600,8,Very Positive,337,46,383
208620,6,Mostly Positive,23,9,32
208630,7,Positive,20,1,21
208640,7,Positive,20,0,20
208650,6,Mostly Positive,11295,2861,14156
208670,8,Very Positive,144,27,171
208690,5,Mixed,51,27,78
208710,6,Mostly Positive,11,4,15
208730,5,Mixed,475,224,699
208740,7,Positive,16,4,20
208741,7,Positive,10,1,11
208742,7,Positive,9,1,10
208750,8,Very Positive,1359,133,1492
208790,3,Negative,2,10,12
208791,5,Mixed,8,8,16
208792,4,Mostly Negative,4,9,13
208793,4,Mostly Negative,6,12,18
208801,5,Mixed,4,6,10
208802,4,Mostly Negative,5,8,13
208803,4,Mostly Negative,4,7,11
208804,4,Mostly Negative,3,7,10
208805,4,Mostly Negative,5,9,14
208806,6,Mostly Positive,14,6,20
208807,6,Mostly Positive,18,6,24
208808,6,Mostly Positive,15,6,21
208809,6,Mostly Positive,14,4,18
208810,5,Mixed,9,9,18
208811,5,Mixed,8,8,16
208812,4,Mostly Negative,58,122,180
208813,5,Mixed,8,10,18
208814,5,Mixed,9,8,17
208817,7,Positive,16,4,20
208818,7,Positive,23,4,27
208830,0,1 user reviews,1,0,1
208831,0,1 user reviews,1,0,1
208832,0,1 user reviews,1,0,1
208835,0,1 user reviews,1,0,1
208843,0,1 user reviews,1,0,1
208981,0,5 user reviews,3,2,5
209000,8,Very Positive,6204,1372,7576
209060,8,Very Positive,359,57,416
209080,8,Very Positive,5819,493,6312
209100,5,Mixed,532,562,1094
209120,5,Mixed,371,333,704
209160,5,Mixed,2096,2439,4535
209170,8,Very Positive,95,15,110
209190,8,Very Positive,259,33,292
209201,0,2 user reviews,2,0,2
209202,0,6 user reviews,5,1,6
209230,8,Very Positive,77,12,89
209270,6,Mostly Positive,231,77,308
209330,5,Mixed,102,58,160
209340,5,Mixed,64,47,111
209360,7,Positive,18,4,22
209370,9,Overwhelmingly Positive,1119,58,1177
209373,0,7 user reviews,7,0,7
209390,3,Negative,5,23,28
209460,8,Very Positive,87,8,95
209520,5,Mixed,111,55,166
209540,6,Mostly Positive,679,176,855
209545,0,5 user reviews,5,0,5
209546,0,1 user reviews,0,1,1
209610,5,Mixed,23,20,43
209630,8,Very Positive,127,22,149
209650,5,Mixed,2591,2238,4829
209660,8,Very Positive,54,13,67
209670,8,Very Positive,909,224,1133
209690,6,Mostly Positive,50,16,66
209730,5,Mixed,59,65,124
209750,5,Mixed,15,15,30
209771,0,3 user reviews,3,0,3
209772,0,6 user reviews,5,1,6
209790,8,Very Positive,118,14,132
209793,0,1 user reviews,0,1,1
209801,0,1 user reviews,0,1,1
209811,6,Mostly Positive,114,34,148
209812,6,Mostly Positive,93,32,125
209830,8,Very Positive,477,62,539
209850,5,Mixed,26,12,38
209870,5,Mixed,43,62,105
209872,0,9 user reviews,3,6,9
209873,5,Mixed,5,6,11
209874,0,3 user reviews,2,1,3
209950,8,Very Positive,300,28,328
210012,0,5 user reviews,5,0,5
210013,0,6 user reviews,6,0,6
210014,5,Mixed,4,6,10
210015,0,3 user reviews,3,0,3
210016,0,4 user reviews,3,1,4
210017,0,4 user reviews,4,0,4
210018,0,4 user reviews,3,1,4
210019,0,5 user reviews,5,0,5
210047,0,1 user reviews,1,0,1
210054,0,1 user reviews,1,0,1
210068,0,1 user reviews,0,1,1
210069,0,1 user reviews,1,0,1
210113,7,Positive,11,2,13
210170,5,Mixed,27,13,40
210230,7,Positive,40,1,41
210350,0,6 user reviews,3,3,6
210390,6,Mostly Positive,33,10,43
210490,3,Negative,0,36,36
210510,0,3 user reviews,2,1,3
210550,8,Very Positive,172,25,197
210561,0,9 user reviews,4,5,9
210770,8,Very Positive,3614,274,3888
210892,5,Mixed,6,4,10
210893,0,6 user reviews,3,3,6
210894,0,8 user reviews,6,2,8
210895,5,Mixed,46,20,66
210896,5,Mixed,7,4,11
210897,6,Mostly Positive,14,4,18
210898,5,Mixed,18,8,26
210899,0,9 user reviews,4,5,9
210900,5,Mixed,9,6,15
210901,6,Mostly Positive,7,3,10
210902,5,Mixed,44,57,101
210903,0,3 user reviews,1,2,3
210904,5,Mixed,9,13,22
210905,5,Mixed,8,7,15
210906,5,Mixed,32,27,59
210907,0,3 user reviews,1,2,3
210908,6,Mostly Positive,90,24,114
210931,7,Positive,18,2,20
210932,7,Positive,13,2,15
210933,8,Very Positive,64,2,66
210934,7,Positive,42,4,46
210936,7,Positive,20,2,22
210937,7,Positive,21,3,24
210938,7,Positive,15,2,17
210944,7,Positive,11,1,12
210945,7,Positive,16,1,17
210950,8,Very Positive,247,22,269
210970,8,Very Positive,3956,720,4676
210990,6,Mostly Positive,16,5,21
211010,7,Positive,24,5,29
211050,5,Mixed,48,29,77
211070,5,Mixed,48,29,77
211120,6,Mostly Positive,151,55,206
211160,5,Mixed,205,189,394
211180,8,Very Positive,155,17,172
211200,0,3 user reviews,3,0,3
211201,0,4 user reviews,4,0,4
211202,0,2 user reviews,2,0,2
211203,0,2 user reviews,1,1,2
211204,0,2 user reviews,1,1,2
211205,0,5 user reviews,5,0,5
211206,0,5 user reviews,5,0,5
211207,0,2 user reviews,2,0,2
211208,0,2 user reviews,2,0,2
211209,0,3 user reviews,3,0,3
211260,8,Very Positive,1105,202,1307
211262,0,6 user reviews,6,0,6
211280,5,Mixed,49,34,83
211340,8,Very Positive,546,42,588
211340,8,Very Positive,546,42,588
211360,8,Very Positive,88,10,98
211400,5,Mixed,2598,1115,3713
211419,0,8 user reviews,8,0,8
211420,8,Very Positive,27631,3407,31038
211440,8,Very Positive,123,22,145
211500,8,Very Positive,394,83,477
211520,0,5 user reviews,4,1,5
211521,0,5 user reviews,4,1,5
211522,0,6 user reviews,4,2,6
211523,5,Mixed,6,7,13
211580,5,Mixed,101,100,201
211600,8,Very Positive,1253,95,1348
211670,0,5 user reviews,4,1,5
211720,8,Very Positive,558,75,633
211740,8,Very Positive,765,45,810
211780,6,Mostly Positive,305,98,403
211800,7,Positive,21,4,25
211820,8,Very Positive,37306,4140,41446
211900,8,Very Positive,189,40,229
211970,5,Mixed,52,54,106
211990,0,1 user reviews,0,1,1
212010,5,Mixed,269,135,404
212030,6,Mostly Positive,232,61,293
212041,0,3 user reviews,3,0,3
212050,8,Very Positive,240,26,266
212070,5,Mixed,54,32,86
212110,6,Mostly Positive,33,9,42
212160,4,Mostly Negative,16,47,63
212170,0,3 user reviews,3,0,3
212171,0,6 user reviews,6,0,6
212172,0,4 user reviews,3,1,4
212200,5,Mixed,20,19,39
212210,0,7 user reviews,4,3,7
212301,5,Mixed,81,77,158
212390,0,5 user reviews,2,3,5
212410,5,Mixed,84,81,165
212480,8,Very Positive,4108,255,4363
212500,8,Very Positive,79,14,93
212580,5,Mixed,226,171,397
212601,0,1 user reviews,0,1,1
212603,0,4 user reviews,4,0,4
212630,5,Mixed,904,567,1471
212671,0,2 user reviews,1,1,2
212672,0,8 user reviews,6,2,8
212673,0,3 user reviews,1,2,3
212680,9,Overwhelmingly Positive,31658,1240,32898
212700,5,Mixed,9,10,19
212740,5,Mixed,94,43,137
212780,5,Mixed,66,51,117
212800,6,Mostly Positive,18,7,25
212893,6,Mostly Positive,46,19,65
212894,8,Very Positive,162,7,169
212910,9,Overwhelmingly Positive,1915,68,1983
213030,8,Very Positive,321,37,358
213178,0,1 user reviews,1,0,1
213179,7,Positive,8,2,10
213194,0,1 user reviews,1,0,1
213195,0,8 user reviews,5,3,8
213197,7,Positive,14,3,17
213198,0,6 user reviews,4,2,6
213210,8,Very Positive,205,38,243
213230,8,Very Positive,211,23,234
213250,5,Mixed,100,139,239
213311,0,6 user reviews,3,3,6
213312,0,7 user reviews,5,2,7
213330,8,Very Positive,564,70,634
213350,5,Mixed,27,36,63
213370,6,Mostly Positive,23,7,30
213550,0,1 user reviews,1,0,1
213610,8,Very Positive,4604,706,5310
213650,0,6 user reviews,4,2,6
213661,0,1 user reviews,1,0,1
213662,0,2 user reviews,2,0,2
213663,0,1 user reviews,1,0,1
213664,0,1 user reviews,1,0,1
213665,0,1 user reviews,1,0,1
213670,9,Overwhelmingly Positive,17062,543,17605
213780,6,Mostly Positive,74,25,99
213850,8,Very Positive,1818,427,2245
213890,0,1 user reviews,0,1,1
213896,0,3 user reviews,3,0,3
213906,0,1 user reviews,0,1,1
213907,0,1 user reviews,0,1,1
213930,0,1 user reviews,1,0,1
214100,5,Mixed,17,18,35
214130,5,Mixed,59,36,95
214150,5,Mixed,30,42,72
214170,8,Very Positive,775,128,903
214230,5,Mixed,63,36,99
214250,5,Mixed,619,423,1042
214270,0,6 user reviews,5,1,6
214310,6,Mostly Positive,23,9,32
214320,5,Mixed,10,10,20
214340,8,Very Positive,1762,431,2193
214360,5,Mixed,463,205,668
214400,0,4 user reviews,4,0,4
214420,8,Very Positive,534,95,629
214490,8,Very Positive,14033,1311,15344
214510,8,Very Positive,1481,218,1699
214530,0,2 user reviews,1,1,2
214550,8,Very Positive,47,9,56
214560,9,Overwhelmingly Positive,6590,221,6811
214570,8,Very Positive,53,5,58
214590,8,Very Positive,300,28,328
214610,8,Very Positive,235,29,264
214630,5,Mixed,115,70,185
214643,0,2 user reviews,2,0,2
214649,0,6 user reviews,6,0,6
214700,5,Mixed,609,329,938
214730,8,Very Positive,574,96,670
214770,8,Very Positive,1597,126,1723
214790,8,Very Positive,464,67,531
214830,8,Very Positive,541,68,609
214850,8,Very Positive,93,13,106
214870,5,Mixed,486,209,695
214910,4,Mostly Negative,41,62,103
214930,5,Mixed,69,40,109
214931,6,Mostly Positive,370,117,487
214932,8,Very Positive,481,102,583
214933,8,Very Positive,208,31,239
214950,6,Mostly Positive,15198,3879,19077
214970,8,Very Positive,416,44,460
214986,0,1 user reviews,1,0,1
214987,0,6 user reviews,2,4,6
214988,0,7 user reviews,2,5,7
214990,0,5 user reviews,3,2,5
214991,5,Mixed,8,4,12
215000,0,3 user reviews,3,0,3
215001,7,Positive,19,4,23
215002,0,9 user reviews,5,4,9
215003,7,Positive,12,1,13
215004,0,7 user reviews,6,1,7
215005,6,Mostly Positive,12,4,16
215080,5,Mixed,32,22,54
215100,5,Mixed,7,4,11
215120,0,6 user reviews,5,1,6
215160,8,Very Positive,683,86,769
215200,0,5 user reviews,3,2,5
215240,0,2 user reviews,0,2,2
215241,0,4 user reviews,1,3,4
215242,0,8 user reviews,3,5,8
215243,0,2 user reviews,1,1,2
215244,0,2 user reviews,0,2,2
215245,0,6 user reviews,0,6,6
215246,0,5 user reviews,1,4,5
215247,0,5 user reviews,3,2,5
215248,0,3 user reviews,2,1,3
215249,0,3 user reviews,0,3,3
215251,0,3 user reviews,1,2,3
215253,0,4 user reviews,2,2,4
215255,0,3 user reviews,1,2,3
215256,5,Mixed,21,12,33
215257,5,Mixed,11,5,16
215258,7,Positive,11,2,13
215259,0,4 user reviews,1,3,4
215280,6,Mostly Positive,2280,960,3240
215370,0,5 user reviews,4,1,5
215371,0,3 user reviews,2,1,3
215373,0,4 user reviews,3,1,4
215374,0,8 user reviews,8,0,8
215390,4,Mostly Negative,4,7,11
215450,7,Positive,22,0,22
215470,6,Mostly Positive,1966,526,2492
215510,6,Mostly Positive,378,148,526
215530,8,Very Positive,2016,472,2488
215533,0,4 user reviews,2,2,4
215534,6,Mostly Positive,11,4,15
215535,7,Positive,14,3,17
215536,7,Positive,9,2,11
215550,5,Mixed,30,25,55
215630,5,Mixed,120,61,181
215670,6,Mostly Positive,576,245,821
215690,8,Very Positive,278,51,329
215710,8,Very Positive,119,19,138
215770,5,Mixed,10,15,25
215790,4,Mostly Negative,37,142,179
215812,0,1 user reviews,0,1,1
215813,0,2 user reviews,1,1,2
215814,0,4 user reviews,2,2,4
215815,0,3 user reviews,2,1,3
215817,0,1 user reviews,0,1,1
215818,0,3 user reviews,0,3,3
215819,0,1 user reviews,0,1,1
215820,0,1 user reviews,0,1,1
215824,0,6 user reviews,3,3,6
215825,0,1 user reviews,1,0,1
215826,0,4 user reviews,3,1,4
215827,0,4 user reviews,3,1,4
215830,8,Very Positive,139,30,169
215850,0,3 user reviews,2,1,3
215923,0,1 user reviews,0,1,1
215930,5,Mixed,148,92,240
215970,0,6 user reviews,2,4,6
215971,0,3 user reviews,1,2,3
215972,0,2 user reviews,2,0,2
215992,0,3 user reviews,3,0,3
215993,0,1 user reviews,1,0,1
215997,0,1 user reviews,1,0,1
215998,0,3 user reviews,2,1,3
216090,8,Very Positive,181,12,193
216110,6,Mostly Positive,217,65,282
216130,4,Mostly Negative,19,68,87
216150,5,Mixed,51,37,88
216172,7,Positive,10,1,11
216173,0,7 user reviews,6,1,7
216174,7,Positive,9,2,11
216210,5,Mixed,21,17,38
216250,6,Mostly Positive,1577,407,1984
216260,8,Very Positive,357,49,406
216290,8,Very Positive,108,9,117
216332,0,3 user reviews,1,2,3
216333,0,9 user reviews,7,2,9
216334,0,2 user reviews,0,2,2
216335,0,4 user reviews,1,3,4
216390,5,Mixed,129,67,196
216411,0,8 user reviews,5,3,8
216412,0,6 user reviews,5,1,6
216413,0,7 user reviews,4,3,7
216414,7,Positive,9,1,10
216415,0,7 user reviews,5,2,7
216416,0,5 user reviews,4,1,5
216417,0,5 user reviews,4,1,5
216418,0,7 user reviews,5,2,7
216419,0,9 user reviews,7,2,9
216420,7,Positive,9,1,10
216421,0,8 user reviews,6,2,8
216430,0,3 user reviews,3,0,3
216431,0,2 user reviews,2,0,2
216432,0,1 user reviews,1,0,1
216433,0,1 user reviews,1,0,1
216434,0,1 user reviews,1,0,1
216436,0,1 user reviews,1,0,1
216437,0,1 user reviews,1,0,1
216441,0,3 user reviews,2,1,3
216444,0,2 user reviews,1,1,2
216445,0,1 user reviews,1,0,1
216448,0,1 user reviews,0,1,1
216452,0,4 user reviews,4,0,4
216462,0,2 user reviews,2,0,2
216464,0,2 user reviews,2,0,2
216465,0,1 user reviews,1,0,1
216468,0,2 user reviews,2,0,2
216610,7,Positive,12,0,12
216670,7,Positive,31,1,32
216890,6,Mostly Positive,679,188,867
216910,6,Mostly Positive,399,159,558
216930,0,4 user reviews,4,0,4
217060,5,Mixed,37,48,85
217100,5,Mixed,166,203,369
217120,8,Very Positive,47,4,51
217140,5,Mixed,841,368,1209
217200,8,Very Positive,1594,114,1708
217270,6,Mostly Positive,48,14,62
217290,8,Very Positive,126,22,148
217300,0,2 user reviews,2,0,2
217350,0,1 user reviews,1,0,1
217370,7,Positive,27,2,29
217390,0,2 user reviews,1,1,2
217410,0,5 user reviews,2,3,5
217690,5,Mixed,316,217,533
217750,5,Mixed,9,7,16
217790,6,Mostly Positive,129,53,182
217810,0,4 user reviews,4,0,4
217860,5,Mixed,72,65,137
217900,8,Very Positive,137,24,161
217920,5,Mixed,279,123,402
217941,0,2 user reviews,2,0,2
217961,0,8 user reviews,8,0,8
217962,7,Positive,10,0,10
217980,9,Overwhelmingly Positive,695,21,716
218020,7,Positive,42,6,48
218040,5,Mixed,34,32,66
218060,8,Very Positive,913,61,974
218065,7,Positive,16,0,16
218090,6,Mostly Positive,358,97,455
218100,0,7 user reviews,6,1,7
218130,5,Mixed,141,105,246
218230,6,Mostly Positive,270,93,363
218240,7,Positive,18,1,19
218241,7,Positive,15,1,16
218242,7,Positive,21,1,22
218290,0,1 user reviews,1,0,1
218410,9,Overwhelmingly Positive,1572,54,1626
218461,0,1 user reviews,1,0,1
218510,5,Mixed,79,63,142
218550,8,Very Positive,692,52,744
218560,4,Mostly Negative,56,128,184
218620,8,Very Positive,87618,18413,106031
218640,6,Mostly Positive,1617,458,2075
218660,6,Mostly Positive,34,9,43
218680,8,Very Positive,3318,300,3618
218700,6,Mostly Positive,18,6,24
218740,6,Mostly Positive,103,44,147
218760,8,Very Positive,122,13,135
218780,0,5 user reviews,3,2,5
218784,4,Mostly Negative,3,10,13
218785,7,Positive,21,0,21
218786,7,Positive,18,0,18
218820,6,Mostly Positive,580,196,776
218843,0,2 user reviews,2,0,2
218844,0,1 user reviews,1,0,1
218980,2,Very Negative,14,76,90
219070,0,4 user reviews,1,3,4
219092,8,Very Positive,58,9,67
219097,8,Very Positive,45,10,55
219098,8,Very Positive,55,3,58
219101,8,Very Positive,47,4,51
219103,8,Very Positive,74,3,77
219130,0,1 user reviews,1,0,1
219131,0,1 user reviews,1,0,1
219136,0,2 user reviews,1,1,2
219150,9,Overwhelmingly Positive,23535,695,24230
219152,8,Very Positive,87,5,92
219190,8,Very Positive,255,38,293
219200,8,Very Positive,139,25,164
219340,0,1 user reviews,0,1,1
219440,6,Mostly Positive,13,4,17
219441,0,5 user reviews,3,2,5
219442,0,6 user reviews,4,2,6
219443,5,Mixed,25,11,36
219444,0,7 user reviews,6,1,7
219445,5,Mixed,6,5,11
219446,7,Positive,10,1,11
219447,4,Mostly Negative,5,8,13
219600,8,Very Positive,170,40,210
219640,8,Very Positive,18010,4126,22136
219680,8,Very Positive,829,206,1035
219700,0,1 user reviews,0,1,1
219740,9,Overwhelmingly Positive,25294,837,26131
219750,8,Very Positive,51,4,55
219760,5,Mixed,72,78,150
219780,6,Mostly Positive,883,250,1133
219800,5,Mixed,26,13,39
219830,8,Very Positive,1484,340,1824
219890,9,Overwhelmingly Positive,7712,366,8078
219910,8,Very Positive,513,89,602
219950,8,Very Positive,364,48,412
219990,8,Very Positive,19582,1057,20639
220050,5,Mixed,147,212,359
220090,8,Very Positive,396,60,456
220160,6,Mostly Positive,849,297,1146
220200,8,Very Positive,42460,2601,45061
220240,8,Very Positive,20043,3209,23252
220260,8,Very Positive,1393,174,1567
220285,0,2 user reviews,2,0,2
220420,7,Positive,19,3,22
220440,8,Very Positive,3666,316,3982
220460,8,Very Positive,339,63,402
220660,5,Mixed,378,561,939
220700,8,Very Positive,1715,106,1821
220740,8,Very Positive,398,71,469
220760,8,Very Positive,582,92,674
220780,8,Very Positive,2843,177,3020
220811,0,1 user reviews,0,1,1
220812,0,1 user reviews,0,1,1
220813,0,2 user reviews,1,1,2
220820,8,Very Positive,690,136,826
220822,0,5 user reviews,5,0,5
220823,0,9 user reviews,8,1,9
220824,0,7 user reviews,7,0,7
220825,0,6 user reviews,6,0,6
220860,8,Very Positive,1060,201,1261
220900,7,Positive,14,3,17
220960,0,8 user reviews,7,1,8
220980,6,Mostly Positive,103,41,144
221001,8,Very Positive,55,5,60
221020,4,Mostly Negative,476,1440,1916
221040,6,Mostly Positive,3708,1445,5153
221100,5,Mixed,65946,40739,106685
221161,0,9 user reviews,4,5,9
221162,5,Mixed,10,9,19
221165,6,Mostly Positive,10,3,13
221166,6,Mostly Positive,8,3,11
221167,0,8 user reviews,7,1,8
221168,6,Mostly Positive,10,4,14
221169,0,1 user reviews,0,1,1
221180,8,Very Positive,224,20,244
221260,9,Overwhelmingly Positive,3089,161,3250
221340,6,Mostly Positive,19,8,27
221380,8,Very Positive,28256,1597,29853
221430,7,Positive,12,0,12
221540,8,Very Positive,982,212,1194
221560,5,Mixed,75,90,165
221640,9,Overwhelmingly Positive,10232,286,10518
221680,8,Very Positive,5139,526,5665
221810,8,Very Positive,846,170,1016
221829,0,3 user reviews,3,0,3
221830,8,Very Positive,122,30,152
221910,8,Very Positive,21995,1924,23919
222021,6,Mostly Positive,21,8,29
222044,0,2 user reviews,2,0,2
222051,0,1 user reviews,1,0,1
222055,0,1 user reviews,1,0,1
222057,0,4 user reviews,4,0,4
222064,0,1 user reviews,1,0,1
222073,0,4 user reviews,4,0,4
222075,0,1 user reviews,1,0,1
222081,0,1 user reviews,0,1,1
222090,0,1 user reviews,1,0,1
222092,0,1 user reviews,1,0,1
222093,0,1 user reviews,1,0,1
222095,0,1 user reviews,0,1,1
222100,0,1 user reviews,1,0,1
222113,0,4 user reviews,3,1,4
222114,0,1 user reviews,1,0,1
222122,0,2 user reviews,1,1,2
222140,5,Mixed,139,60,199
222160,5,Mixed,61,45,106
222180,0,9 user reviews,5,4,9
222221,0,3 user reviews,3,0,3
222222,0,4 user reviews,3,1,4
222223,0,2 user reviews,2,0,2
222280,7,Positive,19,3,22
222281,0,5 user reviews,2,3,5
222282,5,Mixed,7,4,11
222283,0,7 user reviews,5,2,7
222284,5,Mixed,7,4,11
222285,0,4 user reviews,2,2,4
222380,0,5 user reviews,5,0,5
222420,8,Very Positive,317,33,350
222440,8,Very Positive,408,14,422
222480,8,Very Positive,1336,272,1608
222520,0,4 user reviews,2,2,4
222532,0,1 user reviews,1,0,1
222540,0,1 user reviews,1,0,1
222541,5,Mixed,9,4,13
222542,7,Positive,18,1,19
222543,7,Positive,14,0,14
222544,7,Positive,11,1,12
222545,0,9 user reviews,7,2,9
222547,0,4 user reviews,2,2,4
222548,0,1 user reviews,1,0,1
222549,7,Positive,22,2,24
222550,0,3 user reviews,2,1,3
222551,7,Positive,10,2,12
222554,7,Positive,26,2,28
222555,0,6 user reviews,4,2,6
222556,0,7 user reviews,5,2,7
222557,6,Mostly Positive,41,13,54
222558,6,Mostly Positive,18,5,23
222561,7,Positive,19,3,22
222562,6,Mostly Positive,12,4,16
222564,0,7 user reviews,7,0,7
222566,7,Positive,11,0,11
222567,7,Positive,19,0,19
222568,0,7 user reviews,5,2,7
222569,0,3 user reviews,3,0,3
222570,0,3 user reviews,2,1,3
222571,7,Positive,10,0,10
222573,7,Positive,12,0,12
222574,0,6 user reviews,5,1,6
222575,6,Mostly Positive,15,4,19
222576,7,Positive,10,0,10
222577,0,8 user reviews,8,0,8
222578,0,8 user reviews,6,2,8
222579,0,9 user reviews,9,0,9
222580,0,5 user reviews,2,3,5
222581,7,Positive,11,0,11
222582,7,Positive,34,5,39
222583,0,5 user reviews,5,0,5
222584,7,Positive,19,4,23
222585,0,9 user reviews,5,4,9
222586,0,9 user reviews,6,3,9
222587,0,7 user reviews,6,1,7
222588,7,Positive,16,4,20
222589,0,3 user reviews,3,0,3
222590,7,Positive,14,0,14
222591,0,8 user reviews,7,1,8
222593,7,Positive,36,9,45
222594,0,3 user reviews,3,0,3
222595,0,4 user reviews,4,0,4
222596,7,Positive,16,0,16
222597,7,Positive,33,3,36
222598,0,3 user reviews,3,0,3
222599,7,Positive,13,0,13
222601,0,3 user reviews,1,2,3
222603,7,Positive,20,4,24
222604,7,Positive,13,2,15
222606,0,7 user reviews,7,0,7
222607,0,9 user reviews,9,0,9
222608,0,9 user reviews,5,4,9
222610,5,Mixed,5,5,10
222611,5,Mixed,10,8,18
222612,0,8 user reviews,8,0,8
222613,7,Positive,30,6,36
222616,0,7 user reviews,5,2,7
222617,7,Positive,21,1,22
222618,7,Positive,9,2,11
222619,7,Positive,11,0,11
222622,5,Mixed,10,9,19
222623,4,Mostly Negative,5,20,25
222624,0,3 user reviews,2,1,3
222625,6,Mostly Positive,28,11,39
222626,0,1 user reviews,0,1,1
222627,6,Mostly Positive,26,7,33
222628,6,Mostly Positive,7,3,10
222629,0,6 user reviews,5,1,6
222630,0,3 user reviews,3,0,3
222631,5,Mixed,11,14,25
222632,8,Very Positive,44,6,50
222633,6,Mostly Positive,8,3,11
222634,0,9 user reviews,9,0,9
222635,0,9 user reviews,7,2,9
222636,0,3 user reviews,2,1,3
222639,0,7 user reviews,4,3,7
222640,6,Mostly Positive,255,67,322
222660,8,Very Positive,127,17,144
222680,0,4 user reviews,4,0,4
222710,5,Mixed,81,43,124
222730,6,Mostly Positive,1686,480,2166
222750,8,Very Positive,1829,250,2079
222801,0,3 user reviews,2,1,3
222802,0,3 user reviews,1,2,3
222804,0,8 user reviews,7,1,8
222805,0,6 user reviews,2,4,6
222806,0,3 user reviews,2,1,3
222807,0,6 user reviews,5,1,6
222820,0,7 user reviews,6,1,7
222860,0,4 user reviews,3,1,4
222880,8,Very Positive,31987,2751,34738
222900,8,Very Positive,171,14,185
222940,8,Very Positive,1090,122,1212
222980,8,Very Positive,891,147,1038
223000,7,Positive,26,1,27
223100,5,Mixed,2240,1207,3447
223180,7,Positive,25,3,28
223220,8,Very Positive,378,87,465
223261,0,3 user reviews,3,0,3
223262,0,2 user reviews,2,0,2
223280,7,Positive,27,4,31
223330,5,Mixed,151,116,267
223350,0,3 user reviews,2,1,3
223390,5,Mixed,125,82,207
223410,5,Mixed,292,126,418
223430,4,Mostly Negative,50,125,175
223450,8,Very Positive,115,26,141
223470,9,Overwhelmingly Positive,17575,716,18291
223490,5,Mixed,190,262,452
223510,6,Mostly Positive,534,154,688
223592,5,Mixed,4,6,10
223593,8,Very Positive,107,18,125
223594,8,Very Positive,88,10,98
223595,5,Mixed,6,4,10
223597,6,Mostly Positive,68,20,88
223598,4,Mostly Negative,75,123,198
223630,5,Mixed,82,44,126
223670,8,Very Positive,492,66,558
223691,0,1 user reviews,1,0,1
223710,6,Mostly Positive,105,36,141
223730,8,Very Positive,130,13,143
223750,8,Very Positive,138,23,161
223770,7,Positive,24,4,28
223790,7,Positive,28,3,31
223792,7,Positive,17,4,21
223793,5,Mixed,70,57,127
223810,8,Very Positive,870,114,984
223830,8,Very Positive,1533,213,1746
223850,8,Very Positive,2271,218,2489
223870,7,Positive,42,3,45
224040,6,Mostly Positive,78,31,109
224060,8,Very Positive,1395,138,1533
224140,5,Mixed,18,11,29
224141,5,Mixed,13,12,25
224142,5,Mixed,17,11,28
224143,6,Mostly Positive,24,10,34
224144,5,Mixed,14,14,28
224145,5,Mixed,24,11,35
224160,5,Mixed,17,13,30
224161,6,Mostly Positive,33,12,45
224162,5,Mixed,16,12,28
224163,5,Mixed,17,12,29
224164,5,Mixed,25,11,36
224165,5,Mixed,16,12,28
224166,5,Mixed,22,13,35
224167,5,Mixed,15,13,28
224168,5,Mixed,19,14,33
224180,6,Mostly Positive,182,49,231
224200,8,Very Positive,118,25,143
224243,0,1 user reviews,1,0,1
224260,8,Very Positive,262,54,316
224280,0,1 user reviews,0,1,1
224300,8,Very Positive,257,49,306
224340,4,Mostly Negative,10,17,27
224360,0,1 user reviews,0,1,1
224380,4,Mostly Negative,8,19,27
224420,5,Mixed,154,118,272
224440,5,Mixed,865,1174,2039
224460,8,Very Positive,1929,231,2160
224462,0,4 user reviews,4,0,4
224480,8,Very Positive,4327,332,4659
224500,6,Mostly Positive,1514,466,1980
224540,5,Mixed,3234,2987,6221
224580,8,Very Positive,149,28,177
224600,6,Mostly Positive,1170,468,1638
224610,5,Mixed,7,4,11
224740,5,Mixed,221,280,501
224760,8,Very Positive,4379,438,4817
224820,9,Overwhelmingly Positive,901,34,935
224860,4,Mostly Negative,62,128,190
224900,5,Mixed,122,72,194
224920,5,Mixed,413,214,627
224940,5,Mixed,156,81,237
224960,8,Very Positive,857,212,1069
224980,8,Very Positive,213,39,252
225000,6,Mostly Positive,113,45,158
225020,5,Mixed,184,150,334
225080,8,Very Positive,14371,814,15185
225140,9,Overwhelmingly Positive,1791,39,1830
225160,8,Very Positive,1077,115,1192
225180,5,Mixed,34,15,49
225200,4,Mostly Negative,6,10,16
225260,8,Very Positive,3897,266,4163
225270,7,Positive,21,3,24
225280,8,Very Positive,223,34,257
225300,8,Very Positive,435,73,508
225320,8,Very Positive,255,48,303
225340,8,Very Positive,679,79,758
225360,5,Mixed,141,187,328
225420,5,Mixed,282,254,536
225424,0,2 user reviews,1,1,2
225429,0,3 user reviews,3,0,3
225430,0,1 user reviews,1,0,1
225431,0,3 user reviews,3,0,3
225432,0,1 user reviews,1,0,1
225434,0,7 user reviews,7,0,7
225540,6,Mostly Positive,20613,5232,25845
225600,6,Mostly Positive,1368,569,1937
225640,6,Mostly Positive,515,198,713
225780,0,3 user reviews,3,0,3
225820,5,Mixed,15,17,32
225821,6,Mostly Positive,38,12,50
225822,5,Mixed,12,15,27
225823,5,Mixed,18,16,34
225824,5,Mixed,28,17,45
225825,5,Mixed,17,15,32
225826,5,Mixed,25,15,40
225827,5,Mixed,25,13,38
225828,5,Mixed,10,12,22
225829,4,Mostly Negative,11,17,28
225830,6,Mostly Positive,50,19,69
225831,5,Mixed,23,12,35
225832,5,Mixed,30,17,47
225833,8,Very Positive,81,13,94
225834,6,Mostly Positive,41,17,58
225840,8,Very Positive,127,10,137
226100,6,Mostly Positive,290,104,394
226120,6,Mostly Positive,81,30,111
226320,4,Mostly Negative,189,427,616
226350,0,3 user reviews,2,1,3
226370,0,3 user reviews,2,1,3
226390,0,1 user reviews,0,1,1
226459,6,Mostly Positive,22,8,30
226560,5,Mixed,109,104,213
226580,6,Mostly Positive,302,85,387
226620,8,Very Positive,561,77,638
226660,0,8 user reviews,6,2,8
226662,5,Mixed,6,4,10
226663,7,Positive,21,5,26
226664,0,9 user reviews,5,4,9
226665,4,Mostly Negative,40,101,141
226666,4,Mostly Negative,27,63,90
226667,6,Mostly Positive,60,17,77
226668,5,Mixed,6,4,10
226669,0,8 user reviews,2,6,8
226670,0,4 user reviews,1,3,4
226671,0,3 user reviews,2,1,3
226672,5,Mixed,5,6,11
226673,5,Mixed,6,5,11
226700,4,Mostly Negative,2527,5411,7938
226720,5,Mixed,424,275,699
226740,6,Mostly Positive,511,158,669
226760,6,Mostly Positive,9,3,12
226780,5,Mixed,21,26,47
226820,8,Very Positive,83,7,90
226840,8,Very Positive,2996,688,3684
226860,6,Mostly Positive,4567,1307,5874
226880,8,Very Positive,569,62,631
226960,6,Mostly Positive,118,41,159
226980,8,Very Positive,825,60,885
226990,0,4 user reviews,4,0,4
226991,0,4 user reviews,3,1,4
226992,0,2 user reviews,2,0,2
226993,0,3 user reviews,3,0,3
226994,0,2 user reviews,2,0,2
226995,0,4 user reviews,4,0,4
226996,0,4 user reviews,3,1,4
226997,0,5 user reviews,4,1,5
226998,0,5 user reviews,5,0,5
226999,3,Negative,2,12,14
227000,9,Overwhelmingly Positive,1737,30,1767
227020,5,Mixed,72,53,125
227060,5,Mixed,128,94,222
227080,8,Very Positive,523,28,551
227090,0,3 user reviews,3,0,3
227100,8,Very Positive,1289,177,1466
227129,0,4 user reviews,2,2,4
227130,4,Mostly Negative,14,35,49
227131,4,Mostly Negative,4,10,14
227132,4,Mostly Negative,12,19,31
227160,1,Overwhelmingly Negative,208,955,1163
227180,5,Mixed,254,220,474
227200,8,Very Positive,427,43,470
227220,8,Very Positive,717,96,813
227240,0,7 user reviews,5,2,7
227260,8,Very Positive,449,48,497
227280,6,Mostly Positive,305,122,427
227300,9,Overwhelmingly Positive,51992,1436,53428
227310,8,Very Positive,375,28,403
227320,8,Very Positive,990,91,1081
227380,6,Mostly Positive,224,74,298
227400,5,Mixed,172,99,271
227480,5,Mixed,517,291,808
227560,5,Mixed,67,38,105
227580,8,Very Positive,943,116,1059
227600,8,Very Positive,564,68,632
227680,1,Overwhelmingly Negative,729,5332,6061
227720,5,Mixed,95,84,179
227760,5,Mixed,88,47,135
227780,8,Very Positive,634,85,719
227800,6,Mostly Positive,46,15,61
227860,5,Mixed,1705,1481,3186
227940,5,Mixed,577,471,1048
228180,6,Mostly Positive,774,222,996
228200,8,Very Positive,1895,128,2023
228260,6,Mostly Positive,765,225,990
228280,8,Very Positive,4256,462,4718
228300,6,Mostly Positive,2921,764,3685
228320,5,Mixed,43,48,91
228360,8,Very Positive,674,48,722
228380,8,Very Positive,8732,1765,10497
228400,5,Mixed,810,828,1638
228421,0,1 user reviews,1,0,1
228440,5,Mixed,57,30,87
228560,5,Mixed,190,172,362
228600,0,6 user reviews,6,0,6
228601,7,Positive,28,1,29
228760,6,Mostly Positive,429,130,559
228880,5,Mixed,617,318,935
228940,6,Mostly Positive,66,24,90
228960,8,Very Positive,148,18,166
229080,0,4 user reviews,3,1,4
229190,0,4 user reviews,2,2,4
229210,0,7 user reviews,6,1,7
229230,0,7 user reviews,6,1,7
229250,0,6 user reviews,2,4,6
229270,6,Mostly Positive,8,3,11
229290,0,8 user reviews,7,1,8
229310,6,Mostly Positive,8,3,11
229480,8,Very Positive,440,72,512
229520,5,Mixed,121,68,189
229560,0,7 user reviews,1,6,7
229580,5,Mixed,318,253,571
229600,5,Mixed,46,51,97
229626,7,Positive,14,1,15
229627,5,Mixed,10,5,15
229629,0,7 user reviews,2,5,7
229630,6,Mostly Positive,7,3,10
229660,7,Positive,40,4,44
229750,0,9 user reviews,8,1,9
229751,0,5 user reviews,4,1,5
229752,7,Positive,11,2,13
229753,7,Positive,10,2,12
229754,7,Positive,13,2,15
229755,0,3 user reviews,3,0,3
229757,0,3 user reviews,3,0,3
229758,0,4 user reviews,4,0,4
229790,0,3 user reviews,2,1,3
229810,5,Mixed,36,22,58
229870,8,Very Positive,185,44,229
229890,6,Mostly Positive,26,9,35
229950,0,1 user reviews,1,0,1
229970,5,Mixed,29,21,50
230050,8,Very Positive,3028,487,3515
230070,6,Mostly Positive,1284,338,1622
230090,8,Very Positive,307,13,320
230150,6,Mostly Positive,77,25,102
230190,8,Very Positive,2525,412,2937
230230,8,Very Positive,4783,517,5300
230270,9,Overwhelmingly Positive,1354,57,1411
230290,9,Overwhelmingly Positive,6352,320,6672
230310,4,Mostly Negative,36,88,124
230330,8,Very Positive,123,22,145
230350,8,Very Positive,123,22,145
230410,8,Very Positive,1009,136,1145
230650,4,Mostly Negative,46,75,121
230691,0,1 user reviews,0,1,1
230700,8,Very Positive,903,183,1086
230760,0,2 user reviews,0,2,2
230780,8,Very Positive,43,7,50
230791,0,2 user reviews,1,1,2
230820,8,Very Positive,662,89,751
230840,5,Mixed,232,262,494
230860,8,Very Positive,328,32,360
230880,0,3 user reviews,3,0,3
230882,0,4 user reviews,3,1,4
230883,7,Positive,11,0,11
230884,0,5 user reviews,4,1,5
230885,0,2 user reviews,2,0,2
230886,0,2 user reviews,2,0,2
230887,0,4 user reviews,4,0,4
230888,0,6 user reviews,6,0,6
230890,0,6 user reviews,6,0,6
230891,0,2 user reviews,2,0,2
230892,7,Positive,10,0,10
230900,0,3 user reviews,3,0,3
230920,0,2 user reviews,1,1,2
230940,5,Mixed,55,25,80
230980,6,Mostly Positive,113,30,143
231020,5,Mixed,20,15,35
231040,8,Very Positive,161,35,196
231060,0,9 user reviews,5,4,9
231120,0,2 user reviews,2,0,2
231140,5,Mixed,263,291,554
231160,8,Very Positive,2703,153,2856
231180,8,Very Positive,58,3,61
231200,8,Very Positive,1291,252,1543
231310,5,Mixed,150,88,238
231330,6,Mostly Positive,331,126,457
231430,8,Very Positive,15000,3233,18233
231456,0,2 user reviews,1,1,2
231460,0,1 user reviews,0,1,1
231462,0,1 user reviews,1,0,1
231463,0,3 user reviews,1,2,3
231465,0,4 user reviews,4,0,4
231466,0,5 user reviews,5,0,5
231479,4,Mostly Negative,19,29,48
231480,5,Mixed,14,14,28
231504,0,1 user reviews,1,0,1
231670,8,Very Positive,750,95,845
231720,4,Mostly Negative,14,33,47
231740,8,Very Positive,832,203,1035
231910,8,Very Positive,141,35,176
231990,5,Mixed,118,78,196
232010,6,Mostly Positive,1179,312,1491
232050,5,Mixed,432,296,728
232090,8,Very Positive,27998,4081,32079
232191,0,3 user reviews,2,1,3
232430,6,Mostly Positive,7397,2271,9668
232450,5,Mixed,32,21,53
232530,0,8 user reviews,7,1,8
232550,6,Mostly Positive,9,3,12
232570,6,Mostly Positive,9,3,12
232590,5,Mixed,9,8,17
232634,7,Positive,38,4,42
232647,6,Mostly Positive,14,6,20
232670,0,8 user reviews,5,3,8
232750,6,Mostly Positive,751,281,1032
232770,8,Very Positive,985,160,1145
232790,8,Very Positive,2350,552,2902
232810,4,Mostly Negative,987,3288,4275
232890,5,Mixed,1395,895,2290
232910,8,Very Positive,1274,306,1580
232950,5,Mixed,59,75,134
232970,8,Very Positive,119,19,138
232990,0,1 user reviews,1,0,1
233110,4,Mostly Negative,31,47,78
233130,8,Very Positive,6508,393,6901
233150,8,Very Positive,1969,167,2136
233190,6,Mostly Positive,173,50,223
233210,4,Mostly Negative,35,78,113
233230,6,Mostly Positive,708,248,956
233250,5,Mixed,4208,3299,7507
233270,8,Very Positive,6482,944,7426
233290,6,Mostly Positive,2158,543,2701
233310,6,Mostly Positive,76,22,98
233350,8,Very Positive,241,45,286
233370,6,Mostly Positive,254,99,353
233390,5,Mixed,45,22,67
233410,8,Very Positive,57,8,65
233450,8,Very Positive,21815,2087,23902
233470,8,Very Positive,2157,531,2688
233510,5,Mixed,41,20,61
233530,4,Mostly Negative,19,49,68
233550,8,Very Positive,564,117,681
233590,0,4 user reviews,2,2,4
233591,0,2 user reviews,2,0,2
233592,0,2 user reviews,2,0,2
233610,8,Very Positive,3002,198,3200
233680,8,Very Positive,216,30,246
233700,8,Very Positive,653,106,759
233720,8,Very Positive,6252,1268,7520
233740,8,Very Positive,1585,181,1766
233800,8,Very Positive,77,11,88
233840,5,Mixed,422,187,609
233860,8,Very Positive,17574,1144,18718
233980,8,Very Positive,1323,219,1542
234000,5,Mixed,25,19,44
234022,0,1 user reviews,1,0,1
234060,5,Mixed,21,29,50
234080,6,Mostly Positive,1482,575,2057
234140,8,Very Positive,13196,1528,14724
234160,8,Very Positive,266,47,313
234190,8,Very Positive,1714,242,1956
234270,8,Very Positive,682,41,723
234290,5,Mixed,45,37,82
234330,5,Mixed,7,8,15
234350,0,9 user reviews,8,1,9
234370,5,Mixed,8,10,18
234390,8,Very Positive,609,71,680
234490,5,Mixed,75,60,135
234510,8,Very Positive,63,0,63
234530,5,Mixed,325,285,610
234570,0,2 user reviews,0,2,2
234630,6,Mostly Positive,2496,1020,3516
234650,8,Very Positive,5076,633,5709
234670,8,Very Positive,2383,319,2702
234710,8,Very Positive,3131,540,3671
234770,5,Mixed,13,17,30
234771,0,7 user reviews,6,1,7
234772,7,Positive,14,0,14
234773,7,Positive,10,1,11
234774,0,4 user reviews,3,1,4
234775,0,6 user reviews,3,3,6
234776,7,Positive,14,1,15
234777,0,5 user reviews,4,1,5
234778,0,3 user reviews,2,1,3
234779,0,4 user reviews,3,1,4
234780,0,3 user reviews,2,1,3
234781,0,3 user reviews,2,1,3
234782,0,7 user reviews,6,1,7
234783,0,3 user reviews,2,1,3
234784,0,5 user reviews,3,2,5
234785,7,Positive,12,2,14
234786,0,3 user reviews,2,1,3
234787,7,Positive,17,3,20
234788,7,Positive,14,1,15
234789,0,3 user reviews,2,1,3
234790,0,3 user reviews,2,1,3
234791,0,8 user reviews,8,0,8
234792,0,9 user reviews,8,1,9
234793,0,5 user reviews,4,1,5
234794,0,4 user reviews,3,1,4
234820,6,Mostly Positive,173,67,240
234860,0,4 user reviews,1,3,4
234880,0,4 user reviews,4,0,4
234900,8,Very Positive,451,71,522
234920,6,Mostly Positive,113,31,144
234940,8,Very Positive,208,49,257
234980,2,Very Negative,11,79,90
235070,5,Mixed,39,25,64
235130,0,5 user reviews,4,1,5
235140,0,1 user reviews,1,0,1
235150,0,7 user reviews,7,0,7
235210,8,Very Positive,923,137,1060
235230,0,1 user reviews,1,0,1
235250,8,Very Positive,466,79,545
235320,8,Very Positive,379,41,420
235340,0,6 user reviews,2,4,6
235360,6,Mostly Positive,253,90,343
235380,5,Mixed,602,505,1107
235460,8,Very Positive,8845,717,9562
235520,6,Mostly Positive,60,19,79
235540,8,Very Positive,5980,1161,7141
235580,9,Overwhelmingly Positive,664,28,692
235584,8,Very Positive,66,14,80
235585,6,Mostly Positive,15,4,19
235600,6,Mostly Positive,3968,1068,5036
235620,6,Mostly Positive,315,115,430
235660,6,Mostly Positive,64,18,82
235700,6,Mostly Positive,27,7,34
235720,7,Positive,15,3,18
235780,7,Positive,8,2,10
235800,6,Mostly Positive,2268,640,2908
235820,8,Very Positive,236,47,283
235883,3,Negative,3,23,26
235900,8,Very Positive,298,30,328
235980,8,Very Positive,107,1,108
236010,0,1 user reviews,0,1,1
236090,9,Overwhelmingly Positive,7589,352,7941
236110,5,Mixed,1371,726,2097
236130,5,Mixed,134,96,230
236150,6,Mostly Positive,1552,592,2144
236290,0,9 user reviews,8,1,9
236370,5,Mixed,1861,1342,3203
236390,5,Mixed,478,210,688
236430,8,Very Positive,10492,1855,12347
236450,9,Overwhelmingly Positive,2129,89,2218
236490,5,Mixed,9,6,15
236510,4,Mostly Negative,659,1208,1867
236530,4,Mostly Negative,4,15,19
236570,0,1 user reviews,1,0,1
236660,0,1 user reviews,1,0,1
236690,6,Mostly Positive,2450,781,3231
236730,6,Mostly Positive,98,37,135
236790,2,Very Negative,40,162,202
236850,8,Very Positive,27010,4142,31152
236870,6,Mostly Positive,7972,2041,10013
236890,5,Mixed,13,9,22
236930,8,Very Positive,373,10,383
236970,5,Mixed,6,7,13
237010,6,Mostly Positive,12,4,16
237030,7,Positive,14,2,16
237050,7,Positive,13,2,15
237070,7,Positive,14,2,16
237090,7,Positive,13,1,14
237151,0,8 user reviews,5,3,8
237310,6,Mostly Positive,29,11,40
237350,6,Mostly Positive,103,37,140
237370,5,Mixed,109,70,179
237430,6,Mostly Positive,444,117,561
237450,0,4 user reviews,2,2,4
237470,5,Mixed,51,41,92
237550,4,Mostly Negative,41,62,103
237570,8,Very Positive,161,26,187
237590,4,Mostly Negative,22,40,62
237619,5,Mixed,17,23,40
237620,5,Mixed,12,13,25
237630,8,Very Positive,1887,308,2195
237680,0,2 user reviews,2,0,2
237700,0,2 user reviews,2,0,2
237740,8,Very Positive,1630,191,1821
237760,8,Very Positive,64,3,67
237850,8,Very Positive,1309,306,1615
237870,5,Mixed,1814,1152,2966
237890,5,Mixed,787,343,1130
237930,8,Very Positive,12892,750,13642
237950,5,Mixed,89,47,136
237970,5,Mixed,23,17,40
237990,8,Very Positive,5626,746,6372
238010,8,Very Positive,7668,721,8389
238050,8,Very Positive,149,11,160
238070,0,5 user reviews,2,3,5
238090,6,Mostly Positive,3675,1158,4833
238170,4,Mostly Negative,52,135,187
238210,8,Very Positive,3246,172,3418
238240,4,Mostly Negative,520,1011,1531
238251,0,4 user reviews,4,0,4
238260,7,Positive,29,5,34
238270,7,Positive,11,0,11
238271,0,4 user reviews,4,0,4
238272,0,2 user reviews,2,0,2
238280,6,Mostly Positive,626,216,842
238300,7,Positive,37,4,41
238301,7,Positive,10,2,12
238302,6,Mostly Positive,28,8,36
238303,7,Positive,43,4,47
238304,5,Mixed,34,48,82
238320,9,Overwhelmingly Positive,14182,623,14805
238340,7,Positive,16,1,17
238370,6,Mostly Positive,1461,589,2050
238430,6,Mostly Positive,3610,1394,5004
238450,0,5 user reviews,5,0,5
238460,9,Overwhelmingly Positive,17454,505,17959
238480,0,1 user reviews,0,1,1
238481,7,Positive,10,2,12
238482,0,8 user reviews,7,1,8
238530,8,Very Positive,224,14,238
238630,6,Mostly Positive,85,27,112
238710,7,Positive,22,3,25
238750,5,Mixed,879,457,1336
238870,2,Very Negative,25,204,229
238890,5,Mixed,68,76,144
238900,0,1 user reviews,1,0,1
238910,8,Very Positive,190,33,223
238930,5,Mixed,152,98,250
238950,0,3 user reviews,3,0,3
238960,8,Very Positive,548,50,598
238991,0,8 user reviews,7,1,8
239030,9,Overwhelmingly Positive,19738,707,20445
239070,8,Very Positive,2033,258,2291
239090,8,Very Positive,242,17,259
239120,6,Mostly Positive,780,215,995
239140,8,Very Positive,37735,2790,40525
239160,5,Mixed,3352,1835,5187
239200,5,Mixed,1983,1192,3175
239250,6,Mostly Positive,801,232,1033
239350,8,Very Positive,7532,635,8167
239370,0,5 user reviews,2,3,5
239430,8,Very Positive,353,82,435
239450,5,Mixed,32,24,56
239550,6,Mostly Positive,328,107,435
239570,8,Very Positive,87,10,97
239660,0,5 user reviews,2,3,5
239700,8,Very Positive,276,42,318
239800,8,Very Positive,884,74,958
239820,8,Very Positive,16935,960,17895
239840,6,Mostly Positive,898,361,1259
240160,8,Very Positive,63,5,68
240180,7,Positive,32,4,36
240200,7,Positive,30,6,36
240280,7,Positive,39,6,45
240300,5,Mixed,12,17,29
240320,0,2 user reviews,1,1,2
240340,8,Very Positive,54,6,60
240360,6,Mostly Positive,22,8,30
240440,8,Very Positive,471,45,516
240460,5,Mixed,587,426,1013
240480,0,4 user reviews,4,0,4
240500,8,Very Positive,76,9,85
240600,6,Mostly Positive,136,53,189
240612,0,3 user reviews,3,0,3
240620,5,Mixed,86,61,147
240660,6,Mostly Positive,34,11,45
240720,8,Very Positive,10821,2169,12990
240760,8,Very Positive,2448,555,3003
240820,5,Mixed,13,6,19
240970,8,Very Positive,245,21,266
241000,5,Mixed,110,143,253
241070,7,Positive,17,1,18
241240,8,Very Positive,532,40,572
241260,8,Very Positive,1038,113,1151
241280,5,Mixed,296,255,551
241300,8,Very Positive,82,8,90
241320,8,Very Positive,222,19,241
241364,5,Mixed,15,12,27
241368,4,Mostly Negative,9,27,36
241369,4,Mostly Negative,31,60,91
241370,5,Mixed,7,4,11
241371,5,Mixed,8,10,18
241372,5,Mixed,12,6,18
241410,8,Very Positive,515,77,592
241430,7,Positive,34,3,37
241540,8,Very Positive,7246,1648,8894
241560,5,Mixed,2863,1646,4509
241600,8,Very Positive,8513,664,9177
241620,5,Mixed,143,78,221
241660,0,9 user reviews,8,1,9
241680,0,2 user reviews,1,1,2
241720,5,Mixed,263,260,523
241760,5,Mixed,59,30,89
241790,7,Positive,25,4,29
241910,8,Very Positive,352,78,430
241930,8,Very Positive,19923,1948,21871
241990,5,Mixed,245,106,351
242050,8,Very Positive,12420,1862,14282
242110,7,Positive,22,5,27
242120,0,4 user reviews,1,3,4
242130,5,Mixed,163,168,331
242280,0,2 user reviews,2,0,2
242290,0,1 user reviews,1,0,1
242300,5,Mixed,7,6,13
242310,6,Mostly Positive,9,3,12
242530,6,Mostly Positive,93,39,132
242550,8,Very Positive,1430,192,1622
242570,5,Mixed,698,306,1004
242590,0,2 user reviews,1,1,2
242610,0,7 user reviews,7,0,7
242630,0,1 user reviews,1,0,1
242640,8,Very Positive,2140,493,2633
242680,9,Overwhelmingly Positive,6730,218,6948
242700,8,Very Positive,2444,599,3043
242720,6,Mostly Positive,24,7,31
242760,8,Very Positive,65392,4072,69464
242780,8,Very Positive,170,41,211
242820,9,Overwhelmingly Positive,1030,51,1081
242840,6,Mostly Positive,296,85,381
242860,8,Very Positive,13729,1943,15672
242880,6,Mostly Positive,1694,443,2137
242920,8,Very Positive,17937,2101,20038
242940,6,Mostly Positive,137,35,172
242960,5,Mixed,214,119,333
242980,5,Mixed,160,105,265
243000,6,Mostly Positive,132,52,184
243020,5,Mixed,61,35,96
243040,8,Very Positive,437,47,484
243060,5,Mixed,51,28,79
243120,8,Very Positive,1293,267,1560
243160,8,Very Positive,78,15,93
243180,5,Mixed,13,12,25
243200,8,Very Positive,617,68,685
243220,8,Very Positive,274,45,319
243280,7,Positive,27,5,32
243300,3,Negative,4,25,29
243320,4,Mostly Negative,47,81,128
243360,6,Mostly Positive,103,39,142
243440,0,4 user reviews,2,2,4
243442,0,1 user reviews,0,1,1
243450,6,Mostly Positive,311,112,423
243470,5,Mixed,6983,3912,10895
243560,4,Mostly Negative,27,45,72
243780,8,Very Positive,231,45,276
243800,8,Very Positive,848,109,957
243890,5,Mixed,9,10,19
243930,5,Mixed,763,448,1211
243950,6,Mostly Positive,764,286,1050
243970,8,Very Positive,2547,219,2766
244030,5,Mixed,539,484,1023
244050,5,Mixed,158,89,247
244060,5,Mixed,9,10,19
244061,0,3 user reviews,3,0,3
244062,7,Positive,11,2,13
244063,0,5 user reviews,4,1,5
244064,0,4 user reviews,1,3,4
244065,0,9 user reviews,9,0,9
244066,0,8 user reviews,4,4,8
244070,6,Mostly Positive,147,62,209
244090,5,Mixed,73,34,107
244160,8,Very Positive,4153,634,4787
244210,8,Very Positive,10660,1385,12045
244230,6,Mostly Positive,38,12,50
244290,0,9 user reviews,8,1,9
244350,0,8 user reviews,2,6,8
244390,6,Mostly Positive,54,15,69
244410,6,Mostly Positive,109,40,149
244430,8,Very Positive,604,87,691
244450,8,Very Positive,8238,1038,9276
244590,8,Very Positive,100,25,125
244630,6,Mostly Positive,9,3,12
244690,5,Mixed,27,12,39
244710,8,Very Positive,1170,194,1364
244730,8,Very Positive,857,82,939
244750,8,Very Positive,79,19,98
244770,6,Mostly Positive,1118,479,1597
244810,6,Mostly Positive,179,47,226
244830,7,Positive,11,1,12
244850,8,Very Positive,42107,5133,47240
244870,8,Very Positive,1398,182,1580
244890,8,Very Positive,45,6,51
244910,6,Mostly Positive,443,156,599
244930,5,Mixed,986,560,1546
244950,6,Mostly Positive,16,5,21
245010,5,Mixed,30,29,59
245050,4,Mostly Negative,26,43,69
245130,4,Mostly Negative,408,804,1212
245150,6,Mostly Positive,330,86,416
245170,9,Overwhelmingly Positive,7412,385,7797
245172,8,Very Positive,49,1,50
245174,8,Very Positive,61,1,62
245175,8,Very Positive,90,3,93
245176,8,Very Positive,47,4,51
245190,0,2 user reviews,2,0,2
245191,0,7 user reviews,7,0,7
245192,0,3 user reviews,1,2,3
245193,0,5 user reviews,4,1,5
245220,0,8 user reviews,8,0,8
245280,8,Very Positive,1639,337,1976
245300,5,Mixed,65,46,111
245370,5,Mixed,96,144,240
245390,8,Very Positive,668,75,743
245410,5,Mixed,53,23,76
245430,8,Very Positive,78,10,88
245450,8,Very Positive,398,46,444
245470,6,Mostly Positive,3391,1125,4516
245490,5,Mixed,713,385,1098
245550,7,Positive,9,1,10
245580,0,3 user reviews,3,0,3
245620,6,Mostly Positive,3108,1022,4130
245660,0,1 user reviews,1,0,1
245730,5,Mixed,85,81,166
245810,8,Very Positive,138,13,151
245890,6,Mostly Positive,115,40,155
245910,5,Mixed,113,59,172
245930,8,Very Positive,168,32,200
245950,8,Very Positive,108,24,132
245970,8,Very Positive,137,22,159
246050,0,5 user reviews,5,0,5
246070,5,Mixed,226,166,392
246090,1,Overwhelmingly Negative,462,2227,2689
246110,6,Mostly Positive,627,252,879
246250,0,7 user reviews,6,1,7
246251,0,7 user reviews,7,0,7
246252,0,8 user reviews,6,2,8
246253,0,9 user reviews,8,1,9
246254,0,9 user reviews,7,2,9
246255,5,Mixed,6,6,12
246256,7,Positive,14,0,14
246257,0,8 user reviews,6,2,8
246260,7,Positive,23,4,27
246280,5,Mixed,16,9,25
246300,5,Mixed,178,99,277
246360,5,Mixed,8,9,17
246400,8,Very Positive,85,21,106
246420,9,Overwhelmingly Positive,2269,100,2369
246562,0,4 user reviews,3,1,4
246580,8,Very Positive,1364,222,1586
246600,0,9 user reviews,9,0,9
246620,8,Very Positive,13435,953,14388
246680,5,Mixed,86,39,125
246720,6,Mostly Positive,15,5,20
246740,5,Mixed,15,20,35
246760,5,Mixed,251,127,378
246800,0,4 user reviews,3,1,4
246820,0,4 user reviews,3,1,4
246840,8,Very Positive,1119,73,1192
246880,3,Negative,7,38,45
246900,8,Very Positive,5068,325,5393
246920,8,Very Positive,57,9,66
246940,4,Mostly Negative,56,195,251
246960,8,Very Positive,82,17,99
246980,6,Mostly Positive,60,22,82
247000,6,Mostly Positive,1683,515,2198
247020,9,Overwhelmingly Positive,2416,114,2530
247080,9,Overwhelmingly Positive,8796,343,9139
247120,0,1 user reviews,0,1,1
247140,8,Very Positive,335,29,364
247240,8,Very Positive,775,155,930
247290,5,Mixed,17,9,26
247291,7,Positive,10,1,11
247292,7,Positive,12,2,14
247293,6,Mostly Positive,25,7,32
247294,7,Positive,13,1,14
247295,8,Very Positive,65,3,68
247297,8,Very Positive,76,14,90
247298,7,Positive,19,1,20
247299,7,Positive,19,0,19
247300,7,Positive,40,4,44
247301,7,Positive,16,3,19
247302,5,Mixed,39,25,64
247303,8,Very Positive,104,7,111
247304,8,Very Positive,82,9,91
247305,7,Positive,13,0,13
247306,7,Positive,19,3,22
247307,7,Positive,10,1,11
247308,6,Mostly Positive,16,5,21
247309,6,Mostly Positive,15,5,20
247310,0,9 user reviews,5,4,9
247350,8,Very Positive,222,31,253
247370,6,Mostly Positive,115,45,160
247430,8,Very Positive,563,94,657
247580,6,Mostly Positive,26,10,36
247660,5,Mixed,935,460,1395
247730,4,Mostly Negative,3429,5427,8856
247750,0,5 user reviews,5,0,5
247830,7,Positive,11,1,12
247870,4,Mostly Negative,75,114,189
247910,8,Very Positive,1024,181,1205
247930,5,Mixed,13,8,21
247950,4,Mostly Negative,156,527,683
248160,5,Mixed,11,5,16
248170,8,Very Positive,303,34,337
248190,8,Very Positive,97,18,115
248270,5,Mixed,20,17,37
248290,5,Mixed,110,63,173
248310,9,Overwhelmingly Positive,1977,69,2046
248330,8,Very Positive,406,25,431
248350,5,Mixed,160,91,251
248370,5,Mixed,18,14,32
248390,8,Very Positive,2889,580,3469
248410,4,Mostly Negative,21,72,93
248450,5,Mixed,99,48,147
248470,5,Mixed,113,83,196
248490,5,Mixed,33,39,72
248510,8,Very Positive,62,12,74
248530,6,Mostly Positive,60,18,78
248550,8,Very Positive,247,18,265
248570,8,Very Positive,90,12,102
248610,8,Very Positive,2781,191,2972
248630,5,Mixed,273,392,665
248650,5,Mixed,195,89,284
248710,4,Mostly Negative,45,180,225
248730,6,Mostly Positive,141,36,177
248750,8,Very Positive,151,3,154
248800,6,Mostly Positive,412,128,540
248820,8,Very Positive,12542,783,13325
248860,8,Very Positive,2385,282,2667
248970,8,Very Positive,136,29,165
249050,8,Very Positive,4711,600,5311
249081,0,7 user reviews,4,3,7
249082,5,Mixed,4,6,10
249083,0,5 user reviews,4,1,5
249085,7,Positive,9,1,10
249086,0,7 user reviews,6,1,7
249087,0,2 user reviews,2,0,2
249088,5,Mixed,10,6,16
249090,0,5 user reviews,5,0,5
249092,0,3 user reviews,2,1,3
249094,0,5 user reviews,5,0,5
249120,7,Positive,10,1,11
249121,0,7 user reviews,6,1,7
249122,7,Positive,11,0,11
249130,8,Very Positive,3249,349,3598
249170,0,8 user reviews,4,4,8
249180,5,Mixed,48,22,70
249181,5,Mixed,7,5,12
249190,5,Mixed,75,102,177
249230,5,Mixed,716,406,1122
249310,7,Positive,23,2,25
249320,8,Very Positive,106,20,126
249330,8,Very Positive,542,50,592
249360,5,Mixed,162,84,246
249380,6,Mostly Positive,904,307,1211
249540,0,4 user reviews,0,4,4
249550,5,Mixed,139,68,207
249570,5,Mixed,104,140,244
249590,8,Very Positive,550,127,677
249610,6,Mostly Positive,8,3,11
249630,8,Very Positive,1349,209,1558
249650,5,Mixed,620,416,1036
249680,8,Very Positive,826,69,895
249730,5,Mixed,8,6,14
249750,0,1 user reviews,1,0,1
249870,8,Very Positive,697,160,857
249910,0,9 user reviews,0,9,9
249921,0,5 user reviews,2,3,5
249922,0,2 user reviews,2,0,2
249923,0,5 user reviews,4,1,5
249930,4,Mostly Negative,6,11,17
249950,8,Very Positive,281,62,343
249990,6,Mostly Positive,791,298,1089
250030,8,Very Positive,82,20,102
250050,9,Overwhelmingly Positive,558,25,583
250070,6,Mostly Positive,7,3,10
250110,9,Overwhelmingly Positive,737,32,769
250180,8,Very Positive,1798,222,2020
250260,8,Very Positive,2968,241,3209
250300,8,Very Positive,83,18,101
250310,0,1 user reviews,1,0,1
250320,9,Overwhelmingly Positive,11804,317,12121
250340,6,Mostly Positive,1594,678,2272
250360,6,Mostly Positive,10,4,14
250380,8,Very Positive,268,48,316
250400,6,Mostly Positive,3302,1053,4355
250420,5,Mixed,7,7,14
250460,6,Mostly Positive,235,97,332
250500,9,Overwhelmingly Positive,1338,59,1397
250520,8,Very Positive,1981,315,2296
250540,4,Mostly Negative,3,10,13
250560,6,Mostly Positive,530,145,675
250580,6,Mostly Positive,328,137,465
250600,8,Very Positive,71,7,78
250620,8,Very Positive,1921,299,2220
250640,6,Mostly Positive,106,41,147
250660,5,Mixed,125,64,189
250680,6,Mostly Positive,366,142,508
250700,8,Very Positive,356,40,396
250720,3,Negative,7,30,37
250740,5,Mixed,7,4,11
250760,9,Overwhelmingly Positive,7607,301,7908
250870,5,Mixed,38,51,89
250900,9,Overwhelmingly Positive,46484,941,47425
250930,0,2 user reviews,2,0,2
250990,6,Mostly Positive,10,4,14
251020,5,Mixed,13,11,24
251040,0,1 user reviews,1,0,1
251060,8,Very Positive,4550,595,5145
251080,0,8 user reviews,7,1,8
251081,0,5 user reviews,5,0,5
251110,8,Very Positive,733,107,840
251130,8,Very Positive,1069,82,1151
251150,8,Very Positive,3238,254,3492
251170,5,Mixed,768,359,1127
251210,8,Very Positive,105,16,121
251230,6,Mostly Positive,123,37,160
251270,8,Very Positive,460,51,511
251290,9,Overwhelmingly Positive,1226,30,1256
251310,5,Mixed,37,40,77
251370,8,Very Positive,270,11,281
251390,5,Mixed,75,38,113
251410,5,Mixed,52,74,126
251430,8,Very Positive,192,23,215
251450,4,Mostly Negative,3,7,10
251470,8,Very Positive,1184,66,1250
251490,8,Very Positive,103,4,107
251510,7,Positive,12,1,13
251530,5,Mixed,36,21,57
251570,8,Very Positive,44267,7937,52204
251590,5,Mixed,13,16,29
251610,8,Very Positive,142,15,157
251630,8,Very Positive,504,91,595
251650,7,Positive,8,2,10
251690,5,Mixed,93,50,143
251710,5,Mixed,114,53,167
251730,8,Very Positive,1280,125,1405
251770,8,Very Positive,220,30,250
251790,0,2 user reviews,0,2,2
251810,6,Mostly Positive,135,52,187
251830,8,Very Positive,256,11,267
251850,6,Mostly Positive,230,68,298
251870,8,Very Positive,845,109,954
251890,5,Mixed,133,147,280
251910,7,Positive,32,6,38
251950,5,Mixed,55,25,80
251970,5,Mixed,124,81,205
251990,9,Overwhelmingly Positive,4035,205,4240
252010,8,Very Positive,217,46,263
252030,8,Very Positive,1237,237,1474
252050,2,Very Negative,11,107,118
252070,6,Mostly Positive,75,24,99
252090,6,Mostly Positive,27,8,35
252110,8,Very Positive,1129,60,1189
252130,8,Very Positive,231,18,249
252150,8,Very Positive,120,19,139
252170,5,Mixed,26,13,39
252210,5,Mixed,34,44,78
252230,5,Mixed,115,63,178
252250,5,Mixed,266,365,631
252270,5,Mixed,45,26,71
252290,6,Mostly Positive,74,30,104
252310,8,Very Positive,215,27,242
252330,8,Very Positive,1966,290,2256
252350,6,Mostly Positive,684,179,863
252370,8,Very Positive,251,47,298
252390,5,Mixed,66,39,105
252410,8,Very Positive,1606,124,1730
252430,5,Mixed,17,24,41
252450,5,Mixed,695,567,1262
252470,6,Mostly Positive,1444,399,1843
252490,8,Very Positive,168070,27689,195759
252530,6,Mostly Positive,833,259,1092
252550,8,Very Positive,260,48,308
252570,5,Mixed,146,65,211
252610,9,Overwhelmingly Positive,3123,142,3265
252630,8,Very Positive,896,123,1019
252670,8,Very Positive,761,132,893
252690,6,Mostly Positive,566,156,722
252710,6,Mostly Positive,110,28,138
252730,8,Very Positive,76,12,88
252750,8,Very Positive,60,13,73
252830,5,Mixed,92,40,132
252850,5,Mixed,23,15,38
252870,8,Very Positive,1875,183,2058
252890,6,Mostly Positive,48,14,62
252910,2,Very Negative,21,169,190
252950,8,Very Positive,156890,18237,175127
252970,6,Mostly Positive,42,18,60
252990,0,6 user reviews,6,0,6
253030,8,Very Positive,1088,62,1150
253110,8,Very Positive,1660,142,1802
253150,6,Mostly Positive,333,109,442
253190,5,Mixed,278,142,420
253230,9,Overwhelmingly Positive,17612,286,17898
253250,6,Mostly Positive,3237,1183,4420
253290,8,Very Positive,243,18,261
253310,5,Mixed,13,6,19
253330,6,Mostly Positive,478,173,651
253350,8,Very Positive,59,10,69
253370,5,Mixed,67,38,105
253390,6,Mostly Positive,42,15,57
253410,5,Mixed,61,48,109
253430,6,Mostly Positive,2805,766,3571
253470,5,Mixed,57,34,91
253510,5,Mixed,172,173,345
253530,6,Mostly Positive,11,3,14
253570,7,Positive,8,2,10
253610,6,Mostly Positive,164,63,227
253630,5,Mixed,99,83,182
253650,5,Mixed,496,273,769
253670,6,Mostly Positive,19,8,27
253690,6,Mostly Positive,134,48,182
253710,5,Mixed,104,149,253
253750,9,Overwhelmingly Positive,824,41,865
253770,4,Mostly Negative,118,249,367
253790,6,Mostly Positive,110,30,140
253830,0,1 user reviews,0,1,1
253840,8,Very Positive,919,98,1017
253860,5,Mixed,32,39,71
253880,5,Mixed,106,56,162
253900,6,Mostly Positive,467,120,587
253920,6,Mostly Positive,180,58,238
253940,6,Mostly Positive,186,49,235
253960,5,Mixed,31,41,72
253980,5,Mixed,465,229,694
254060,5,Mixed,58,42,100
254080,5,Mixed,44,36,80
254100,5,Mixed,38,20,58
254200,6,Mostly Positive,1358,498,1856
254260,8,Very Positive,89,1,90
254290,0,3 user reviews,3,0,3
254291,0,3 user reviews,3,0,3
254300,0,2 user reviews,2,0,2
254320,8,Very Positive,1019,133,1152
254370,5,Mixed,49,44,93
254440,8,Very Positive,1124,121,1245
254460,8,Very Positive,384,29,413
254480,6,Mostly Positive,113,40,153
254590,4,Mostly Negative,110,170,280
254650,4,Mostly Negative,52,82,134
254700,8,Very Positive,6834,928,7762
254820,8,Very Positive,46,7,53
254840,6,Mostly Positive,60,18,78
254860,4,Mostly Negative,4,10,14
254880,8,Very Positive,84,8,92
254900,0,3 user reviews,3,0,3
254920,6,Mostly Positive,24,7,31
254940,0,9 user reviews,6,3,9
254960,8,Very Positive,265,41,306
255010,6,Mostly Positive,12,4,16
255030,5,Mixed,31,24,55
255050,7,Positive,33,3,36
255070,5,Mixed,500,216,716
255160,0,2 user reviews,2,0,2
255163,0,2 user reviews,1,1,2
255250,0,1 user reviews,0,1,1
255260,5,Mixed,37,26,63
255280,6,Mostly Positive,257,93,350
255300,8,Very Positive,240,60,300
255320,6,Mostly Positive,211,82,293
255340,8,Very Positive,129,7,136
255370,5,Mixed,149,64,213
255390,8,Very Positive,338,21,359
255420,5,Mixed,919,1356,2275
255480,5,Mixed,544,332,876
255520,6,Mostly Positive,680,182,862
255690,0,9 user reviews,7,2,9
255691,4,Mostly Negative,4,8,12
255692,5,Mixed,8,8,16
255710,8,Very Positive,46920,4006,50926
255870,8,Very Positive,122,8,130
255910,7,Positive,17,1,18
255920,6,Mostly Positive,128,36,164
255940,5,Mixed,33,32,65
255960,7,Positive,37,6,43
255980,4,Mostly Negative,4,12,16
256010,4,Mostly Negative,63,129,192
256030,5,Mixed,78,56,134
256050,2,Very Negative,5,60,65
256070,6,Mostly Positive,24,8,32
256190,5,Mixed,581,446,1027
256240,0,9 user reviews,8,1,9
256270,5,Mixed,16,8,24
256280,0,4 user reviews,1,3,4
256290,8,Very Positive,4311,451,4762
256320,7,Positive,34,4,38
256321,6,Mostly Positive,18,5,23
256330,5,Mixed,154,100,254
256350,5,Mixed,33,18,51
256370,6,Mostly Positive,280,101,381
256390,5,Mixed,54,68,122
256440,4,Mostly Negative,6,13,19
256460,8,Very Positive,328,38,366
256500,8,Very Positive,56,7,63
256501,0,6 user reviews,6,0,6
256502,7,Positive,11,0,11
256503,0,6 user reviews,6,0,6
256504,0,8 user reviews,7,1,8
256505,7,Positive,10,0,10
256506,0,1 user reviews,1,0,1
256507,0,2 user reviews,2,0,2
256510,7,Positive,12,1,13
256520,0,1 user reviews,1,0,1
256521,0,1 user reviews,0,1,1
256522,0,4 user reviews,4,0,4
256523,0,3 user reviews,3,0,3
256535,0,1 user reviews,1,0,1
257020,0,1 user reviews,1,0,1
257030,8,Very Positive,563,74,637
257050,5,Mixed,176,195,371
257080,8,Very Positive,131,32,163
257120,8,Very Positive,188,41,229
257170,8,Very Positive,705,115,820
257220,6,Mostly Positive,38,14,52
257260,8,Very Positive,47,3,50
257290,0,4 user reviews,4,0,4
257310,0,5 user reviews,4,1,5
257320,0,7 user reviews,4,3,7
257350,8,Very Positive,2581,281,2862
257370,5,Mixed,74,79,153
257371,5,Mixed,41,60,101
257400,5,Mixed,98,131,229
257420,8,Very Positive,1613,346,1959
257510,9,Overwhelmingly Positive,11098,467,11565
257610,5,Mixed,24,12,36
257630,5,Mixed,42,35,77
257650,5,Mixed,15,10,25
257670,6,Mostly Positive,189,59,248
257690,8,Very Positive,464,82,546
257710,0,5 user reviews,5,0,5
257730,6,Mostly Positive,29,9,38
257750,8,Very Positive,943,184,1127
257770,5,Mixed,34,20,54
257790,8,Very Positive,171,19,190
257830,5,Mixed,125,108,233
257850,8,Very Positive,7301,497,7798
257870,5,Mixed,25,13,38
257890,3,Negative,2,19,21
257930,2,Very Negative,11,175,186
257970,8,Very Positive,234,52,286
257990,8,Very Positive,199,31,230
258010,8,Very Positive,368,58,426
258050,5,Mixed,173,107,280
258070,7,Positive,14,2,16
258090,6,Mostly Positive,42,14,56
258180,4,Mostly Negative,536,1180,1716
258200,5,Mixed,46,24,70
258220,5,Mixed,105,55,160
258240,4,Mostly Negative,10,29,39
258270,5,Mixed,13,19,32
258343,0,1 user reviews,1,0,1
258347,0,2 user reviews,2,0,2
258348,0,3 user reviews,3,0,3
258350,0,1 user reviews,1,0,1
258352,0,1 user reviews,0,1,1
258353,0,9 user reviews,9,0,9
258354,0,1 user reviews,1,0,1
258358,0,1 user reviews,1,0,1
258361,0,4 user reviews,4,0,4
258365,0,4 user reviews,3,1,4
258366,0,1 user reviews,1,0,1
258367,0,1 user reviews,1,0,1
258374,0,1 user reviews,1,0,1
258378,0,4 user reviews,4,0,4
258381,0,2 user reviews,2,0,2
258382,0,1 user reviews,0,1,1
258383,0,1 user reviews,1,0,1
258384,0,3 user reviews,3,0,3
258385,0,3 user reviews,2,1,3
258386,0,2 user reviews,2,0,2
258388,0,3 user reviews,3,0,3
258392,0,5 user reviews,5,0,5
258394,0,1 user reviews,1,0,1
258395,0,2 user reviews,1,1,2
258396,0,1 user reviews,1,0,1
258397,0,6 user reviews,6,0,6
258402,0,1 user reviews,1,0,1
258404,0,2 user reviews,1,1,2
258410,0,1 user reviews,1,0,1
258412,0,1 user reviews,1,0,1
258414,0,8 user reviews,4,4,8
258415,0,3 user reviews,3,0,3
258418,0,1 user reviews,1,0,1
258419,0,2 user reviews,2,0,2
258420,0,6 user reviews,4,2,6
258460,7,Positive,22,2,24
258470,0,1 user reviews,1,0,1
258500,0,2 user reviews,2,0,2
258501,0,2 user reviews,2,0,2
258502,0,4 user reviews,3,1,4
258510,0,1 user reviews,1,0,1
258511,0,1 user reviews,1,0,1
258520,8,Very Positive,3305,494,3799
258540,0,3 user reviews,1,2,3
258541,0,4 user reviews,2,2,4
258542,0,3 user reviews,0,3,3
258543,5,Mixed,6,6,12
258590,6,Mostly Positive,157,65,222
258640,5,Mixed,11,13,24
258641,5,Mixed,10,5,15
258642,7,Positive,11,0,11
258643,6,Mostly Positive,8,3,11
258644,5,Mixed,5,7,12
258645,0,6 user reviews,4,2,6
258646,0,8 user reviews,7,1,8
258647,6,Mostly Positive,20,7,27
258648,8,Very Positive,50,9,59
258650,7,Positive,9,1,10
258652,7,Positive,17,2,19
258653,7,Positive,23,3,26
258654,7,Positive,32,8,40
258655,6,Mostly Positive,19,5,24
258656,7,Positive,14,1,15
258657,7,Positive,10,0,10
258658,7,Positive,13,1,14
258659,7,Positive,12,1,13
258661,0,9 user reviews,7,2,9
258663,5,Mixed,23,24,47
258666,0,4 user reviews,1,3,4
258668,4,Mostly Negative,8,13,21
258671,0,4 user reviews,3,1,4
258674,0,7 user reviews,5,2,7
258677,0,4 user reviews,3,1,4
258678,7,Positive,8,2,10
258700,4,Mostly Negative,4,7,11
258740,0,8 user reviews,6,2,8
258741,0,2 user reviews,2,0,2
258742,0,4 user reviews,4,0,4
258743,6,Mostly Positive,10,3,13
258744,7,Positive,9,1,10
258745,0,1 user reviews,1,0,1
258750,7,Positive,18,2,20
258751,7,Positive,26,5,31
258752,7,Positive,9,1,10
258760,6,Mostly Positive,187,77,264
258800,7,Positive,25,5,30
258803,0,2 user reviews,2,0,2
258804,0,2 user reviews,2,0,2
258810,5,Mixed,9,4,13
258812,0,4 user reviews,3,1,4
258813,0,3 user reviews,2,1,3
258814,0,4 user reviews,3,1,4
258815,0,3 user reviews,0,3,3
258816,0,7 user reviews,4,3,7
258817,4,Mostly Negative,20,41,61
258850,0,4 user reviews,4,0,4
258851,0,2 user reviews,1,1,2
258852,0,1 user reviews,1,0,1
258880,5,Mixed,36,47,83
258890,8,Very Positive,207,51,258
258910,8,Very Positive,118,17,135
258930,0,2 user reviews,2,0,2
258950,5,Mixed,60,49,109
258970,6,Mostly Positive,2581,782,3363
258990,0,1 user reviews,1,0,1
259020,5,Mixed,8,6,14
259040,6,Mostly Positive,47,17,64
259041,5,Mixed,54,33,87
259060,8,Very Positive,823,90,913
259080,7,Positive,42,3,45
259110,0,8 user reviews,8,0,8
259120,0,1 user reviews,1,0,1
259121,0,1 user reviews,1,0,1
259130,6,Mostly Positive,135,34,169
259170,4,Mostly Negative,59,108,167
259190,5,Mixed,66,48,114
259210,0,5 user reviews,5,0,5
259211,0,8 user reviews,8,0,8
259230,0,3 user reviews,2,1,3
259240,0,1 user reviews,1,0,1
259250,7,Positive,15,2,17
259251,6,Mostly Positive,7,3,10
259252,0,9 user reviews,5,4,9
259253,0,7 user reviews,3,4,7
259320,4,Mostly Negative,9,25,34
259340,5,Mixed,40,26,66
259380,5,Mixed,218,99,317
259381,6,Mostly Positive,275,100,375
259390,8,Very Positive,90,12,102
259410,8,Very Positive,126,16,142
259430,6,Mostly Positive,128,42,170
259450,5,Mixed,98,46,144
259470,7,Positive,17,4,21
259490,8,Very Positive,50,5,55
259510,8,Very Positive,104,20,124
259530,8,Very Positive,1293,81,1374
259550,8,Very Positive,1015,95,1110
259570,5,Mixed,448,198,646
259590,0,1 user reviews,1,0,1
259591,0,1 user reviews,1,0,1
259600,8,Very Positive,157,37,194
259620,5,Mixed,111,101,212
259640,4,Mostly Negative,18,46,64
259660,5,Mixed,146,73,219
259680,9,Overwhelmingly Positive,2279,109,2388
259700,5,Mixed,42,61,103
259720,5,Mixed,97,57,154
259740,8,Very Positive,255,31,286
259760,4,Mostly Negative,9,22,31
259780,8,Very Positive,277,40,317
259800,4,Mostly Negative,133,376,509
259810,7,Positive,15,0,15
259830,5,Mixed,9,4,13
259870,6,Mostly Positive,111,35,146
259890,3,Negative,6,43,49
259900,5,Mixed,22,10,32
259910,2,Very Negative,17,80,97
259940,7,Positive,21,3,24
259960,7,Positive,27,3,30
259980,8,Very Positive,46,7,53
260000,5,Mixed,21,10,31
260020,6,Mostly Positive,8,3,11
260040,7,Positive,14,2,16
260060,7,Positive,15,3,18
260080,4,Mostly Negative,10,17,27
260130,6,Mostly Positive,153,64,217
260160,6,Mostly Positive,224,70,294
260190,8,Very Positive,247,39,286
260210,5,Mixed,413,356,769
260230,8,Very Positive,5212,370,5582
260250,5,Mixed,142,107,249
260270,5,Mixed,29,23,52
260290,6,Mostly Positive,21,7,28
260291,0,2 user reviews,2,0,2
260293,0,1 user reviews,0,1,1
260330,6,Mostly Positive,51,17,68
260380,5,Mixed,14,9,23
260410,0,5 user reviews,4,1,5
260430,5,Mixed,60,36,96
260471,6,Mostly Positive,7,3,10
260472,0,6 user reviews,3,3,6
260510,2,Very Negative,6,51,57
260530,7,Positive,27,4,31
260550,6,Mostly Positive,19,6,25
260570,8,Very Positive,240,23,263
260650,5,Mixed,44,30,74
260690,6,Mostly Positive,80,23,103
260710,5,Mixed,20,9,29
260730,8,Very Positive,395,79,474
260750,8,Very Positive,381,18,399
260790,8,Very Positive,268,41,309
260850,0,3 user reviews,2,1,3
260860,0,1 user reviews,1,0,1
260880,0,1 user reviews,1,0,1
260930,5,Mixed,49,38,87
260960,0,9 user reviews,7,2,9
260990,6,Mostly Positive,22,7,29
261030,9,Overwhelmingly Positive,9802,492,10294
261050,5,Mixed,54,29,83
261110,6,Mostly Positive,1080,343,1423
261130,0,1 user reviews,1,0,1
261160,0,6 user reviews,2,4,6
261161,0,3 user reviews,2,1,3
261180,9,Overwhelmingly Positive,2261,99,2360
261350,5,Mixed,10,8,18
261392,0,1 user reviews,1,0,1
261394,0,1 user reviews,0,1,1
261400,0,1 user reviews,0,1,1
261408,0,1 user reviews,1,0,1
261420,0,1 user reviews,1,0,1
261421,0,2 user reviews,1,1,2
261430,5,Mixed,6,4,10
261470,6,Mostly Positive,638,249,887
261510,8,Very Positive,361,36,397
261530,6,Mostly Positive,986,326,1312
261550,8,Very Positive,45426,6056,51482
261570,9,Overwhelmingly Positive,11247,455,11702
261600,3,Negative,3,21,24
261640,6,Mostly Positive,10205,2597,12802
261680,8,Very Positive,183,43,226
261700,8,Very Positive,367,53,420
261720,5,Mixed,26,28,54
261740,5,Mixed,13,9,22
261760,5,Mixed,750,583,1333
261820,7,Positive,25,1,26
261880,8,Very Positive,221,26,247
261900,0,7 user reviews,7,0,7
261920,4,Mostly Negative,29,59,88
261940,7,Positive,10,2,12
261960,6,Mostly Positive,21,8,29
261980,4,Mostly Negative,5,12,17
262000,8,Very Positive,357,45,402
262060,8,Very Positive,29800,3367,33167
262080,3,Negative,0,12,12
262100,4,Mostly Negative,14,23,37
262120,6,Mostly Positive,283,104,387
262142,0,1 user reviews,1,0,1
262150,5,Mixed,536,245,781
262190,6,Mostly Positive,92,37,129
262210,8,Very Positive,51,7,58
262230,0,1 user reviews,1,0,1
262240,8,Very Positive,68,8,76
262260,8,Very Positive,540,68,608
262280,6,Mostly Positive,619,244,863
262300,0,4 user reviews,4,0,4
262342,0,1 user reviews,1,0,1
262370,5,Mixed,6,4,10
262390,8,Very Positive,434,88,522
262410,5,Mixed,73,34,107
262450,8,Very Positive,196,43,239
262470,8,Very Positive,194,19,213
262490,6,Mostly Positive,233,83,316
262510,5,Mixed,12,8,20
262550,8,Very Positive,258,33,291
262590,8,Very Positive,82,14,96
262610,5,Mixed,10,10,20
262630,0,5 user reviews,3,2,5
262650,4,Mostly Negative,10,19,29
262690,8,Very Positive,193,41,234
262750,5,Mixed,103,51,154
262770,8,Very Positive,110,13,123
262790,8,Very Positive,306,56,362
262810,5,Mixed,6,9,15
262830,8,Very Positive,577,53,630
262850,8,Very Positive,184,7,191
262870,3,Negative,1,9,10
262900,6,Mostly Positive,133,42,175
262920,0,2 user reviews,2,0,2
262940,8,Very Positive,526,66,592
262960,6,Mostly Positive,536,177,713
262980,4,Mostly Negative,5,12,17
263020,8,Very Positive,403,34,437
263040,5,Mixed,26,18,44
263060,6,Mostly Positive,1025,344,1369
263100,8,Very Positive,383,60,443
263120,0,4 user reviews,4,0,4
263140,5,Mixed,29,42,71
263180,0,5 user reviews,3,2,5
263200,6,Mostly Positive,322,85,407
263260,8,Very Positive,67,14,81
263280,8,Very Positive,6371,1235,7606
263300,8,Very Positive,815,159,974
263320,6,Mostly Positive,191,52,243
263340,5,Mixed,49,44,93
263360,6,Mostly Positive,209,60,269
263380,8,Very Positive,56,8,64
263400,8,Very Positive,218,18,236
263420,5,Mixed,36,52,88
263440,5,Mixed,1035,1257,2292
263460,7,Positive,39,7,46
263480,5,Mixed,31,34,65
263500,7,Positive,8,2,10
263520,5,Mixed,34,17,51
263540,0,5 user reviews,3,2,5
263560,8,Very Positive,257,44,301
263600,4,Mostly Negative,8,19,27
263620,8,Very Positive,872,192,1064
263640,5,Mixed,23,30,53
263680,5,Mixed,131,89,220
263700,6,Mostly Positive,35,10,45
263720,5,Mixed,166,76,242
263740,6,Mostly Positive,198,57,255
263760,8,Very Positive,3030,249,3279
263800,3,Negative,1,17,18
263820,8,Very Positive,314,33,347
263840,6,Mostly Positive,35,9,44
263860,5,Mixed,43,22,65
263880,8,Very Positive,168,22,190
263920,5,Mixed,86,51,137
263940,6,Mostly Positive,35,11,46
263960,7,Positive,13,2,15
263980,8,Very Positive,2499,221,2720
264000,5,Mixed,47,36,83
264020,5,Mixed,8,4,12
264060,7,Positive,42,6,48
264080,8,Very Positive,70,5,75
264120,5,Mixed,36,46,82
264140,5,Mixed,2388,1513,3901
264160,8,Very Positive,347,50,397
264200,9,Overwhelmingly Positive,8485,146,8631
264220,8,Very Positive,47,7,54
264240,6,Mostly Positive,396,113,509
264260,5,Mixed,23,11,34
264280,5,Mixed,82,87,169
264300,5,Mixed,157,106,263
264320,5,Mixed,26,18,44
264340,7,Positive,31,3,34
264380,7,Positive,9,1,10
264400,7,Positive,21,0,21
264420,7,Positive,22,4,26
264440,0,5 user reviews,1,4,5
264460,5,Mixed,4,6,10
264480,5,Mixed,15,20,35
264520,6,Mostly Positive,59,18,77
264540,6,Mostly Positive,63,27,90
264560,8,Very Positive,59,8,67
264580,4,Mostly Negative,5,10,15
264600,5,Mixed,24,11,35
264610,5,Mixed,146,91,237
264681,0,1 user reviews,0,1,1
264682,0,1 user reviews,1,0,1
264690,8,Very Positive,114,9,123
264710,9,Overwhelmingly Positive,75833,3685,79518
264730,6,Mostly Positive,366,143,509
264750,6,Mostly Positive,12,5,17
264802,0,5 user reviews,2,3,5
264804,5,Mixed,12,8,20
264805,0,8 user reviews,2,6,8
264830,0,3 user reviews,1,2,3
264840,0,1 user reviews,1,0,1
264920,0,2 user reviews,2,0,2
264970,0,9 user reviews,3,6,9
265000,8,Very Positive,245,52,297
265020,3,Negative,3,29,32
265060,0,7 user reviews,2,5,7
265061,0,9 user reviews,6,3,9
265120,5,Mixed,89,93,182
265130,0,5 user reviews,3,2,5
265131,0,2 user reviews,2,0,2
265132,0,3 user reviews,2,1,3
265140,4,Mostly Negative,9,20,29
265141,0,6 user reviews,1,5,6
265142,0,2 user reviews,1,1,2
265143,0,2 user reviews,1,1,2
265144,0,1 user reviews,1,0,1
265145,0,1 user reviews,1,0,1
265146,0,1 user reviews,1,0,1
265170,8,Very Positive,87,14,101
265191,5,Mixed,9,8,17
265192,5,Mixed,7,6,13
265193,5,Mixed,8,10,18
265200,0,2 user reviews,2,0,2
265210,8,Very Positive,1790,173,1963
265240,4,Mostly Negative,2,8,10
265300,5,Mixed,1860,1725,3585
265330,5,Mixed,220,120,340
265380,5,Mixed,20,14,34
265400,4,Mostly Negative,24,40,64
265410,0,4 user reviews,3,1,4
265420,6,Mostly Positive,11,3,14
265460,0,1 user reviews,1,0,1
265461,0,4 user reviews,4,0,4
265462,0,3 user reviews,3,0,3
265463,0,6 user reviews,5,1,6
265464,0,3 user reviews,3,0,3
265470,8,Very Positive,91,14,105
265490,0,2 user reviews,1,1,2
265550,5,Mixed,2459,1092,3551
265590,6,Mostly Positive,384,119,503
265610,9,Overwhelmingly Positive,1383,33,1416
265630,8,Very Positive,242,31,273
265670,4,Mostly Negative,5,11,16
265690,6,Mostly Positive,392,100,492
265730,0,2 user reviews,2,0,2
265750,6,Mostly Positive,338,103,441
265770,0,1 user reviews,1,0,1
265790,0,7 user reviews,6,1,7
265810,5,Mixed,185,137,322
265830,5,Mixed,76,39,115
265870,6,Mostly Positive,22,9,31
265890,9,Overwhelmingly Positive,2001,72,2073
265930,8,Very Positive,21788,2832,24620
265950,6,Mostly Positive,157,52,209
265970,5,Mixed,106,121,227
265990,5,Mixed,160,84,244
266010,9,Overwhelmingly Positive,3090,134,3224
266050,5,Mixed,27,18,45
266090,5,Mixed,55,81,136
266110,8,Very Positive,307,41,348
266130,8,Very Positive,947,217,1164
266150,0,5 user reviews,4,1,5
266170,5,Mixed,159,77,236
266190,4,Mostly Negative,24,41,65
266210,8,Very Positive,2184,124,2308
266230,8,Very Positive,288,50,338
266250,7,Positive,37,3,40
266270,6,Mostly Positive,49,16,65
266290,4,Mostly Negative,33,81,114
266310,6,Mostly Positive,448,168,616
266330,5,Mixed,14,15,29
266370,5,Mixed,9,12,21
266390,6,Mostly Positive,208,70,278
266410,6,Mostly Positive,320,88,408
266430,5,Mixed,15,8,23
266470,5,Mixed,24,17,41
266490,8,Very Positive,509,68,577
266510,8,Very Positive,2625,309,2934
266550,4,Mostly Negative,6,10,16
266590,0,8 user reviews,4,4,8
266620,4,Mostly Negative,7,14,21
266730,7,Positive,12,1,13
266740,7,Positive,9,1,10
266750,5,Mixed,10,6,16
266840,8,Very Positive,6711,919,7630
266930,7,Positive,35,4,39
266931,7,Positive,21,4,25
266940,8,Very Positive,53,13,66
266980,0,8 user reviews,4,4,8
267000,0,1 user reviews,0,1,1
267001,0,1 user reviews,1,0,1
267060,5,Mixed,41,25,66
267220,0,7 user reviews,0,7,7
267340,6,Mostly Positive,60,20,80
267360,8,Very Positive,197,11,208
267380,5,Mixed,135,108,243
267381,8,Very Positive,222,33,255
267382,0,1 user reviews,1,0,1
267440,5,Mixed,18,14,32
267480,0,3 user reviews,3,0,3
267490,4,Mostly Negative,131,246,377
267530,6,Mostly Positive,682,174,856
267550,5,Mixed,245,193,438
267600,2,Very Negative,39,313,352
267610,4,Mostly Negative,38,122,160
267630,5,Mixed,42,43,85
267650,0,6 user reviews,6,0,6
267652,0,1 user reviews,1,0,1
267653,0,3 user reviews,1,2,3
267655,5,Mixed,10,9,19
267660,0,2 user reviews,2,0,2
267670,5,Mixed,15,11,26
267730,5,Mixed,7,10,17
267750,5,Mixed,310,238,548
267770,0,5 user reviews,3,2,5
267771,0,3 user reviews,2,1,3
267772,6,Mostly Positive,8,3,11
267773,0,3 user reviews,2,1,3
267774,0,4 user reviews,3,1,4
267775,7,Positive,14,1,15
267776,0,1 user reviews,1,0,1
267777,0,1 user reviews,1,0,1
267778,0,3 user reviews,2,1,3
267780,0,9 user reviews,7,2,9
267781,0,4 user reviews,3,1,4
267782,0,9 user reviews,9,0,9
267783,0,2 user reviews,2,0,2
267784,7,Positive,14,1,15
267785,0,2 user reviews,2,0,2
267786,0,2 user reviews,2,0,2
267787,0,6 user reviews,5,1,6
267788,5,Mixed,7,5,12
267789,5,Mixed,8,5,13
267810,0,4 user reviews,4,0,4
267900,5,Mixed,42,49,91
267920,8,Very Positive,137,30,167
267940,5,Mixed,5,5,10
267960,4,Mostly Negative,6,15,21
267980,8,Very Positive,62,4,66
268050,6,Mostly Positive,2949,1018,3967
268080,7,Positive,14,0,14
268090,8,Very Positive,124,7,131
268100,0,3 user reviews,3,0,3
268101,0,7 user reviews,6,1,7
268130,8,Very Positive,4296,242,4538
268200,5,Mixed,39,33,72
268220,8,Very Positive,241,42,283
268240,6,Mostly Positive,16,6,22
268260,5,Mixed,29,32,61
268280,0,3 user reviews,3,0,3
268320,8,Very Positive,157,17,174
268340,7,Positive,12,1,13
268360,5,Mixed,76,33,109
268400,8,Very Positive,751,77,828
268420,6,Mostly Positive,57,21,78
268500,8,Very Positive,20518,3377,23895
268520,0,8 user reviews,1,7,8
268540,5,Mixed,203,139,342
268590,0,1 user reviews,1,0,1
268610,0,3 user reviews,3,0,3
268611,0,2 user reviews,2,0,2
268612,0,2 user reviews,2,0,2
268613,0,3 user reviews,3,0,3
268614,0,5 user reviews,4,1,5
268620,0,5 user reviews,4,1,5
268650,8,Very Positive,4680,484,5164
268670,4,Mostly Negative,56,91,147
268710,5,Mixed,16,21,37
268750,8,Very Positive,2911,556,3467
268770,6,Mostly Positive,91,23,114
268810,6,Mostly Positive,73,22,95
268850,5,Mixed,25,13,38
268870,6,Mostly Positive,1122,359,1481
268890,4,Mostly Negative,69,139,208
268910,9,Overwhelmingly Positive,25956,1119,27075
268930,5,Mixed,29,21,50
268970,3,Negative,2,9,11
268990,8,Very Positive,290,18,308
269010,6,Mostly Positive,70,27,97
269030,8,Very Positive,721,159,880
269050,8,Very Positive,756,54,810
269110,6,Mostly Positive,277,77,354
269150,7,Positive,42,6,48
269170,8,Very Positive,487,76,563
269190,8,Very Positive,636,102,738
269210,6,Mostly Positive,4786,1881,6667
269230,8,Very Positive,137,28,165
269250,8,Very Positive,258,40,298
269270,8,Very Positive,463,40,503
269290,5,Mixed,168,192,360
269310,5,Mixed,284,166,450
269330,8,Very Positive,88,9,97
269350,4,Mostly Negative,22,37,59
269370,6,Mostly Positive,101,39,140
269430,0,7 user reviews,2,5,7
269450,8,Very Positive,51,3,54
269470,5,Mixed,95,86,181
269490,8,Very Positive,361,49,410
269530,3,Negative,2,13,15
269550,5,Mixed,10,9,19
269570,8,Very Positive,61,10,71
269590,4,Mostly Negative,17,34,51
269610,5,Mixed,39,29,68
269630,4,Mostly Negative,5,8,13
269650,8,Very Positive,978,181,1159
269670,6,Mostly Positive,327,83,410
269690,6,Mostly Positive,110,43,153
269710,8,Very Positive,56,3,59
269730,5,Mixed,513,290,803
269770,8,Very Positive,1963,199,2162
269790,6,Mostly Positive,986,300,1286
269810,5,Mixed,90,40,130
269890,5,Mixed,38,53,91
269950,8,Very Positive,3907,455,4362
269990,6,Mostly Positive,27,10,37
270010,8,Very Positive,190,26,216
270030,0,9 user reviews,8,1,9
270050,6,Mostly Positive,228,63,291
270070,5,Mixed,13,9,22
270090,4,Mostly Negative,49,74,123
270110,5,Mixed,170,88,258
270130,8,Very Positive,685,137,822
270150,8,Very Positive,3114,382,3496
270170,5,Mixed,18,12,30
270190,5,Mixed,24,15,39
270210,8,Very Positive,1904,192,2096
270230,8,Very Positive,57,12,69
270270,5,Mixed,156,105,261
270310,8,Very Positive,123,23,146
270330,3,Negative,4,17,21
270370,7,Positive,18,0,18
270410,5,Mixed,10,5,15
270430,0,8 user reviews,1,7,8
270450,8,Very Positive,1700,147,1847
270490,8,Very Positive,72,14,86
270510,5,Mixed,22,12,34
270550,8,Very Positive,3414,516,3930
270570,5,Mixed,15,7,22
270590,5,Mixed,19,18,37
270610,8,Very Positive,52,4,56
270630,8,Very Positive,564,102,666
270700,0,3 user reviews,3,0,3
270750,7,Positive,12,2,14
270760,5,Mixed,6,4,10
270770,4,Mostly Negative,15,33,48
270790,6,Mostly Positive,55,19,74
270810,7,Positive,36,7,43
270830,5,Mixed,23,23,46
270850,6,Mostly Positive,1177,315,1492
270880,9,Overwhelmingly Positive,24063,974,25037
270910,5,Mixed,149,164,313
270940,0,5 user reviews,4,1,5
270941,0,3 user reviews,3,0,3
270942,0,2 user reviews,1,1,2
270950,6,Mostly Positive,107,33,140
271030,7,Positive,33,4,37
271090,0,2 user reviews,2,0,2
271100,0,2 user reviews,2,0,2
271110,0,9 user reviews,7,2,9
271240,6,Mostly Positive,1688,510,2198
271260,6,Mostly Positive,880,309,1189
271331,0,4 user reviews,2,2,4
271360,6,Mostly Positive,136,40,176
271370,4,Mostly Negative,37,63,100
271390,7,Positive,22,4,26
271400,6,Mostly Positive,9,3,12
271416,0,4 user reviews,3,1,4
271417,0,1 user reviews,1,0,1
271418,0,1 user reviews,1,0,1
271419,0,5 user reviews,5,0,5
271423,0,1 user reviews,1,0,1
271432,0,1 user reviews,1,0,1
271433,0,1 user reviews,1,0,1
271444,0,1 user reviews,1,0,1
271446,0,1 user reviews,1,0,1
271449,0,1 user reviews,1,0,1
271450,0,2 user reviews,2,0,2
271451,0,1 user reviews,1,0,1
271454,0,1 user reviews,0,1,1
271456,0,2 user reviews,2,0,2
271457,0,2 user reviews,2,0,2
271461,0,1 user reviews,0,1,1
271462,0,3 user reviews,1,2,3
271463,0,2 user reviews,2,0,2
271469,0,1 user reviews,1,0,1
271472,0,3 user reviews,2,1,3
271474,0,1 user reviews,1,0,1
271479,0,8 user reviews,4,4,8
271480,0,1 user reviews,1,0,1
271481,0,1 user reviews,1,0,1
271491,0,1 user reviews,1,0,1
271498,0,2 user reviews,0,2,2
271500,4,Mostly Negative,105,266,371
271520,6,Mostly Positive,8,3,11
271550,7,Positive,30,2,32
271570,6,Mostly Positive,97,29,126
271590,6,Mostly Positive,192005,68170,260175
271640,0,2 user reviews,0,2,2
271670,8,Very Positive,192,23,215
271730,5,Mixed,35,37,72
271760,6,Mostly Positive,165,49,214
271800,0,2 user reviews,0,2,2
271801,0,1 user reviews,1,0,1
271802,0,4 user reviews,2,2,4
271820,8,Very Positive,419,39,458
271850,5,Mixed,55,42,97
271860,5,Mixed,48,31,79
271900,8,Very Positive,723,39,762
271920,7,Positive,36,8,44
271942,6,Mostly Positive,28,9,37
271943,8,Very Positive,45,9,54
271944,8,Very Positive,53,11,64
271950,0,5 user reviews,4,1,5
271960,0,2 user reviews,2,0,2
271961,0,2 user reviews,2,0,2
271962,0,3 user reviews,3,0,3
271963,0,2 user reviews,2,0,2
271964,0,4 user reviews,4,0,4
271970,8,Very Positive,95,16,111
271990,6,Mostly Positive,11,3,14
272010,6,Mostly Positive,35,12,47
272040,8,Very Positive,281,12,293
272060,5,Mixed,18,12,30
272080,0,3 user reviews,1,2,3
272083,0,2 user reviews,1,1,2
272084,0,1 user reviews,1,0,1
272090,0,1 user reviews,0,1,1
272100,0,8 user reviews,8,0,8
272230,8,Very Positive,1037,235,1272
272270,5,Mixed,767,331,1098
272300,5,Mixed,4,6,10
272330,8,Very Positive,61,10,71
272470,5,Mixed,445,233,678
272490,4,Mostly Negative,2,8,10
272510,6,Mostly Positive,1199,349,1548
272600,8,Very Positive,849,47,896
272620,8,Very Positive,115,27,142
272670,8,Very Positive,182,3,185
272680,6,Mostly Positive,37,12,49
272690,0,1 user reviews,0,1,1
272700,6,Mostly Positive,11,3,14
272710,5,Mixed,6,5,11
272770,0,9 user reviews,9,0,9
272890,5,Mixed,46,24,70
272950,0,4 user reviews,4,0,4
272970,0,2 user reviews,1,1,2
272990,7,Positive,38,7,45
273030,2,Very Negative,12,62,74
273070,6,Mostly Positive,226,84,310
273110,5,Mixed,107,73,180
273150,0,8 user reviews,7,1,8
273151,0,9 user reviews,6,3,9
273152,0,3 user reviews,3,0,3
273153,5,Mixed,13,6,19
273240,5,Mixed,77,36,113
273300,9,Overwhelmingly Positive,602,19,621
273350,5,Mixed,3180,1840,5020
273380,5,Mixed,49,23,72
273381,5,Mixed,31,25,56
273390,8,Very Positive,82,4,86
273500,8,Very Positive,281,52,333
273522,0,3 user reviews,2,1,3
273524,0,1 user reviews,1,0,1
273525,0,1 user reviews,0,1,1
273526,0,2 user reviews,2,0,2
273540,0,1 user reviews,0,1,1
273570,8,Very Positive,252,10,262
273580,8,Very Positive,76,4,80
273590,6,Mostly Positive,36,14,50
273600,6,Mostly Positive,99,28,127
273620,6,Mostly Positive,142,42,184
273680,0,1 user reviews,1,0,1
273730,4,Mostly Negative,14,52,66
273740,3,Negative,1,20,21
273750,5,Mixed,25,16,41
273760,2,Very Negative,6,49,55
273770,2,Very Negative,19,209,228
273790,0,5 user reviews,2,3,5
273800,4,Mostly Negative,5,11,16
273820,3,Negative,6,26,32
273830,3,Negative,0,11,11
273840,8,Very Positive,115,26,141
273850,0,9 user reviews,0,9,9
273860,0,7 user reviews,2,5,7
273890,0,6 user reviews,3,3,6
273940,4,Mostly Negative,17,30,47
273960,5,Mixed,34,41,75
274010,5,Mixed,14,18,32
274050,6,Mostly Positive,14,5,19
274120,0,9 user reviews,6,3,9
274121,0,6 user reviews,5,1,6
274122,0,7 user reviews,6,1,7
274123,8,Very Positive,90,4,94
274130,5,Mixed,108,79,187
274161,0,2 user reviews,2,0,2
274170,8,Very Positive,11418,1233,12651
274190,9,Overwhelmingly Positive,14692,507,15199
274230,5,Mixed,519,226,745
274250,8,Very Positive,212,52,264
274270,8,Very Positive,801,129,930
274290,5,Mixed,809,437,1246
274310,6,Mostly Positive,900,226,1126
274350,9,Overwhelmingly Positive,677,35,712
274430,0,5 user reviews,5,0,5
274431,0,8 user reviews,6,2,8
274440,5,Mixed,10,6,16
274450,8,Very Positive,63,13,76
274480,8,Very Positive,188,28,216
274500,9,Overwhelmingly Positive,2176,71,2247
274520,8,Very Positive,3485,207,3692
274560,5,Mixed,352,188,540
274620,5,Mixed,24,15,39
274700,8,Very Positive,55,2,57
274880,8,Very Positive,49,12,61
274900,8,Very Positive,2366,285,2651
274920,8,Very Positive,2053,488,2541
274940,8,Very Positive,7626,812,8438
274960,4,Mostly Negative,7,23,30
274980,6,Mostly Positive,445,157,602
275020,0,8 user reviews,8,0,8
275030,0,8 user reviews,6,2,8
275050,0,1 user reviews,0,1,1
275060,4,Mostly Negative,18,63,81
275080,5,Mixed,42,49,91
275100,8,Very Positive,1222,215,1437
275124,0,1 user reviews,0,1,1
275125,0,1 user reviews,1,0,1
275127,0,1 user reviews,1,0,1
275128,0,1 user reviews,0,1,1
275134,0,3 user reviews,3,0,3
275138,0,1 user reviews,1,0,1
275139,0,1 user reviews,0,1,1
275144,0,4 user reviews,3,1,4
275163,0,2 user reviews,2,0,2
275180,8,Very Positive,331,51,382
275200,8,Very Positive,781,67,848
275240,0,1 user reviews,0,1,1
275290,8,Very Positive,205,51,256
275310,4,Mostly Negative,5,20,25
275330,0,3 user reviews,1,2,3
275350,6,Mostly Positive,40,12,52
275390,8,Very Positive,800,59,859
275470,6,Mostly Positive,52,19,71
275490,5,Mixed,7,4,11
275510,5,Mixed,31,38,69
275530,5,Mixed,207,107,314
275560,6,Mostly Positive,9,3,12
275570,8,Very Positive,179,38,217
275590,5,Mixed,119,104,223
275610,5,Mixed,200,179,379
275670,8,Very Positive,911,161,1072
275690,8,Very Positive,178,20,198
275700,8,Very Positive,200,25,225
275800,0,2 user reviews,1,1,2
275804,0,1 user reviews,1,0,1
275805,0,2 user reviews,2,0,2
275806,0,2 user reviews,1,1,2
275807,0,1 user reviews,0,1,1
275810,6,Mostly Positive,12,4,16
275830,7,Positive,16,0,16
275850,5,Mixed,57831,34566,92397
276190,0,4 user reviews,1,3,4
276210,0,9 user reviews,9,0,9
276220,5,Mixed,10,12,22
276240,6,Mostly Positive,8,3,11
276300,5,Mixed,8,7,15
276340,8,Very Positive,66,13,79
276360,5,Mixed,14,11,25
276380,0,7 user reviews,1,6,7
276430,0,9 user reviews,4,5,9
276440,5,Mixed,6,8,14
276460,0,5 user reviews,1,4,5
276550,0,7 user reviews,7,0,7
276551,0,8 user reviews,5,3,8
276552,7,Positive,12,1,13
276730,5,Mixed,7,5,12
276750,6,Mostly Positive,29,10,39
276810,6,Mostly Positive,2559,1037,3596
276870,5,Mixed,77,51,128
276890,8,Very Positive,87,18,105
277110,6,Mostly Positive,75,26,101
277150,0,1 user reviews,1,0,1
277170,0,4 user reviews,2,2,4
277210,0,1 user reviews,1,0,1
277230,0,2 user reviews,2,0,2
277250,0,6 user reviews,4,2,6
277270,5,Mixed,27,14,41
277390,8,Very Positive,84,11,95
277430,6,Mostly Positive,1450,429,1879
277450,6,Mostly Positive,308,106,414
277460,6,Mostly Positive,144,46,190
277470,5,Mixed,45,37,82
277490,8,Very Positive,94,23,117
277500,4,Mostly Negative,30,53,83
277510,5,Mixed,7,6,13
277520,5,Mixed,17,22,39
277540,4,Mostly Negative,4,7,11
277560,5,Mixed,12,16,28
277590,6,Mostly Positive,381,152,533
277630,7,Positive,39,9,48
277650,7,Positive,33,8,41
277670,0,2 user reviews,0,2,2
277671,0,3 user reviews,3,0,3
277672,0,2 user reviews,2,0,2
277673,0,1 user reviews,1,0,1
277674,0,2 user reviews,2,0,2
277675,0,2 user reviews,2,0,2
277677,0,1 user reviews,1,0,1
277678,0,2 user reviews,2,0,2
277680,8,Very Positive,180,28,208
277700,8,Very Positive,51,5,56
277720,0,3 user reviews,1,2,3
277721,0,3 user reviews,2,1,3
277730,0,8 user reviews,3,5,8
277731,0,9 user reviews,8,1,9
277732,5,Mixed,13,8,21
277733,5,Mixed,8,8,16
277735,0,8 user reviews,7,1,8
277736,0,8 user reviews,8,0,8
277737,3,Negative,2,9,11
277739,6,Mostly Positive,22,6,28
277740,8,Very Positive,84,1,85
277741,0,8 user reviews,6,2,8
277742,7,Positive,17,4,21
277745,7,Positive,27,0,27
277747,5,Mixed,25,11,36
277748,7,Positive,38,3,41
277749,0,6 user reviews,4,2,6
277751,0,5 user reviews,5,0,5
277752,5,Mixed,26,17,43
277753,7,Positive,14,0,14
277754,7,Positive,19,2,21
277755,7,Positive,8,2,10
277756,7,Positive,11,1,12
277757,7,Positive,13,0,13
277758,0,4 user reviews,3,1,4
277759,7,Positive,13,2,15
277760,7,Positive,30,5,35
277761,7,Positive,12,3,15
277762,7,Positive,16,1,17
277763,7,Positive,23,2,25
277764,6,Mostly Positive,7,3,10
277765,7,Positive,15,2,17
277767,5,Mixed,11,6,17
277768,5,Mixed,10,6,16
277769,7,Positive,27,5,32
277770,0,6 user reviews,5,1,6
277771,7,Positive,20,1,21
277773,5,Mixed,25,16,41
277774,7,Positive,8,2,10
277776,0,4 user reviews,3,1,4
277777,7,Positive,43,2,45
277778,0,6 user reviews,6,0,6
277820,7,Positive,13,1,14
277821,6,Mostly Positive,14,5,19
277830,8,Very Positive,70,16,86
277840,0,3 user reviews,3,0,3
277841,0,1 user reviews,1,0,1
277842,0,1 user reviews,1,0,1
277843,0,7 user reviews,2,5,7
277850,6,Mostly Positive,14,4,18
277870,6,Mostly Positive,178,76,254
277890,8,Very Positive,488,61,549
277910,5,Mixed,59,30,89
277930,4,Mostly Negative,211,326,537
277950,5,Mixed,67,33,100
278080,6,Mostly Positive,2077,542,2619
278100,8,Very Positive,131,19,150
278120,7,Positive,14,2,16
278131,0,4 user reviews,4,0,4
278190,5,Mixed,28,14,42
278210,7,Positive,26,1,27
278360,8,Very Positive,6078,493,6571
278420,7,Positive,29,4,33
278440,6,Mostly Positive,71,26,97
278460,8,Very Positive,337,39,376
278480,0,2 user reviews,0,2,2
278481,0,1 user reviews,0,1,1
278490,7,Positive,12,3,15
278510,7,Positive,24,1,25
278530,6,Mostly Positive,20,8,28
278550,5,Mixed,25,12,37
278570,8,Very Positive,88,20,108
278590,6,Mostly Positive,11,3,14
278620,5,Mixed,118,62,180
278640,5,Mixed,60,26,86
278701,0,1 user reviews,1,0,1
278710,5,Mixed,5,5,10
278711,5,Mixed,5,5,10
278712,5,Mixed,12,9,21
278810,5,Mixed,49,35,84
278850,0,3 user reviews,1,2,3
278890,6,Mostly Positive,112,36,148
278910,6,Mostly Positive,337,90,427
278930,6,Mostly Positive,87,23,110
278970,3,Negative,7,33,40
279070,8,Very Positive,77,11,88
279110,0,2 user reviews,2,0,2
279111,0,2 user reviews,0,2,2
279112,0,2 user reviews,1,1,2
279140,6,Mostly Positive,193,59,252
279160,5,Mixed,64,36,100
279260,6,Mostly Positive,156,54,210
279420,7,Positive,15,3,18
279440,6,Mostly Positive,172,62,234
279460,4,Mostly Negative,4,8,12
279480,5,Mixed,9,7,16
279500,5,Mixed,8,9,17
279520,5,Mixed,5,6,11
279540,6,Mostly Positive,67,19,86
279560,5,Mixed,10,7,17
279580,5,Mixed,35,19,54
279600,5,Mixed,25,24,49
279601,0,8 user reviews,3,5,8
279602,5,Mixed,11,8,19
279603,0,8 user reviews,4,4,8
279620,5,Mixed,36,42,78
279621,0,5 user reviews,2,3,5
279622,5,Mixed,8,4,12
279623,4,Mostly Negative,34,58,92
279640,7,Positive,28,7,35
279720,5,Mixed,81,47,128
279740,5,Mixed,12,11,23
279800,8,Very Positive,229,8,237
279820,0,1 user reviews,1,0,1
279830,0,1 user reviews,1,0,1
279840,7,Positive,19,0,19
279900,5,Mixed,36,19,55
279920,5,Mixed,35,16,51
279940,8,Very Positive,225,33,258
279960,0,3 user reviews,3,0,3
279961,0,4 user reviews,3,1,4
279962,0,2 user reviews,1,1,2
279963,0,2 user reviews,1,1,2
279964,0,2 user reviews,1,1,2
279965,0,2 user reviews,2,0,2
279966,0,1 user reviews,1,0,1
279967,0,4 user reviews,4,0,4
279968,0,1 user reviews,1,0,1
279990,5,Mixed,22,10,32
280010,0,6 user reviews,3,3,6
280040,5,Mixed,125,54,179
280140,5,Mixed,64,28,92
280160,8,Very Positive,2380,276,2656
280180,8,Very Positive,705,127,832
280200,7,Positive,19,3,22
280220,9,Overwhelmingly Positive,2256,80,2336
280320,5,Mixed,203,146,349
280360,5,Mixed,144,137,281
280380,3,Negative,4,22,26
280440,8,Very Positive,53,11,64
280460,5,Mixed,25,14,39
280500,0,8 user reviews,6,2,8
280520,6,Mostly Positive,511,151,662
280540,5,Mixed,67,30,97
280560,8,Very Positive,201,11,212
280600,8,Very Positive,189,37,226
280620,0,6 user reviews,4,2,6
280640,3,Negative,4,19,23
280680,8,Very Positive,509,42,551
280720,6,Mostly Positive,181,49,230
280740,6,Mostly Positive,1772,545,2317
280790,8,Very Positive,817,151,968
280830,5,Mixed,18,17,35
280850,5,Mixed,23,13,36
280890,5,Mixed,26,29,55
280910,8,Very Positive,123,12,135
280930,8,Very Positive,56,6,62
281050,7,Positive,20,3,23
281060,6,Mostly Positive,21,6,27
281080,0,2 user reviews,2,0,2
281100,0,1 user reviews,1,0,1
281102,0,6 user reviews,1,5,6
281103,0,1 user reviews,1,0,1
281130,2,Very Negative,10,75,85
281200,6,Mostly Positive,70,20,90
281220,5,Mixed,138,112,250
281240,5,Mixed,30,13,43
281260,5,Mixed,16,21,37
281280,6,Mostly Positive,109,31,140
281340,0,4 user reviews,3,1,4
281342,0,1 user reviews,1,0,1
281343,0,3 user reviews,3,0,3
281344,0,2 user reviews,1,1,2
281346,0,4 user reviews,4,0,4
281350,4,Mostly Negative,17,40,57
281370,4,Mostly Negative,146,323,469
281390,6,Mostly Positive,37,15,52
281410,6,Mostly Positive,131,46,177
281430,5,Mixed,33,27,60
281450,8,Very Positive,68,15,83
281511,0,1 user reviews,1,0,1
281560,5,Mixed,6,4,10
281580,5,Mixed,30,29,59
281600,0,1 user reviews,1,0,1
281601,0,1 user reviews,1,0,1
281602,0,1 user reviews,1,0,1
281603,0,2 user reviews,2,0,2
281604,0,1 user reviews,1,0,1
281606,0,1 user reviews,1,0,1
281607,0,1 user reviews,1,0,1
281610,8,Very Positive,2386,593,2979
281640,8,Very Positive,1113,113,1226
281750,6,Mostly Positive,133,36,169
281770,6,Mostly Positive,7,3,10
281780,0,4 user reviews,4,0,4
281810,0,1 user reviews,1,0,1
281811,0,1 user reviews,1,0,1
281812,0,1 user reviews,1,0,1
281820,6,Mostly Positive,17,6,23
281840,4,Mostly Negative,22,47,69
281860,7,Positive,37,2,39
281900,5,Mixed,5,6,11
281920,8,Very Positive,514,76,590
281940,5,Mixed,203,177,380
281990,8,Very Positive,32071,4764,36835
282010,8,Very Positive,99,19,118
282030,8,Very Positive,96,16,112
282050,5,Mixed,152,150,302
282070,8,Very Positive,16338,1244,17582
282100,8,Very Positive,53,6,59
282140,9,Overwhelmingly Positive,10764,497,11261
282201,0,1 user reviews,1,0,1
282210,5,Mixed,601,609,1210
282250,0,1 user reviews,0,1,1
282280,0,3 user reviews,2,1,3
282350,5,Mixed,737,355,1092
282400,6,Mostly Positive,575,166,741
282440,8,Very Positive,1155,192,1347
282470,9,Overwhelmingly Positive,487,15,502
282510,6,Mostly Positive,80,31,111
282511,5,Mixed,56,39,95
282512,6,Mostly Positive,20,6,26
282513,7,Positive,17,4,21
282514,7,Positive,28,5,33
282515,7,Positive,16,3,19
282516,6,Mostly Positive,17,6,23
282520,0,3 user reviews,3,0,3
282530,6,Mostly Positive,341,114,455
282550,0,1 user reviews,0,1,1
282560,4,Mostly Negative,450,1292,1742
282590,8,Very Positive,411,91,502
282620,5,Mixed,31,16,47
282640,7,Positive,18,1,19
282660,4,Mostly Negative,5,14,19
282680,6,Mostly Positive,35,13,48
282740,0,5 user reviews,4,1,5
282760,8,Very Positive,565,106,671
282780,6,Mostly Positive,50,18,68
282800,8,Very Positive,5834,333,6167
282860,4,Mostly Negative,32,74,106
282880,5,Mixed,33,23,56
282900,8,Very Positive,4925,294,5219
282960,0,1 user reviews,1,0,1
283000,5,Mixed,23,23,46
283020,0,9 user reviews,3,6,9
283040,4,Mostly Negative,6,10,16
283060,0,6 user reviews,1,5,6
283080,8,Very Positive,143,24,167
283100,4,Mostly Negative,28,98,126
283160,8,Very Positive,1068,115,1183
283180,6,Mostly Positive,36,11,47
283230,5,Mixed,100,59,159
283270,8,Very Positive,54,6,60
283290,8,Very Positive,415,55,470
283310,5,Mixed,23,10,33
283330,0,8 user reviews,5,3,8
283350,4,Mostly Negative,14,22,36
283370,5,Mixed,12,15,27
283390,5,Mixed,21,12,33
283410,5,Mixed,13,13,26
283430,7,Positive,9,2,11
283450,5,Mixed,14,16,30
283470,3,Negative,3,13,16
283490,5,Mixed,10,7,17
283530,0,7 user reviews,1,6,7
283542,0,2 user reviews,1,1,2
283550,0,9 user reviews,8,1,9
283551,0,8 user reviews,8,0,8
283552,0,6 user reviews,4,2,6
283560,4,Mostly Negative,25,40,65
283580,5,Mixed,26,29,55
283600,5,Mixed,27,16,43
283620,6,Mostly Positive,241,80,321
283640,8,Very Positive,3771,431,4202
283660,5,Mixed,46,27,73
283680,8,Very Positive,421,53,474
283740,5,Mixed,195,156,351
283750,0,5 user reviews,4,1,5
283820,7,Positive,34,3,37
283840,7,Positive,31,3,34
283880,0,9 user reviews,7,2,9
283920,8,Very Positive,96,4,100
283940,8,Very Positive,221,6,227
283960,9,Overwhelmingly Positive,512,10,522
283980,8,Very Positive,201,8,209
284000,7,Positive,24,3,27
284020,7,Positive,27,3,30
284050,8,Very Positive,248,16,264
284070,0,1 user reviews,1,0,1
284100,5,Mixed,63,53,116
284140,5,Mixed,21,17,38
284160,9,Overwhelmingly Positive,25000,1178,26178
284180,8,Very Positive,43,9,52
284220,7,Positive,10,2,12
284240,8,Very Positive,347,61,408
284260,8,Very Positive,101,14,115
284290,4,Mostly Negative,15,23,38
284390,8,Very Positive,643,34,677
284410,6,Mostly Positive,10,4,14
284430,7,Positive,13,2,15
284440,6,Mostly Positive,29,9,38
284441,6,Mostly Positive,26,8,34
284450,7,Positive,42,4,46
284460,8,Very Positive,803,138,941
284500,6,Mostly Positive,11,4,15
284580,4,Mostly Negative,4,7,11
284680,0,3 user reviews,2,1,3
284710,8,Very Positive,210,20,230
284730,8,Very Positive,103,12,115
284750,8,Very Positive,243,39,282
284770,8,Very Positive,280,11,291
284790,8,Very Positive,158,8,166
284810,8,Very Positive,127,3,130
284830,8,Very Positive,200,28,228
284850,8,Very Positive,278,10,288
284870,8,Very Positive,180,29,209
284890,6,Mostly Positive,119,30,149
284910,0,2 user reviews,1,1,2
284930,5,Mixed,12,13,25
284950,6,Mostly Positive,178,53,231
284970,5,Mixed,15,21,36
284990,5,Mixed,54,42,96
285010,6,Mostly Positive,51,21,72
285030,0,6 user reviews,4,2,6
285050,5,Mixed,140,75,215
285070,6,Mostly Positive,30,10,40
285110,8,Very Positive,492,79,571
285130,5,Mixed,34,24,58
285150,0,5 user reviews,5,0,5
285160,5,Mixed,701,360,1061
285190,5,Mixed,2438,3020,5458
285310,8,Very Positive,2887,166,3053
285330,8,Very Positive,1897,267,2164
285350,0,6 user reviews,4,2,6
285370,0,1 user reviews,1,0,1
285380,5,Mixed,67,67,134
285400,5,Mixed,15,11,26
285420,7,Positive,24,2,26
285440,8,Very Positive,587,31,618
285460,0,2 user reviews,2,0,2
285461,0,8 user reviews,6,2,8
285462,0,4 user reviews,2,2,4
285470,0,3 user reviews,3,0,3
285480,4,Mostly Negative,61,100,161
285500,5,Mixed,227,110,337
285520,5,Mixed,20,9,29
285540,0,2 user reviews,1,1,2
285550,0,3 user reviews,3,0,3
285580,0,2 user reviews,0,2,2
285670,0,3 user reviews,0,3,3
285730,0,3 user reviews,3,0,3
285740,8,Very Positive,507,29,536
285800,6,Mostly Positive,276,88,364
285820,8,Very Positive,182,15,197
285840,8,Very Positive,63,15,78
285900,6,Mostly Positive,8314,2821,11135
285920,8,Very Positive,6081,604,6685
285960,5,Mixed,67,55,122
285980,7,Positive,24,4,28
286000,8,Very Positive,1134,238,1372
286040,6,Mostly Positive,863,354,1217
286080,7,Positive,16,2,18
286100,7,Positive,28,1,29
286120,4,Mostly Negative,21,43,64
286140,6,Mostly Positive,99,36,135
286160,9,Overwhelmingly Positive,14671,599,15270
286200,6,Mostly Positive,20,8,28
286220,5,Mixed,28,19,47
286240,8,Very Positive,310,23,333
286260,8,Very Positive,598,52,650
286280,6,Mostly Positive,114,30,144
286300,7,Positive,25,6,31
286320,8,Very Positive,163,13,176
286340,5,Mixed,1260,570,1830
286360,5,Mixed,28,17,45
286380,8,Very Positive,83,7,90
286460,8,Very Positive,114,12,126
286480,8,Very Positive,90,15,105
286500,8,Very Positive,107,2,109
286520,5,Mixed,6,7,13
286540,8,Very Positive,92,9,101
286570,5,Mixed,192,266,458
286632,0,1 user reviews,1,0,1
286633,0,5 user reviews,3,2,5
286634,0,6 user reviews,6,0,6
286635,7,Positive,10,1,11
286636,7,Positive,9,1,10
286660,8,Very Positive,67,14,81
286670,0,4 user reviews,4,0,4
286671,7,Positive,10,0,10
286690,8,Very Positive,10852,2519,13371
286730,5,Mixed,14,12,26
286750,5,Mixed,29,16,45
286770,6,Mostly Positive,64,19,83
286790,0,3 user reviews,1,2,3
286810,5,Mixed,68,42,110
286830,3,Negative,5,28,33
286880,7,Positive,10,2,12
286910,0,2 user reviews,2,0,2
286911,0,1 user reviews,1,0,1
286912,0,3 user reviews,1,2,3
286913,0,4 user reviews,3,1,4
286920,0,3 user reviews,3,0,3
286930,5,Mixed,7,7,14
286940,5,Mixed,46,31,77
286961,0,5 user reviews,3,2,5
286963,0,2 user reviews,2,0,2
286964,0,5 user reviews,2,3,5
286965,0,1 user reviews,1,0,1
286966,0,8 user reviews,8,0,8
286970,0,5 user reviews,4,1,5
286971,0,6 user reviews,5,1,6
286972,0,1 user reviews,1,0,1
287020,8,Very Positive,413,28,441
287070,8,Very Positive,80,10,90
287090,0,2 user reviews,2,0,2
287091,0,1 user reviews,1,0,1
287094,0,1 user reviews,1,0,1
287100,4,Mostly Negative,5,16,21
287120,6,Mostly Positive,68,29,97
287140,5,Mixed,42,20,62
287200,5,Mixed,101,70,171
287220,5,Mixed,99,97,196
287260,8,Very Positive,287,60,347
287290,6,Mostly Positive,2522,835,3357
287330,5,Mixed,12,14,26
287340,5,Mixed,249,366,615
287370,5,Mixed,18,10,28
287371,6,Mostly Positive,22,7,29
287390,8,Very Positive,8761,1897,10658
287450,8,Very Positive,3935,277,4212
287530,0,3 user reviews,3,0,3
287531,0,4 user reviews,4,0,4
287540,7,Positive,11,0,11
287580,5,Mixed,237,137,374
287600,5,Mixed,51,32,83
287630,8,Very Positive,1137,273,1410
287680,5,Mixed,118,102,220
287700,8,Very Positive,20220,2383,22603
287720,5,Mixed,40,20,60
287740,0,5 user reviews,0,5,5
287760,7,Positive,8,2,10
287780,0,3 user reviews,3,0,3
287840,8,Very Positive,140,31,171
287860,5,Mixed,20,13,33
287900,8,Very Positive,73,16,89
287920,6,Mostly Positive,51,18,69
287960,8,Very Positive,74,18,92
287980,9,Overwhelmingly Positive,3716,128,3844
288000,0,6 user reviews,1,5,6
288020,5,Mixed,70,34,104
288040,6,Mostly Positive,253,82,335
288060,8,Very Positive,233,45,278
288100,0,7 user reviews,4,3,7
288120,8,Very Positive,465,55,520
288140,5,Mixed,441,246,687
288160,9,Overwhelmingly Positive,6900,194,7094
288220,8,Very Positive,149,13,162
288260,6,Mostly Positive,38,11,49
288270,5,Mixed,18,25,43
288290,7,Positive,41,7,48
288330,0,2 user reviews,0,2,2
288370,8,Very Positive,171,41,212
288390,0,1 user reviews,1,0,1
288420,0,3 user reviews,2,1,3
288470,8,Very Positive,3107,745,3852
288500,5,Mixed,6,4,10
288520,8,Very Positive,248,45,293
288570,5,Mixed,134,61,195
288610,0,5 user reviews,3,2,5
288630,0,5 user reviews,2,3,5
288650,5,Mixed,10,8,18
288670,7,Positive,9,2,11
288690,0,4 user reviews,2,2,4
288710,0,2 user reviews,1,1,2
288730,4,Mostly Negative,8,13,21
288750,5,Mixed,5,5,10
288780,0,1 user reviews,1,0,1
288790,5,Mixed,34,30,64
288830,5,Mixed,27,18,45
288840,8,Very Positive,61,10,71
288850,0,3 user reviews,3,0,3
288860,5,Mixed,21,19,40
288880,5,Mixed,57,40,97
288900,7,Positive,11,2,13
288930,8,Very Positive,274,67,341
288940,0,1 user reviews,1,0,1
288970,5,Mixed,21,14,35
289010,0,1 user reviews,0,1,1
289050,5,Mixed,9,9,18
289060,0,2 user reviews,2,0,2
289070,6,Mostly Positive,33557,8595,42152
289090,5,Mixed,259,145,404
289130,8,Very Positive,6562,1050,7612
289180,6,Mostly Positive,36,15,51
289200,6,Mostly Positive,67,24,91
289220,5,Mixed,8,12,20
289240,0,6 user reviews,4,2,6
289260,7,Positive,30,6,36
289280,5,Mixed,47,24,71
289300,6,Mostly Positive,95,27,122
289320,4,Mostly Negative,5,10,15
289340,5,Mixed,73,56,129
289360,5,Mixed,7,6,13
289380,6,Mostly Positive,11,3,14
289400,5,Mixed,32,35,67
289420,5,Mixed,23,15,38
289440,6,Mostly Positive,28,10,38
289460,5,Mixed,25,25,50
289480,4,Mostly Negative,5,20,25
289500,6,Mostly Positive,34,13,47
289520,5,Mixed,171,110,281
289550,0,7 user reviews,4,3,7
289570,4,Mostly Negative,7,12,19
289580,5,Mixed,14,21,35
289600,5,Mixed,90,63,153
289620,5,Mixed,43,46,89
289650,5,Mixed,5653,3563,9216
289690,5,Mixed,209,181,390
289730,7,Positive,9,2,11
289731,7,Positive,10,2,12
289733,0,9 user reviews,6,3,9
289734,4,Mostly Negative,5,10,15
289760,8,Very Positive,205,33,238
289780,0,3 user reviews,2,1,3
289800,4,Mostly Negative,31,50,81
289820,3,Negative,8,34,42
289840,4,Mostly Negative,11,21,32
289880,4,Mostly Negative,31,89,120
289881,4,Mostly Negative,66,220,286
289890,6,Mostly Positive,87,27,114
289930,5,Mixed,232,106,338
289950,5,Mixed,703,355,1058
290000,8,Very Positive,94,19,113
290020,6,Mostly Positive,70,19,89
290040,8,Very Positive,96,21,117
290060,6,Mostly Positive,108,37,145
290080,5,Mixed,2371,1573,3944
290140,0,8 user reviews,5,3,8
290180,7,Positive,9,1,10
290260,8,Very Positive,137,14,151
290280,5,Mixed,63,30,93
290300,8,Very Positive,3798,587,4385
290320,7,Positive,17,3,20
290340,8,Very Positive,3496,724,4220
290380,8,Very Positive,67,4,71
290400,6,Mostly Positive,11,4,15
290401,0,5 user reviews,4,1,5
290402,5,Mixed,6,4,10
290403,0,4 user reviews,2,2,4
290404,0,2 user reviews,1,1,2
290405,0,2 user reviews,1,1,2
290406,0,3 user reviews,1,2,3
290440,5,Mixed,11,12,23
290460,5,Mixed,11,6,17
290490,4,Mostly Negative,32,57,89
290510,8,Very Positive,150,16,166
290530,6,Mostly Positive,185,48,233
290630,0,6 user reviews,1,5,6
290650,3,Negative,8,33,41
290690,8,Very Positive,280,11,291
290730,0,3 user reviews,2,1,3
290750,0,5 user reviews,0,5,5
290770,8,Very Positive,1728,250,1978
290790,5,Mixed,1143,515,1658
290810,5,Mixed,23,25,48
290850,0,6 user reviews,3,3,6
290870,4,Mostly Negative,8,13,21
290890,8,Very Positive,387,88,475
290930,7,Positive,23,4,27
290970,5,Mixed,100,53,153
290990,5,Mixed,22,15,37
291010,5,Mixed,544,364,908
291030,5,Mixed,61,44,105
291050,5,Mixed,16,10,26
291070,6,Mostly Positive,22,6,28
291090,5,Mixed,24,14,38
291130,5,Mixed,96,68,164
291170,5,Mixed,27,15,42
291190,6,Mostly Positive,120,33,153
291250,5,Mixed,56,64,120
291270,4,Mostly Negative,7,11,18
291290,7,Positive,10,1,11
291330,5,Mixed,7,9,16
291370,4,Mostly Negative,34,95,129
291390,0,9 user reviews,6,3,9
291430,5,Mixed,5,6,11
291450,5,Mixed,51,48,99
291470,0,4 user reviews,4,0,4
291471,0,4 user reviews,3,1,4
291472,0,1 user reviews,1,0,1
291473,0,3 user reviews,2,1,3
291474,0,3 user reviews,3,0,3
291480,5,Mixed,219,207,426
291503,0,1 user reviews,1,0,1
291525,0,1 user reviews,1,0,1
291550,8,Very Positive,1212,239,1451
291610,0,4 user reviews,3,1,4
291630,6,Mostly Positive,86,33,119
291640,5,Mixed,21,20,41
291650,8,Very Positive,5947,986,6933
291690,5,Mixed,38,24,62
291710,8,Very Positive,144,21,165
291770,6,Mostly Positive,57,15,72
291822,0,1 user reviews,1,0,1
291830,0,1 user reviews,1,0,1
291840,6,Mostly Positive,19,6,25
291860,8,Very Positive,3512,239,3751
291900,7,Positive,27,1,28
291910,5,Mixed,96,100,196
291930,4,Mostly Negative,23,53,76
291960,5,Mixed,68,41,109
292020,0,9 user reviews,8,1,9
292021,7,Positive,25,3,28
292030,9,Overwhelmingly Positive,126443,3029,129472
292050,7,Positive,29,0,29
292060,5,Mixed,41,33,74
292090,7,Positive,10,1,11
292120,6,Mostly Positive,3697,1402,5099
292140,5,Mixed,963,716,1679
292160,6,Mostly Positive,42,18,60
292180,5,Mixed,384,180,564
292200,6,Mostly Positive,75,24,99
292220,7,Positive,8,2,10
292230,5,Mixed,87,45,132
292240,8,Very Positive,71,5,76
292260,8,Very Positive,50,2,52
292280,6,Mostly Positive,8,3,11
292300,0,9 user reviews,5,4,9
292320,7,Positive,30,5,35
292330,5,Mixed,141,167,308
292350,7,Positive,17,2,19
292370,5,Mixed,8,4,12
292380,4,Mostly Negative,10,22,32
292390,8,Very Positive,77,8,85
292400,5,Mixed,57,33,90
292410,8,Very Positive,492,114,606
292420,5,Mixed,27,26,53
292471,0,1 user reviews,0,1,1
292472,0,1 user reviews,0,1,1
292473,0,1 user reviews,1,0,1
292480,6,Mostly Positive,77,25,102
292500,8,Very Positive,351,14,365
292570,6,Mostly Positive,40,13,53
292600,8,Very Positive,117,7,124
292620,5,Mixed,35,52,87
292630,4,Mostly Negative,61,93,154
292660,6,Mostly Positive,54,15,69
292670,7,Positive,29,7,36
292680,0,6 user reviews,5,1,6
292702,0,1 user reviews,1,0,1
292710,7,Positive,8,2,10
292711,0,7 user reviews,6,1,7
292712,0,8 user reviews,6,2,8
292730,5,Mixed,2372,3223,5595
292760,7,Positive,10,2,12
292780,8,Very Positive,145,3,148
292800,8,Very Positive,160,5,165
292820,4,Mostly Negative,23,41,64
292840,7,Positive,19,1,20
292860,6,Mostly Positive,9,3,12
292880,8,Very Positive,62,7,69
292900,0,6 user reviews,2,4,6
292910,8,Very Positive,796,162,958
292930,6,Mostly Positive,197,63,260
292950,0,2 user reviews,2,0,2
292951,0,2 user reviews,0,2,2
292960,0,1 user reviews,1,0,1
292980,0,7 user reviews,3,4,7
292981,5,Mixed,13,6,19
292982,5,Mixed,76,33,109
292983,4,Mostly Negative,4,8,12
292984,7,Positive,9,1,10
292985,5,Mixed,7,7,14
292990,6,Mostly Positive,27,9,36
293010,5,Mixed,392,306,698
293054,7,Positive,17,4,21
293057,0,6 user reviews,2,4,6
293059,5,Mixed,13,6,19
293090,0,1 user reviews,1,0,1
293091,0,1 user reviews,1,0,1
293092,0,1 user reviews,1,0,1
293093,0,1 user reviews,1,0,1
293094,0,1 user reviews,1,0,1
293099,0,1 user reviews,1,0,1
293110,0,5 user reviews,5,0,5
293140,7,Positive,18,1,19
293160,5,Mixed,60,42,102
293180,5,Mixed,246,201,447
293200,5,Mixed,13,8,21
293220,5,Mixed,347,157,504
293240,8,Very Positive,213,18,231
293260,7,Positive,27,5,32
293300,7,Positive,15,0,15
293320,5,Mixed,93,121,214
293340,5,Mixed,40,34,74
293360,0,8 user reviews,7,1,8
293400,2,Very Negative,7,46,53
293420,5,Mixed,9,10,19
293440,5,Mixed,38,19,57
293460,6,Mostly Positive,51,20,71
293480,4,Mostly Negative,32,49,81
293520,6,Mostly Positive,271,114,385
293540,4,Mostly Negative,3,9,12
293600,0,9 user reviews,4,5,9
293660,8,Very Positive,175,27,202
293680,8,Very Positive,318,38,356
293720,3,Negative,2,11,13
293740,8,Very Positive,128,29,157
293760,8,Very Positive,2919,306,3225
293780,9,Overwhelmingly Positive,2642,103,2745
293820,0,3 user reviews,2,1,3
293840,5,Mixed,21,10,31
293860,5,Mixed,150,68,218
293880,8,Very Positive,102,11,113
293900,8,Very Positive,94,14,108
293920,5,Mixed,18,22,40
293940,5,Mixed,21,18,39
293960,5,Mixed,24,13,37
293980,0,6 user reviews,5,1,6
294000,8,Very Positive,90,13,103
294020,5,Mixed,90,58,148
294040,5,Mixed,95,49,144
294060,5,Mixed,16,8,24
294100,9,Overwhelmingly Positive,43629,763,44392
294140,8,Very Positive,473,72,545
294160,0,1 user reviews,0,1,1
294180,0,6 user reviews,4,2,6
294190,0,2 user reviews,2,0,2
294230,6,Mostly Positive,94,29,123
294260,0,1 user reviews,1,0,1
294280,5,Mixed,12,8,20
294340,0,2 user reviews,1,1,2
294370,6,Mostly Positive,135,51,186
294390,5,Mixed,17,17,34
294420,0,3 user reviews,3,0,3
294440,8,Very Positive,273,33,306
294460,7,Positive,27,5,32
294530,8,Very Positive,82,2,84
294540,8,Very Positive,114,8,122
294550,7,Positive,40,2,42
294560,6,Mostly Positive,8,3,11
294570,8,Very Positive,45,6,51
294580,6,Mostly Positive,11,3,14
294590,8,Very Positive,60,5,65
294650,8,Very Positive,75,5,80
294660,8,Very Positive,299,9,308
294670,8,Very Positive,116,14,130
294680,8,Very Positive,62,3,65
294690,7,Positive,24,6,30
294700,5,Mixed,16,14,30
294710,7,Positive,14,0,14
294720,7,Positive,30,2,32
294730,7,Positive,32,8,40
294750,5,Mixed,68,31,99
294770,5,Mixed,9,10,19
294790,5,Mixed,19,14,33
294810,8,Very Positive,389,32,421
294830,5,Mixed,39,57,96
294860,8,Very Positive,5384,548,5932
294904,0,1 user reviews,1,0,1
294910,0,1 user reviews,1,0,1
294912,0,1 user reviews,1,0,1
294913,0,1 user reviews,1,0,1
294914,0,2 user reviews,1,1,2
294916,0,1 user reviews,1,0,1
294919,0,1 user reviews,1,0,1
294923,0,1 user reviews,1,0,1
294924,0,2 user reviews,1,1,2
294927,0,2 user reviews,1,1,2
294929,0,2 user reviews,1,1,2
294930,0,2 user reviews,1,1,2
294932,0,1 user reviews,1,0,1
294940,0,1 user reviews,1,0,1
294942,0,3 user reviews,3,0,3
294953,0,1 user reviews,0,1,1
294957,0,2 user reviews,2,0,2
294958,0,1 user reviews,1,0,1
294959,0,1 user reviews,1,0,1
294960,0,1 user reviews,1,0,1
294961,0,2 user reviews,2,0,2
294962,0,1 user reviews,1,0,1
294963,0,1 user reviews,1,0,1
294964,0,2 user reviews,2,0,2
294966,0,1 user reviews,1,0,1
294968,0,1 user reviews,1,0,1
294969,0,1 user reviews,1,0,1
294978,0,1 user reviews,1,0,1
294980,0,1 user reviews,1,0,1
294985,0,2 user reviews,2,0,2
294990,7,Positive,15,0,15
294993,0,2 user reviews,0,2,2
294997,0,3 user reviews,2,1,3
294999,0,1 user reviews,0,1,1
295005,0,3 user reviews,3,0,3
295009,0,1 user reviews,1,0,1
295011,0,3 user reviews,3,0,3
295012,0,1 user reviews,1,0,1
295017,0,4 user reviews,4,0,4
295023,0,4 user reviews,3,1,4
295024,0,3 user reviews,3,0,3
295027,0,1 user reviews,1,0,1
295028,0,4 user reviews,1,3,4
295029,0,4 user reviews,3,1,4
295030,0,2 user reviews,2,0,2
295034,0,3 user reviews,2,1,3
295035,0,1 user reviews,1,0,1
295036,0,2 user reviews,1,1,2
295037,0,2 user reviews,1,1,2
295040,0,2 user reviews,2,0,2
295042,0,1 user reviews,1,0,1
295043,0,3 user reviews,3,0,3
295044,0,3 user reviews,3,0,3
295047,0,1 user reviews,1,0,1
295048,0,1 user reviews,1,0,1
295050,0,1 user reviews,0,1,1
295051,0,2 user reviews,2,0,2
295052,0,1 user reviews,1,0,1
295053,0,1 user reviews,1,0,1
295055,0,1 user reviews,1,0,1
295056,0,3 user reviews,2,1,3
295057,0,2 user reviews,2,0,2
295058,0,2 user reviews,2,0,2
295059,0,1 user reviews,0,1,1
295060,0,1 user reviews,1,0,1
295064,0,3 user reviews,1,2,3
295065,0,1 user reviews,0,1,1
295066,0,2 user reviews,2,0,2
295069,0,4 user reviews,3,1,4
295073,0,2 user reviews,2,0,2
295076,0,1 user reviews,1,0,1
295078,0,3 user reviews,1,2,3
295083,0,4 user reviews,3,1,4
295084,0,8 user reviews,2,6,8
295086,0,7 user reviews,7,0,7
295087,0,1 user reviews,1,0,1
295088,0,1 user reviews,1,0,1
295089,0,4 user reviews,2,2,4
295090,0,2 user reviews,2,0,2
295092,0,2 user reviews,2,0,2
295093,0,7 user reviews,4,3,7
295095,0,1 user reviews,1,0,1
295099,0,4 user reviews,4,0,4
295110,5,Mixed,18596,14767,33363
295162,5,Mixed,6,4,10
295173,0,2 user reviews,2,0,2
295174,0,1 user reviews,1,0,1
295181,0,1 user reviews,0,1,1
295182,0,2 user reviews,2,0,2
295190,0,9 user reviews,7,2,9
295191,0,2 user reviews,2,0,2
295192,0,3 user reviews,3,0,3
295194,0,1 user reviews,1,0,1
295196,0,6 user reviews,6,0,6
295199,0,2 user reviews,2,0,2
295200,0,2 user reviews,2,0,2
295204,0,1 user reviews,0,1,1
295207,0,1 user reviews,1,0,1
295209,0,1 user reviews,1,0,1
295220,0,4 user reviews,2,2,4
295221,0,8 user reviews,4,4,8
295222,0,4 user reviews,1,3,4
295250,4,Mostly Negative,68,128,196
295270,6,Mostly Positive,729,266,995
295435,0,1 user reviews,1,0,1
295436,0,1 user reviews,1,0,1
295437,0,5 user reviews,3,2,5
295438,0,2 user reviews,2,0,2
295439,0,1 user reviews,1,0,1
295490,6,Mostly Positive,31,11,42
295510,7,Positive,22,0,22
295550,8,Very Positive,55,13,68
295560,0,1 user reviews,1,0,1
295590,5,Mixed,61,66,127
295610,4,Mostly Negative,14,31,45
295630,8,Very Positive,49,12,61
295650,0,1 user reviews,1,0,1
295670,6,Mostly Positive,114,41,155
295690,8,Very Positive,560,85,645
295730,8,Very Positive,42,10,52
295750,8,Very Positive,162,35,197
295770,6,Mostly Positive,217,69,286
295790,6,Mostly Positive,1654,440,2094
295810,5,Mixed,33,44,77
295850,5,Mixed,162,83,245
295870,5,Mixed,34,16,50
295910,5,Mixed,25,11,36
295930,0,8 user reviews,6,2,8
295950,4,Mostly Negative,5,8,13
295990,4,Mostly Negative,11,44,55
296010,6,Mostly Positive,59,15,74
296030,5,Mixed,12,6,18
296050,5,Mixed,32,15,47
296070,5,Mixed,255,155,410
296093,7,Positive,12,1,13
296103,0,5 user reviews,3,2,5
296150,4,Mostly Negative,9,25,34
296170,0,9 user reviews,9,0,9
296180,5,Mixed,19,12,31
296210,5,Mixed,17,11,28
296220,6,Mostly Positive,72,30,102
296240,8,Very Positive,257,59,316
296270,0,4 user reviews,4,0,4
296271,0,2 user reviews,2,0,2
296280,5,Mixed,15,22,37
296300,6,Mostly Positive,1170,476,1646
296360,0,4 user reviews,4,0,4
296440,0,5 user reviews,4,1,5
296441,0,1 user reviews,0,1,1
296450,0,6 user reviews,4,2,6
296470,9,Overwhelmingly Positive,2561,113,2674
296490,9,Overwhelmingly Positive,1763,66,1829
296510,0,9 user reviews,6,3,9
296530,5,Mixed,14,21,35
296550,5,Mixed,39,17,56
296570,6,Mostly Positive,391,100,491
296590,5,Mixed,9,13,22
296610,4,Mostly Negative,15,34,49
296630,6,Mostly Positive,49,18,67
296650,0,3 user reviews,3,0,3
296710,8,Very Positive,766,87,853
296730,6,Mostly Positive,53,20,73
296770,5,Mixed,157,122,279
296790,6,Mostly Positive,26,7,33
296810,0,4 user reviews,4,0,4
296830,5,Mixed,345,237,582
296850,6,Mostly Positive,8,3,11
296870,8,Very Positive,464,46,510
296890,7,Positive,26,3,29
296910,6,Mostly Positive,247,103,350
296930,6,Mostly Positive,70,18,88
296950,0,2 user reviews,0,2,2
296970,8,Very Positive,1514,128,1642
296990,0,9 user reviews,5,4,9
297000,6,Mostly Positive,2042,848,2890
297020,5,Mixed,43,27,70
297060,7,Positive,41,6,47
297070,4,Mostly Negative,3,7,10
297080,0,3 user reviews,2,1,3
297090,0,7 user reviews,3,4,7
297100,4,Mostly Negative,23,41,64
297110,8,Very Positive,401,47,448
297120,8,Very Positive,668,143,811
297130,6,Mostly Positive,1322,503,1825
297140,0,3 user reviews,3,0,3
297141,0,3 user reviews,2,1,3
297142,0,3 user reviews,3,0,3
297143,5,Mixed,5,6,11
297190,0,9 user reviews,6,3,9
297210,0,8 user reviews,6,2,8
297270,0,9 user reviews,3,6,9
297290,8,Very Positive,56,10,66
297310,5,Mixed,69,58,127
297330,5,Mixed,39,26,65
297350,6,Mostly Positive,253,104,357
297370,7,Positive,33,5,38
297390,0,2 user reviews,0,2,2
297410,7,Positive,20,2,22
297450,4,Mostly Negative,13,21,34
297470,6,Mostly Positive,162,61,223
297490,8,Very Positive,53,11,64
297510,0,6 user reviews,5,1,6
297511,0,4 user reviews,2,2,4
297512,6,Mostly Positive,15,6,21
297513,5,Mixed,6,4,10
297514,0,4 user reviews,4,0,4
297515,0,6 user reviews,6,0,6
297570,6,Mostly Positive,27,9,36
297590,7,Positive,28,1,29
297620,5,Mixed,14,12,26
297640,0,2 user reviews,2,0,2
297641,0,5 user reviews,2,3,5
297642,0,1 user reviews,1,0,1
297643,0,2 user reviews,1,1,2
297644,6,Mostly Positive,13,4,17
297645,0,6 user reviews,5,1,6
297650,0,7 user reviews,7,0,7
297660,7,Positive,32,2,34
297720,5,Mixed,70,43,113
297740,5,Mixed,9,4,13
297750,5,Mixed,140,84,224
297760,8,Very Positive,130,26,156
297790,6,Mostly Positive,9,3,12
297791,7,Positive,40,4,44
297792,7,Positive,17,4,21
297793,7,Positive,19,2,21
297810,4,Mostly Negative,369,897,1266
297830,5,Mixed,68,44,112
297831,5,Mixed,38,19,57
297840,0,7 user reviews,6,1,7
297841,0,1 user reviews,0,1,1
297860,6,Mostly Positive,271,104,375
297900,0,2 user reviews,1,1,2
297920,6,Mostly Positive,134,52,186
297950,0,1 user reviews,0,1,1
298010,0,1 user reviews,0,1,1
298020,5,Mixed,15,18,33
298030,9,Overwhelmingly Positive,1243,54,1297
298050,6,Mostly Positive,2301,848,3149
298110,6,Mostly Positive,9209,2700,11909
298140,6,Mostly Positive,34,12,46
298160,0,9 user reviews,5,4,9
298180,8,Very Positive,112,4,116
298220,4,Mostly Negative,8,19,27
298240,5,Mixed,47,36,83
298260,5,Mixed,20,10,30
298280,6,Mostly Positive,56,16,72
298340,5,Mixed,37,32,69
298360,8,Very Positive,73,9,82
298380,0,4 user reviews,1,3,4
298400,8,Very Positive,187,15,202
298420,0,6 user reviews,2,4,6
298480,6,Mostly Positive,216,80,296
298520,8,Very Positive,497,107,604
298560,8,Very Positive,146,33,179
298600,8,Very Positive,870,58,928
298610,5,Mixed,1153,824,1977
298620,0,3 user reviews,2,1,3
298630,8,Very Positive,7530,884,8414
298641,8,Very Positive,119,6,125
298670,4,Mostly Negative,4,8,12
298672,3,Negative,2,16,18
298680,7,Positive,15,0,15
298720,0,3 user reviews,3,0,3
298790,7,Positive,28,1,29
298810,0,5 user reviews,3,2,5
298820,7,Positive,12,3,15
298830,0,9 user reviews,8,1,9
298840,0,5 user reviews,4,1,5
298850,5,Mixed,7,5,12
298860,0,4 user reviews,4,0,4
298880,0,1 user reviews,1,0,1
298900,5,Mixed,1903,1545,3448
298930,6,Mostly Positive,130,49,179
298950,5,Mixed,36,20,56
298970,0,4 user reviews,3,1,4
299010,0,3 user reviews,1,2,3
299020,5,Mixed,5,5,10
299030,8,Very Positive,613,76,689
299050,5,Mixed,75,83,158
299070,8,Very Positive,88,8,96
299090,5,Mixed,9,11,20
299100,0,4 user reviews,2,2,4
299110,8,Very Positive,111,22,133
299140,0,1 user reviews,1,0,1
299150,5,Mixed,46,26,72
299160,8,Very Positive,40,10,50
299170,4,Mostly Negative,10,16,26
299180,5,Mixed,26,17,43
299190,0,1 user reviews,1,0,1
299230,7,Positive,47,2,49
299240,8,Very Positive,201,3,204
299250,5,Mixed,114,157,271
299260,0,9 user reviews,7,2,9
299270,0,1 user reviews,0,1,1
299290,0,1 user reviews,1,0,1
299340,4,Mostly Negative,44,85,129
299350,8,Very Positive,50,5,55
299360,6,Mostly Positive,858,302,1160
299380,0,7 user reviews,5,2,7
299400,8,Very Positive,127,15,142
299420,5,Mixed,8,8,16
299440,7,Positive,9,1,10
299460,5,Mixed,492,237,729
299480,5,Mixed,80,48,128
299500,5,Mixed,105,72,177
299540,8,Very Positive,264,54,318
299600,5,Mixed,44,41,85
299640,6,Mostly Positive,47,15,62
299660,8,Very Positive,224,21,245
299680,8,Very Positive,232,51,283
299700,5,Mixed,34,33,67
299720,8,Very Positive,392,65,457
299740,5,Mixed,7493,3835,11328
299780,5,Mixed,77,47,124
299800,0,8 user reviews,6,2,8
299820,3,Negative,1,10,11
299860,4,Mostly Negative,403,665,1068
299890,5,Mixed,17,25,42
299950,6,Mostly Positive,257,70,327
300040,0,3 user reviews,2,1,3
300060,5,Mixed,279,239,518
300080,5,Mixed,9,13,22
300120,7,Positive,14,2,16
300140,0,2 user reviews,1,1,2
300160,3,Negative,1,15,16
300200,5,Mixed,6,4,10
300220,5,Mixed,27,16,43
300260,5,Mixed,112,74,186
300280,6,Mostly Positive,10,3,13
300300,8,Very Positive,132,23,155
300320,5,Mixed,40,29,69
300340,8,Very Positive,81,9,90
300360,5,Mixed,18,13,31
300380,8,Very Positive,3221,632,3853
300400,8,Very Positive,60,14,74
300510,0,4 user reviews,2,2,4
300540,7,Positive,9,2,11
300550,8,Very Positive,2805,296,3101
300570,9,Overwhelmingly Positive,1081,50,1131
300580,6,Mostly Positive,144,42,186
300610,5,Mixed,82,100,182
300630,5,Mixed,28,16,44
300760,5,Mixed,21,13,34
300790,0,5 user reviews,5,0,5
300820,5,Mixed,69,58,127
300840,7,Positive,20,2,22
300870,6,Mostly Positive,11,3,14
300900,4,Mostly Negative,19,42,61
300910,4,Mostly Negative,3,9,12
300920,0,5 user reviews,2,3,5
300970,0,6 user reviews,4,2,6
300990,0,2 user reviews,2,0,2
300991,0,1 user reviews,1,0,1
300992,0,2 user reviews,2,0,2
301050,7,Positive,22,5,27
301114,0,4 user reviews,4,0,4
301115,0,6 user reviews,6,0,6
301116,0,2 user reviews,2,0,2
301120,8,Very Positive,596,91,687
301140,0,8 user reviews,8,0,8
301150,8,Very Positive,93,21,114
301180,7,Positive,16,3,19
301190,8,Very Positive,219,45,264
301200,8,Very Positive,120,21,141
301210,0,8 user reviews,5,3,8
301220,0,7 user reviews,1,6,7
301244,0,1 user reviews,0,1,1
301250,0,3 user reviews,1,2,3
301260,0,7 user reviews,6,1,7
301270,0,4 user reviews,3,1,4
301300,8,Very Positive,151,3,154
301320,8,Very Positive,418,26,444
301360,5,Mixed,12,11,23
301380,8,Very Positive,98,11,109
301420,0,2 user reviews,0,2,2
301460,6,Mostly Positive,127,37,164
301480,5,Mixed,411,349,760
301500,6,Mostly Positive,35,15,50
301520,5,Mixed,665,377,1042
301540,5,Mixed,9,5,14
301560,6,Mostly Positive,74,31,105
301600,7,Positive,11,0,11
301610,8,Very Positive,129,30,159
301640,8,Very Positive,3079,505,3584
301650,8,Very Positive,450,41,491
301660,7,Positive,22,4,26
301670,6,Mostly Positive,18,6,24
301690,6,Mostly Positive,14,6,20
301700,7,Positive,25,5,30
301730,5,Mixed,12,15,27
301740,6,Mostly Positive,55,23,78
301750,5,Mixed,8,8,16
301760,5,Mixed,22,25,47
301830,7,Positive,28,5,33
301840,8,Very Positive,240,46,286
301860,6,Mostly Positive,977,294,1271
301880,0,4 user reviews,3,1,4
301891,0,3 user reviews,3,0,3
301892,5,Mixed,10,5,15
301893,0,3 user reviews,1,2,3
301894,0,3 user reviews,1,2,3
301895,0,8 user reviews,6,2,8
301896,0,7 user reviews,4,3,7
301897,0,7 user reviews,4,3,7
301900,0,9 user reviews,9,0,9
301910,6,Mostly Positive,1949,758,2707
301920,8,Very Positive,50,2,52
301930,7,Positive,11,2,13
301950,0,3 user reviews,3,0,3
301970,8,Very Positive,421,30,451
301980,5,Mixed,28,18,46
301990,0,8 user reviews,5,3,8
302010,5,Mixed,34,17,51
302020,0,2 user reviews,0,2,2
302030,0,1 user reviews,0,1,1
302060,5,Mixed,55,35,90
302080,6,Mostly Positive,352,105,457
302110,6,Mostly Positive,28,8,36
302120,7,Positive,43,3,46
302130,8,Very Positive,71,8,79
302160,5,Mixed,18,22,40
302170,5,Mixed,10,9,19
302180,6,Mostly Positive,35,11,46
302190,5,Mixed,31,16,47
302210,8,Very Positive,41,10,51
302260,5,Mixed,6,9,15
302270,5,Mixed,480,591,1071
302290,4,Mostly Negative,5,10,15
302310,6,Mostly Positive,17,6,23
302320,5,Mixed,10,11,21
302330,6,Mostly Positive,22,7,29
302340,7,Positive,13,3,16
302350,7,Positive,46,1,47
302360,7,Positive,25,2,27
302370,4,Mostly Negative,6,15,21
302380,7,Positive,33,2,35
302390,4,Mostly Negative,12,37,49
302440,4,Mostly Negative,6,17,23
302450,0,1 user reviews,1,0,1
302470,5,Mixed,26,14,40
302490,8,Very Positive,54,3,57
302510,8,Very Positive,5740,1249,6989
302570,5,Mixed,7,8,15
302590,8,Very Positive,217,46,263
302610,8,Very Positive,695,49,744
302650,0,8 user reviews,5,3,8
302670,6,Mostly Positive,2711,800,3511
302690,8,Very Positive,223,37,260
302710,8,Very Positive,277,40,317
302730,7,Positive,21,1,22
302750,7,Positive,37,1,38
302790,8,Very Positive,448,38,486
302810,7,Positive,9,2,11
302830,5,Mixed,49,53,102
302850,4,Mostly Negative,8,14,22
302870,0,7 user reviews,2,5,7
302910,4,Mostly Negative,17,31,48
302950,5,Mixed,13,17,30
302970,6,Mostly Positive,42,13,55
303210,8,Very Positive,9009,1435,10444
303260,5,Mixed,9,8,17
303290,8,Very Positive,258,46,304
303310,9,Overwhelmingly Positive,526,21,547
303331,0,1 user reviews,0,1,1
303340,7,Positive,16,4,20
303360,0,1 user reviews,0,1,1
303390,5,Mixed,728,728,1456
303430,8,Very Positive,283,20,303
303470,0,8 user reviews,6,2,8
303510,5,Mixed,14,16,30
303530,5,Mixed,12,7,19
303550,8,Very Positive,78,13,91
303590,8,Very Positive,265,3,268
303610,8,Very Positive,276,52,328
303680,8,Very Positive,180,12,192
303690,8,Very Positive,167,15,182
303710,4,Mostly Negative,3,7,10
303720,5,Mixed,18,8,26
303730,7,Positive,12,1,13
303780,0,8 user reviews,8,0,8
303790,6,Mostly Positive,218,92,310
303800,6,Mostly Positive,313,134,447
303830,4,Mostly Negative,2,8,10
303840,5,Mixed,38,20,58
303850,0,3 user reviews,3,0,3
303860,6,Mostly Positive,17,5,22
303870,5,Mixed,6,9,15
303880,0,3 user reviews,2,1,3
303910,5,Mixed,8,8,16
303940,8,Very Positive,66,13,79
304000,5,Mixed,11,12,23
304010,5,Mixed,23,28,51
304020,7,Positive,27,4,31
304030,5,Mixed,335,323,658
304050,6,Mostly Positive,338,133,471
304080,0,2 user reviews,1,1,2
304081,0,1 user reviews,1,0,1
304082,0,3 user reviews,2,1,3
304140,7,Positive,11,1,12
304150,0,8 user reviews,2,6,8
304170,4,Mostly Negative,10,19,29
304210,7,Positive,23,4,27
304211,7,Positive,29,1,30
304212,9,Overwhelmingly Positive,764,39,803
304213,7,Positive,36,2,38
304214,8,Very Positive,236,38,274
304240,8,Very Positive,3527,341,3868
304290,8,Very Positive,113,27,140
304300,0,2 user reviews,2,0,2
304301,0,3 user reviews,2,1,3
304310,7,Positive,34,7,41
304320,0,3 user reviews,3,0,3
304330,0,1 user reviews,1,0,1
304350,5,Mixed,158,79,237
304360,0,1 user reviews,0,1,1
304380,6,Mostly Positive,178,68,246
304390,5,Mixed,14605,8614,23219
304410,9,Overwhelmingly Positive,1388,36,1424
304430,9,Overwhelmingly Positive,10237,502,10739
304460,5,Mixed,80,42,122
304480,7,Positive,8,2,10
304500,6,Mostly Positive,15,6,21
304530,5,Mixed,887,557,1444
304540,5,Mixed,7,6,13
304580,5,Mixed,33,40,73
304590,0,3 user reviews,2,1,3
304650,8,Very Positive,3773,734,4507
304670,6,Mostly Positive,148,49,197
304690,0,4 user reviews,2,2,4
304730,5,Mixed,671,520,1191
304750,0,9 user reviews,0,9,9
304810,0,7 user reviews,4,3,7
304850,7,Positive,17,3,20
304910,8,Very Positive,94,22,116
304930,8,Very Positive,2680,292,2972
304950,6,Mostly Positive,245,80,325
304970,0,1 user reviews,1,0,1
305010,0,7 user reviews,5,2,7
305050,6,Mostly Positive,308,111,419
305070,6,Mostly Positive,51,17,68
305180,5,Mixed,23,10,33
305181,7,Positive,23,0,23
305182,7,Positive,8,2,10
305183,0,7 user reviews,5,2,7
305184,5,Mixed,6,5,11
305185,0,7 user reviews,5,2,7
305186,0,9 user reviews,6,3,9
305187,0,9 user reviews,7,2,9
305200,0,3 user reviews,0,3,3
305221,0,4 user reviews,3,1,4
305260,5,Mixed,10,6,16
305342,0,1 user reviews,1,0,1
305360,0,2 user reviews,2,0,2
305380,8,Very Positive,438,46,484
305390,5,Mixed,14,18,32
305410,0,1 user reviews,1,0,1
305450,0,1 user reviews,1,0,1
305460,0,8 user reviews,3,5,8
305470,0,1 user reviews,0,1,1
305480,5,Mixed,9,6,15
305490,6,Mostly Positive,15,4,19
305500,5,Mixed,17,14,31
305510,5,Mixed,32,36,68
305570,0,5 user reviews,5,0,5
305620,8,Very Positive,21545,2388,23933
305640,5,Mixed,127,68,195
305660,4,Mostly Negative,4,13,17
305700,0,6 user reviews,3,3,6
305720,0,6 user reviews,4,2,6
305740,6,Mostly Positive,10,3,13
305760,8,Very Positive,80,1,81
305780,6,Mostly Positive,72,20,92
305800,5,Mixed,26,12,38
305820,7,Positive,14,2,16
305840,4,Mostly Negative,32,94,126
305860,5,Mixed,10,11,21
305880,0,3 user reviews,3,0,3
305920,8,Very Positive,51,4,55
305940,5,Mixed,221,143,364
305960,4,Mostly Negative,183,333,516
305980,5,Mixed,30,21,51
306000,6,Mostly Positive,8,3,11
306020,8,Very Positive,3618,255,3873
306040,6,Mostly Positive,398,134,532
306100,0,1 user reviews,1,0,1
306130,8,Very Positive,31132,7232,38364
306150,0,6 user reviews,3,3,6
306160,7,Positive,20,4,24
306170,0,2 user reviews,2,0,2
306171,0,2 user reviews,2,0,2
306180,7,Positive,10,0,10
306200,6,Mostly Positive,133,39,172
306260,5,Mixed,8,11,19
306350,7,Positive,14,2,16
306370,5,Mixed,34,26,60
306390,5,Mixed,12,11,23
306391,5,Mixed,29,17,46
306392,7,Positive,13,3,16
306393,5,Mixed,13,11,24
306394,5,Mixed,8,6,14
306395,5,Mixed,7,5,12
306396,6,Mostly Positive,20,6,26
306397,5,Mixed,9,12,21
306398,6,Mostly Positive,14,5,19
306399,5,Mixed,6,9,15
306401,0,4 user reviews,4,0,4
306410,5,Mixed,60,61,121
306440,5,Mixed,38,32,70
306460,8,Very Positive,3447,195,3642
306480,5,Mixed,17,8,25
306490,5,Mixed,35,31,66
306531,0,1 user reviews,1,0,1
306550,8,Very Positive,127,26,153
306601,0,1 user reviews,1,0,1
306610,0,1 user reviews,1,0,1
306620,5,Mixed,9,7,16
306630,6,Mostly Positive,135,37,172
306640,8,Very Positive,66,6,72
306660,8,Very Positive,1411,281,1692
306670,4,Mostly Negative,57,215,272
306680,8,Very Positive,119,25,144
306690,5,Mixed,140,77,217
306700,8,Very Positive,148,17,165
306721,0,1 user reviews,1,0,1
306760,6,Mostly Positive,1308,354,1662
306850,7,Positive,22,0,22
306880,0,9 user reviews,5,4,9
306890,0,9 user reviews,8,1,9
306950,5,Mixed,6,4,10
307010,8,Very Positive,67,11,78
307030,7,Positive,9,1,10
307050,8,Very Positive,309,54,363
307070,5,Mixed,10,8,18
307090,6,Mostly Positive,35,15,50
307110,8,Very Positive,1392,216,1608
307130,5,Mixed,45,56,101
307150,5,Mixed,13,9,22
307170,5,Mixed,10,6,16
307190,8,Very Positive,48,11,59
307210,5,Mixed,13,11,24
307230,6,Mostly Positive,434,169,603
307270,0,4 user reviews,3,1,4
307290,0,7 user reviews,3,4,7
307340,8,Very Positive,147,8,155
307350,5,Mixed,7,8,15
307390,0,1 user reviews,0,1,1
307410,0,8 user reviews,2,6,8
307420,0,3 user reviews,2,1,3
307430,5,Mixed,25,11,36
307530,0,4 user reviews,0,4,4
307560,0,8 user reviews,4,4,8
307570,6,Mostly Positive,68,25,93
307580,9,Overwhelmingly Positive,521,26,547
307590,7,Positive,24,2,26
307600,5,Mixed,17,8,25
307610,0,4 user reviews,1,3,4
307620,5,Mixed,24,15,39
307640,8,Very Positive,349,64,413
307650,0,2 user reviews,2,0,2
307670,6,Mostly Positive,1233,372,1605
307690,8,Very Positive,10484,809,11293
307740,7,Positive,16,2,18
307750,6,Mostly Positive,12,4,16
307760,5,Mixed,52,38,90
307770,6,Mostly Positive,23,6,29
307780,6,Mostly Positive,5072,2003,7075
307800,5,Mixed,15,11,26
307820,0,1 user reviews,1,0,1
307821,0,1 user reviews,1,0,1
307822,0,1 user reviews,1,0,1
307823,0,1 user reviews,1,0,1
307824,0,3 user reviews,3,0,3
307825,0,1 user reviews,1,0,1
307880,5,Mixed,1520,1144,2664
307900,7,Positive,17,4,21
307920,5,Mixed,9,6,15
307930,5,Mixed,20,19,39
307940,6,Mostly Positive,131,45,176
307960,6,Mostly Positive,1688,460,2148
307980,5,Mixed,18,15,33
307990,5,Mixed,23,21,44
308000,7,Positive,30,4,34
308040,6,Mostly Positive,91,38,129
308060,6,Mostly Positive,158,43,201
308080,5,Mixed,14,8,22
308171,0,2 user reviews,1,1,2
308172,0,3 user reviews,2,1,3
308173,6,Mostly Positive,212,73,285
308180,7,Positive,14,2,16
308261,0,1 user reviews,1,0,1
308262,0,1 user reviews,1,0,1
308263,0,1 user reviews,1,0,1
308265,0,1 user reviews,1,0,1
308266,0,1 user reviews,1,0,1
308267,0,5 user reviews,5,0,5
308269,0,3 user reviews,3,0,3
308270,6,Mostly Positive,169,44,213
308300,7,Positive,8,2,10
308310,7,Positive,16,1,17
308330,7,Positive,24,5,29
308360,7,Positive,17,2,19
308380,6,Mostly Positive,10,3,13
308400,0,1 user reviews,1,0,1
308420,8,Very Positive,1612,205,1817
308440,0,7 user reviews,6,1,7
308460,5,Mixed,50,22,72
308520,4,Mostly Negative,10,18,28
308540,0,4 user reviews,3,1,4
308560,6,Mostly Positive,14,5,19
308580,7,Positive,8,2,10
308600,8,Very Positive,90,5,95
309870,0,2 user reviews,2,0,2
309871,0,2 user reviews,2,0,2
309900,5,Mixed,12,8,20
309920,0,2 user reviews,2,0,2
309940,0,2 user reviews,2,0,2
309973,0,1 user reviews,1,0,1
309990,7,Positive,24,4,28
309991,7,Positive,21,5,26
310030,5,Mixed,12,7,19
310031,5,Mixed,107,80,187
310032,0,7 user reviews,6,1,7
310033,0,5 user reviews,3,2,5
310034,0,7 user reviews,5,2,7
310050,0,3 user reviews,1,2,3
310060,8,Very Positive,669,117,786
310070,6,Mostly Positive,10,3,13
310080,9,Overwhelmingly Positive,3316,172,3488
310090,0,1 user reviews,1,0,1
310091,0,1 user reviews,1,0,1
310100,0,9 user reviews,8,1,9
310110,5,Mixed,48,52,100
310260,0,1 user reviews,0,1,1
310280,0,1 user reviews,0,1,1
310300,0,3 user reviews,3,0,3
310360,9,Overwhelmingly Positive,844,38,882
310370,5,Mixed,22,13,35
310380,6,Mostly Positive,934,239,1173
310390,8,Very Positive,54,13,67
310400,0,1 user reviews,1,0,1
310410,0,2 user reviews,2,0,2
310420,0,3 user reviews,2,1,3
310430,0,3 user reviews,1,2,3
310440,0,3 user reviews,2,1,3
310450,0,4 user reviews,3,1,4
310460,0,9 user reviews,2,7,9
310470,5,Mixed,314,426,740
310490,8,Very Positive,71,13,84
310510,8,Very Positive,611,138,749
310560,8,Very Positive,8107,932,9039
310640,3,Negative,2,12,14
310660,7,Positive,27,1,28
310680,0,1 user reviews,1,0,1
310690,0,8 user reviews,2,6,8
310700,8,Very Positive,300,35,335
310740,8,Very Positive,148,22,170
310790,8,Very Positive,692,71,763
310810,7,Positive,16,3,19
310830,0,6 user reviews,5,1,6
310850,4,Mostly Negative,29,54,83
310880,3,Negative,3,16,19
310890,5,Mixed,193,191,384
310950,5,Mixed,4434,2875,7309
310970,6,Mostly Positive,14,5,19
310990,0,1 user reviews,1,0,1
311010,8,Very Positive,255,63,318
311031,0,3 user reviews,0,3,3
311040,4,Mostly Negative,22,34,56
311050,5,Mixed,152,96,248
311060,7,Positive,17,2,19
311080,4,Mostly Negative,6,22,28
311100,6,Mostly Positive,12,4,16
311120,5,Mixed,73,84,157
311140,5,Mixed,99,72,171
311160,5,Mixed,11,10,21
311161,5,Mixed,10,5,15
311162,0,3 user reviews,1,2,3
311163,0,7 user reviews,4,3,7
311164,5,Mixed,20,11,31
311170,4,Mostly Negative,5,8,13
311190,8,Very Positive,374,13,387
311210,6,Mostly Positive,22301,5698,27999
311240,8,Very Positive,1192,165,1357
311250,5,Mixed,53,36,89
311260,5,Mixed,867,645,1512
311290,6,Mostly Positive,1108,432,1540
311310,5,Mixed,2066,1387,3453
311320,0,1 user reviews,1,0,1
311330,0,4 user reviews,4,0,4
311340,8,Very Positive,4461,971,5432
311380,0,1 user reviews,1,0,1
311400,4,Mostly Negative,78,179,257
311440,0,2 user reviews,2,0,2
311480,6,Mostly Positive,77,28,105
311490,0,8 user reviews,5,3,8
311500,0,2 user reviews,1,1,2
311540,0,3 user reviews,2,1,3
311550,0,1 user reviews,1,0,1
311551,0,3 user reviews,2,1,3
311560,8,Very Positive,2648,525,3173
311600,5,Mixed,6,6,12
311660,6,Mostly Positive,47,18,65
311680,6,Mostly Positive,27,11,38
311690,9,Overwhelmingly Positive,22415,991,23406
311720,6,Mostly Positive,166,47,213
311730,5,Mixed,926,518,1444
311770,6,Mostly Positive,246,67,313
311800,8,Very Positive,290,20,310
311820,7,Positive,14,1,15
311840,4,Mostly Negative,13,20,33
311850,6,Mostly Positive,22,7,29
311860,6,Mostly Positive,28,10,38
311870,8,Very Positive,400,56,456
311910,5,Mixed,33,24,57
311920,0,1 user reviews,0,1,1
311930,7,Positive,47,2,49
311940,0,1 user reviews,0,1,1
311950,0,2 user reviews,2,0,2
311980,3,Negative,6,26,32
312010,8,Very Positive,143,16,159
312020,0,5 user reviews,2,3,5
312050,0,4 user reviews,2,2,4
312060,0,1 user reviews,1,0,1
312090,0,1 user reviews,1,0,1
312150,7,Positive,27,2,29
312200,5,Mixed,346,152,498
312210,5,Mixed,243,353,596
312220,0,3 user reviews,1,2,3
312230,6,Mostly Positive,184,52,236
312240,0,4 user reviews,2,2,4
312280,7,Positive,33,8,41
312290,6,Mostly Positive,32,9,41
312300,8,Very Positive,103,11,114
312310,0,2 user reviews,2,0,2
312350,6,Mostly Positive,110,32,142
312360,5,Mixed,57,30,87
312370,8,Very Positive,379,82,461
312380,7,Positive,9,2,11
312390,6,Mostly Positive,20,6,26
312400,0,9 user reviews,2,7,9
312410,6,Mostly Positive,19,7,26
312420,5,Mixed,9,10,19
312430,5,Mixed,96,99,195
312440,5,Mixed,11,7,18
312450,8,Very Positive,241,46,287
312510,7,Positive,28,7,35
312520,8,Very Positive,1520,179,1699
312530,9,Overwhelmingly Positive,7719,251,7970
312540,8,Very Positive,300,27,327
312560,8,Very Positive,172,18,190
312590,0,2 user reviews,1,1,2
312600,5,Mixed,39,18,57
312610,8,Very Positive,500,75,575
312630,6,Mostly Positive,75,20,95
312640,6,Mostly Positive,13,4,17
312650,6,Mostly Positive,166,52,218
312660,8,Very Positive,5755,769,6524
312670,8,Very Positive,856,148,1004
312680,5,Mixed,11,7,18
312690,7,Positive,11,2,13
312720,8,Very Positive,67,3,70
312740,6,Mostly Positive,11,3,14
312750,8,Very Positive,726,145,871
312780,6,Mostly Positive,712,186,898
312790,5,Mixed,76,63,139
312840,6,Mostly Positive,832,280,1112
312860,0,3 user reviews,2,1,3
312900,5,Mixed,23,13,36
312920,8,Very Positive,85,18,103
312960,4,Mostly Negative,11,29,40
312970,6,Mostly Positive,58,15,73
312980,8,Very Positive,279,37,316
312990,8,Very Positive,60,3,63
313010,4,Mostly Negative,261,642,903
313020,8,Very Positive,753,171,924
313040,4,Mostly Negative,16,28,44
313080,5,Mixed,148,95,243
313120,6,Mostly Positive,11819,3937,15756
313130,5,Mixed,26,20,46
313140,6,Mostly Positive,75,27,102
313160,8,Very Positive,3433,381,3814
313190,0,8 user reviews,1,7,8
313200,5,Mixed,22,13,35
313210,5,Mixed,46,29,75
313240,6,Mostly Positive,7,3,10
313260,0,9 user reviews,6,3,9
313280,0,1 user reviews,1,0,1
313281,0,2 user reviews,1,1,2
313330,4,Mostly Negative,4,16,20
313340,8,Very Positive,3992,654,4646
313350,0,2 user reviews,2,0,2
313360,6,Mostly Positive,26,8,34
313381,4,Mostly Negative,11,22,33
313390,6,Mostly Positive,58,19,77
313400,8,Very Positive,122,4,126
313420,6,Mostly Positive,12,5,17
313430,7,Positive,23,4,27
313470,7,Positive,40,7,47
313480,8,Very Positive,212,35,247
313500,8,Very Positive,191,34,225
313560,7,Positive,20,1,21
313590,6,Mostly Positive,121,32,153
313620,2,Very Negative,23,98,121
313630,6,Mostly Positive,1090,303,1393
313650,5,Mixed,48,27,75
313660,5,Mixed,29,15,44
313690,8,Very Positive,847,168,1015
313730,7,Positive,11,1,12
313740,6,Mostly Positive,2473,845,3318
313760,7,Positive,12,3,15
313780,6,Mostly Positive,454,138,592
313790,0,4 user reviews,3,1,4
313800,0,4 user reviews,4,0,4
313810,5,Mixed,54,31,85
313830,5,Mixed,53,31,84
313870,5,Mixed,42,34,76
313931,0,2 user reviews,1,1,2
313960,5,Mixed,7,10,17
313980,8,Very Positive,80,18,98
314000,6,Mostly Positive,128,44,172
314010,8,Very Positive,68,16,84
314020,6,Mostly Positive,1201,367,1568
314030,8,Very Positive,164,22,186
314050,0,4 user reviews,2,2,4
314070,8,Very Positive,440,43,483
314120,5,Mixed,8,4,12
314130,0,1 user reviews,0,1,1
314150,5,Mixed,135,121,256
314160,8,Very Positive,8589,1585,10174
314180,8,Very Positive,143,5,148
314200,5,Mixed,23,10,33
314210,4,Mostly Negative,3,9,12
314220,5,Mixed,24,17,41
314230,8,Very Positive,1004,62,1066
314240,5,Mixed,184,155,339
314250,6,Mostly Positive,51,16,67
314280,5,Mixed,9,6,15
314290,0,7 user reviews,4,3,7
314300,0,3 user reviews,1,2,3
314320,5,Mixed,87,40,127
314330,8,Very Positive,43,7,50
314340,5,Mixed,23,29,52
314350,0,4 user reviews,3,1,4
314360,0,2 user reviews,2,0,2
314370,7,Positive,38,8,46
314380,5,Mixed,92,77,169
314400,0,1 user reviews,1,0,1
314410,8,Very Positive,741,64,805
314420,0,7 user reviews,4,3,7
314450,8,Very Positive,492,116,608
314460,5,Mixed,10,10,20
314470,8,Very Positive,98,15,113
314500,6,Mostly Positive,74,22,96
314510,5,Mixed,13,13,26
314520,5,Mixed,301,230,531
314530,0,9 user reviews,0,9,9
314540,0,8 user reviews,5,3,8
314560,5,Mixed,41,32,73
314570,0,1 user reviews,1,0,1
314590,7,Positive,16,1,17
314630,0,7 user reviews,6,1,7
314650,9,Overwhelmingly Positive,1775,93,1868
314660,8,Very Positive,1046,162,1208
314680,7,Positive,36,0,36
314710,5,Mixed,441,396,837
314730,0,7 user reviews,4,3,7
314750,0,1 user reviews,0,1,1
314760,4,Mostly Negative,3,11,14
314770,5,Mixed,7,4,11
314790,6,Mostly Positive,165,54,219
314810,5,Mixed,110,93,203
314830,5,Mixed,141,90,231
314850,3,Negative,0,13,13
314950,4,Mostly Negative,4,10,14
314970,7,Positive,9,1,10
314980,6,Mostly Positive,449,153,602
315050,0,9 user reviews,6,3,9
315060,0,9 user reviews,6,3,9
315070,0,4 user reviews,1,3,4
315080,6,Mostly Positive,11,3,14
315100,0,1 user reviews,1,0,1
315101,0,2 user reviews,1,1,2
315110,8,Very Positive,48,8,56
315120,0,2 user reviews,1,1,2
315130,5,Mixed,8,7,15
315150,5,Mixed,9,11,20
315151,6,Mostly Positive,18,5,23
315200,7,Positive,15,0,15
315240,5,Mixed,12,14,26
315260,5,Mixed,46,47,93
315320,4,Mostly Negative,12,22,34
315330,3,Negative,4,21,25
315340,5,Mixed,56,35,91
315392,0,9 user reviews,2,7,9
315393,5,Mixed,18,8,26
315430,6,Mostly Positive,1298,430,1728
315440,5,Mixed,60,50,110
315450,5,Mixed,6,5,11
315460,8,Very Positive,1691,145,1836
315480,0,4 user reviews,1,3,4
315490,0,3 user reviews,2,1,3
315520,0,2 user reviews,2,0,2
315530,0,7 user reviews,6,1,7
315540,5,Mixed,16,16,32
315550,5,Mixed,34,45,79
315560,0,6 user reviews,6,0,6
315610,6,Mostly Positive,10,4,14
315650,7,Positive,11,0,11
315660,6,Mostly Positive,756,287,1043
315670,6,Mostly Positive,90,38,128
315680,4,Mostly Negative,8,17,25
315720,0,3 user reviews,3,0,3
315810,8,Very Positive,460,29,489
315830,8,Very Positive,48,6,54
315840,8,Very Positive,291,38,329
315850,5,Mixed,78,38,116
315860,5,Mixed,169,77,246
315890,0,8 user reviews,6,2,8
315906,0,1 user reviews,1,0,1
315916,0,3 user reviews,1,2,3
315920,5,Mixed,30,21,51
315930,5,Mixed,9,6,15
315940,5,Mixed,9,6,15
315960,7,Positive,23,1,24
315990,0,4 user reviews,1,3,4
316010,6,Mostly Positive,524,143,667
316020,6,Mostly Positive,11,4,15
316030,5,Mixed,18,9,27
316050,0,1 user reviews,1,0,1
316060,5,Mixed,10,6,16
316070,0,1 user reviews,1,0,1
316080,8,Very Positive,61,8,69
316131,0,1 user reviews,1,0,1
316140,5,Mixed,26,21,47
316160,5,Mixed,44,44,88
316180,5,Mixed,19,10,29
316240,3,Negative,2,16,18
316260,6,Mostly Positive,36,15,51
316320,4,Mostly Negative,4,7,11
316360,7,Positive,12,0,12
316370,4,Mostly Negative,9,18,27
316390,4,Mostly Negative,29,49,78
316410,8,Very Positive,347,52,399
316430,5,Mixed,517,355,872
316440,0,6 user reviews,6,0,6
316441,0,3 user reviews,3,0,3
316442,0,3 user reviews,1,2,3
316443,0,3 user reviews,3,0,3
316444,0,6 user reviews,5,1,6
316445,0,2 user reviews,2,0,2
316446,0,9 user reviews,6,3,9
316447,0,5 user reviews,5,0,5
316448,0,3 user reviews,2,1,3
316460,0,6 user reviews,6,0,6
316480,7,Positive,20,5,25
316560,7,Positive,40,1,41
316590,0,1 user reviews,1,0,1
316600,8,Very Positive,164,10,174
316610,8,Very Positive,183,4,187
316620,0,3 user reviews,2,1,3
316630,0,4 user reviews,3,1,4
316660,7,Positive,16,1,17
316700,2,Very Negative,6,45,51
316710,0,1 user reviews,0,1,1
316720,9,Overwhelmingly Positive,976,24,1000
316740,5,Mixed,7,10,17
316750,4,Mostly Negative,54,136,190
316790,8,Very Positive,2187,272,2459
316810,5,Mixed,28,23,51
316830,0,5 user reviews,4,1,5
316840,6,Mostly Positive,20,7,27
316860,0,1 user reviews,1,0,1
316861,0,1 user reviews,1,0,1
316862,0,2 user reviews,2,0,2
316863,0,2 user reviews,2,0,2
316864,0,4 user reviews,3,1,4
316865,0,1 user reviews,1,0,1
316868,0,2 user reviews,2,0,2
316890,5,Mixed,42,22,64
316910,7,Positive,31,2,33
316920,0,1 user reviews,1,0,1
316930,5,Mixed,197,107,304
316950,4,Mostly Negative,8,24,32
316960,6,Mostly Positive,18,7,25
316961,0,2 user reviews,1,1,2
316962,4,Mostly Negative,15,45,60
316963,6,Mostly Positive,12,5,17
316964,8,Very Positive,85,15,100
316965,7,Positive,26,3,29
316966,7,Positive,10,0,10
316967,7,Positive,21,1,22
316970,5,Mixed,22,27,49
317020,7,Positive,19,0,19
317030,8,Very Positive,53,5,58
317040,8,Very Positive,242,16,258
317060,5,Mixed,17,10,27
317080,3,Negative,1,11,12
317100,6,Mostly Positive,172,62,234
317140,0,1 user reviews,1,0,1
317150,0,5 user reviews,5,0,5
317202,0,8 user reviews,4,4,8
317203,0,7 user reviews,2,5,7
317250,6,Mostly Positive,641,195,836
317280,8,Very Positive,64,10,74
317290,0,9 user reviews,7,2,9
317300,6,Mostly Positive,55,15,70
317320,8,Very Positive,89,7,96
317330,4,Mostly Negative,4,8,12
317360,8,Very Positive,84,13,97
317370,5,Mixed,19,11,30
317380,6,Mostly Positive,17,5,22
317400,8,Very Positive,122,5,127
317410,0,8 user reviews,6,2,8
317440,5,Mixed,28,29,57
317462,0,1 user reviews,0,1,1
317464,0,1 user reviews,1,0,1
317470,6,Mostly Positive,17,6,23
317480,7,Positive,24,1,25
317490,7,Positive,17,4,21
317500,0,3 user reviews,1,2,3
317501,0,4 user reviews,3,1,4
317510,8,Very Positive,348,64,412
317530,5,Mixed,40,24,64
317540,0,2 user reviews,2,0,2
317550,0,2 user reviews,2,0,2
317560,0,3 user reviews,3,0,3
317580,0,8 user reviews,5,3,8
317590,0,8 user reviews,4,4,8
317610,4,Mostly Negative,3,8,11
317620,6,Mostly Positive,339,129,468
317660,5,Mixed,50,42,92
317690,0,1 user reviews,0,1,1
317710,8,Very Positive,139,10,149
317720,0,9 user reviews,2,7,9
317730,4,Mostly Negative,4,14,18
317740,7,Positive,11,1,12
317770,0,8 user reviews,7,1,8
317790,0,1 user reviews,1,0,1
317820,6,Mostly Positive,764,269,1033
317840,6,Mostly Positive,8,3,11
317850,5,Mixed,30,42,72
317880,0,3 user reviews,2,1,3
317890,0,7 user reviews,7,0,7
317920,0,1 user reviews,0,1,1
317940,5,Mixed,46,20,66
317950,5,Mixed,11,10,21
317970,5,Mixed,25,31,56
318020,5,Mixed,697,462,1159
318050,0,1 user reviews,0,1,1
318070,0,1 user reviews,1,0,1
318072,0,2 user reviews,2,0,2
318074,0,1 user reviews,1,0,1
318080,0,1 user reviews,0,1,1
318090,5,Mixed,76,44,120
318100,5,Mixed,235,213,448
318111,0,2 user reviews,2,0,2
318130,9,Overwhelmingly Positive,897,27,924
318150,0,1 user reviews,1,0,1
318220,5,Mixed,561,650,1211
318230,6,Mostly Positive,626,175,801
318260,5,Mixed,35,28,63
318271,0,1 user reviews,1,0,1
318290,7,Positive,15,3,18
318300,0,2 user reviews,0,2,2
318310,8,Very Positive,254,22,276
318330,8,Very Positive,97,13,110
318350,4,Mostly Negative,8,13,21
318390,5,Mixed,45,39,84
318412,4,Mostly Negative,10,16,26
318420,5,Mixed,71,77,148
318430,8,Very Positive,1223,267,1490
318440,5,Mixed,14,9,23
318480,7,Positive,15,0,15
318500,7,Positive,23,2,25
318510,6,Mostly Positive,13,5,18
318511,6,Mostly Positive,11,4,15
318520,7,Positive,19,2,21
318521,7,Positive,33,1,34
318530,8,Very Positive,534,102,636
318560,0,3 user reviews,0,3,3
318570,5,Mixed,42,24,66
318591,0,1 user reviews,1,0,1
318600,6,Mostly Positive,748,212,960
318650,5,Mixed,46,25,71
318660,0,4 user reviews,1,3,4
318680,0,2 user reviews,0,2,2
318690,2,Very Negative,10,48,58
318710,6,Mostly Positive,10,3,13
318740,0,5 user reviews,4,1,5
318790,0,5 user reviews,1,4,5
318791,5,Mixed,54,65,119
318792,4,Mostly Negative,12,23,35
318793,5,Mixed,16,22,38
318794,4,Mostly Negative,4,11,15
318850,6,Mostly Positive,34,13,47
318860,5,Mixed,35,19,54
318870,0,3 user reviews,3,0,3
318872,0,2 user reviews,2,0,2
318874,0,2 user reviews,2,0,2
318875,0,3 user reviews,2,1,3
318950,5,Mixed,11,9,20
318970,8,Very Positive,430,82,512
318980,5,Mixed,5,5,10
318990,0,5 user reviews,2,3,5
319000,0,1 user reviews,1,0,1
319010,0,1 user reviews,1,0,1
319011,0,9 user reviews,9,0,9
319012,0,5 user reviews,2,3,5
319014,8,Very Positive,83,1,84
319015,7,Positive,45,1,46
319016,7,Positive,21,0,21
319017,7,Positive,13,0,13
319018,7,Positive,14,3,17
319050,6,Mostly Positive,424,144,568
319080,8,Very Positive,53,9,62
319090,5,Mixed,146,92,238
319140,6,Mostly Positive,266,99,365
319150,0,7 user reviews,4,3,7
319170,8,Very Positive,65,3,68
319180,5,Mixed,34,28,62
319210,0,7 user reviews,2,5,7
319230,5,Mixed,30,15,45
319240,0,1 user reviews,1,0,1
319250,8,Very Positive,323,35,358
319260,0,3 user reviews,2,1,3
319270,7,Positive,29,5,34
319280,5,Mixed,89,39,128
319290,0,2 user reviews,1,1,2
319300,6,Mostly Positive,12,4,16
319320,8,Very Positive,68,14,82
319400,8,Very Positive,73,9,82
319410,6,Mostly Positive,22,8,30
319430,4,Mostly Negative,5,12,17
319450,8,Very Positive,77,16,93
319470,8,Very Positive,62,9,71
319480,8,Very Positive,310,23,333
319510,8,Very Positive,11942,1448,13390
319540,5,Mixed,58,71,129
319560,6,Mostly Positive,153,47,200
319570,0,2 user reviews,1,1,2
319630,9,Overwhelmingly Positive,44230,1651,45881
319730,0,1 user reviews,0,1,1
319740,6,Mostly Positive,121,44,165
319750,6,Mostly Positive,36,11,47
319760,8,Very Positive,85,19,104
319780,4,Mostly Negative,17,28,45
319810,7,Positive,28,5,33
319820,0,6 user reviews,6,0,6
319821,0,1 user reviews,1,0,1
319830,5,Mixed,12,9,21
319850,6,Mostly Positive,55,17,72
319870,8,Very Positive,124,12,136
319910,5,Mixed,1091,672,1763
319930,7,Positive,14,0,14
319970,6,Mostly Positive,214,88,302
319980,5,Mixed,5,6,11
319990,5,Mixed,10,10,20
320000,6,Mostly Positive,14,6,20
320020,0,3 user reviews,1,2,3
320030,5,Mixed,176,99,275
320040,6,Mostly Positive,856,227,1083
320052,0,1 user reviews,0,1,1
320090,7,Positive,25,5,30
320110,6,Mostly Positive,24,10,34
320120,5,Mixed,13,10,23
320140,8,Very Positive,1085,111,1196
320150,6,Mostly Positive,14,6,20
320190,0,2 user reviews,0,2,2
320240,6,Mostly Positive,2612,1047,3659
320300,8,Very Positive,3095,356,3451
320310,4,Mostly Negative,8,19,27
320320,6,Mostly Positive,125,37,162
320330,6,Mostly Positive,35,11,46
320340,5,Mixed,255,300,555
320350,7,Positive,19,3,22
320351,7,Positive,16,1,17
320352,5,Mixed,12,13,25
320353,5,Mixed,10,10,20
320360,0,8 user reviews,7,1,8
320361,7,Positive,17,0,17
320362,0,8 user reviews,5,3,8
320363,0,8 user reviews,7,1,8
320364,0,1 user reviews,0,1,1
320370,7,Positive,12,1,13
320371,7,Positive,13,2,15
320372,4,Mostly Negative,6,12,18
320380,0,7 user reviews,3,4,7
320381,0,4 user reviews,3,1,4
320382,0,3 user reviews,2,1,3
320383,4,Mostly Negative,6,13,19
320384,0,4 user reviews,3,1,4
320385,0,4 user reviews,3,1,4
320386,0,6 user reviews,3,3,6
320387,0,4 user reviews,3,1,4
320388,0,5 user reviews,4,1,5
320400,7,Positive,16,1,17
320410,0,4 user reviews,2,2,4
320430,8,Very Positive,392,77,469
320440,0,2 user reviews,1,1,2
320520,5,Mixed,6,6,12
320540,6,Mostly Positive,81,30,111
320551,0,1 user reviews,0,1,1
320552,0,3 user reviews,2,1,3
320553,0,2 user reviews,2,0,2
320554,0,1 user reviews,1,0,1
320590,0,9 user reviews,7,2,9
320610,6,Mostly Positive,46,16,62
320630,6,Mostly Positive,44,18,62
320650,5,Mixed,14,14,28
320670,7,Positive,38,8,46
320690,5,Mixed,29,24,53
320720,0,1 user reviews,0,1,1
320721,0,2 user reviews,1,1,2
320730,0,3 user reviews,1,2,3
320750,0,4 user reviews,3,1,4
320760,8,Very Positive,403,26,429
320790,4,Mostly Negative,4,10,14
320820,5,Mixed,244,140,384
320830,0,2 user reviews,1,1,2
320840,6,Mostly Positive,136,40,176
320860,0,5 user reviews,2,3,5
320890,0,1 user reviews,1,0,1
320900,0,5 user reviews,3,2,5
320970,6,Mostly Positive,15,6,21
320986,5,Mixed,6,9,15
320987,5,Mixed,5,7,12
320988,4,Mostly Negative,3,7,10
320989,5,Mixed,13,16,29
321020,0,1 user reviews,1,0,1
321030,4,Mostly Negative,7,15,22
321040,8,Very Positive,1106,181,1287
321060,8,Very Positive,104,21,125
321070,0,1 user reviews,0,1,1
321080,0,9 user reviews,5,4,9
321100,7,Positive,9,1,10
321140,0,1 user reviews,1,0,1
321141,0,3 user reviews,3,0,3
321142,0,4 user reviews,3,1,4
321150,5,Mixed,45,36,81
321160,6,Mostly Positive,13,5,18
321170,0,2 user reviews,2,0,2
321180,0,3 user reviews,3,0,3
321181,0,2 user reviews,2,0,2
321182,0,2 user reviews,2,0,2
321190,8,Very Positive,48,4,52
321250,0,1 user reviews,1,0,1
321260,5,Mixed,84,98,182
321270,8,Very Positive,399,95,494
321290,8,Very Positive,358,56,414
321300,5,Mixed,1862,844,2706
321310,0,3 user reviews,0,3,3
321330,5,Mixed,14,8,22
321350,6,Mostly Positive,8,3,11
321360,6,Mostly Positive,2108,609,2717
321370,5,Mixed,19,15,34
321390,0,7 user reviews,0,7,7
321400,5,Mixed,130,65,195
321410,8,Very Positive,256,57,313
321420,0,1 user reviews,1,0,1
321421,0,4 user reviews,4,0,4
321430,6,Mostly Positive,83,25,108
321450,7,Positive,12,2,14
321460,0,3 user reviews,2,1,3
321470,0,2 user reviews,2,0,2
321471,0,1 user reviews,1,0,1
321472,0,1 user reviews,1,0,1
321473,0,1 user reviews,1,0,1
321474,0,1 user reviews,1,0,1
321476,0,1 user reviews,1,0,1
321478,0,1 user reviews,0,1,1
321480,0,4 user reviews,4,0,4
321490,3,Negative,4,17,21
321510,0,5 user reviews,3,2,5
321540,7,Positive,20,5,25
321560,7,Positive,31,7,38
321580,5,Mixed,16,18,34
321600,3,Negative,1,24,25
321610,5,Mixed,5,5,10
321620,6,Mostly Positive,15,6,21
321710,7,Positive,9,2,11
321800,8,Very Positive,782,104,886
321830,5,Mixed,79,42,121
321840,0,4 user reviews,4,0,4
321870,6,Mostly Positive,140,49,189
321880,5,Mixed,9,4,13
321890,7,Positive,13,2,15
321920,5,Mixed,27,13,40
321940,0,9 user reviews,6,3,9
321950,5,Mixed,11,13,24
321960,5,Mixed,763,797,1560
321980,6,Mostly Positive,258,101,359
321990,7,Positive,10,0,10
322000,5,Mixed,23,18,41
322020,8,Very Positive,55,4,59
322021,7,Positive,13,1,14
322022,5,Mixed,21,18,39
322030,0,3 user reviews,2,1,3
322080,6,Mostly Positive,37,14,51
322100,5,Mixed,8,9,17
322110,8,Very Positive,2089,138,2227
322130,7,Positive,19,2,21
322160,3,Negative,1,15,16
322170,8,Very Positive,41801,2506,44307
322190,9,Overwhelmingly Positive,1190,47,1237
322210,8,Very Positive,557,59,616
322290,8,Very Positive,171,16,187
322300,5,Mixed,412,338,750
322330,9,Overwhelmingly Positive,35819,1313,37132
322360,0,3 user reviews,0,3,3
322361,5,Mixed,7,6,13
322420,0,2 user reviews,2,0,2
322430,0,5 user reviews,1,4,5
322440,4,Mostly Negative,5,12,17
322450,8,Very Positive,111,9,120
322500,8,Very Positive,9423,1245,10668
322510,0,2 user reviews,1,1,2
322520,6,Mostly Positive,433,178,611
322540,4,Mostly Negative,12,22,34
322550,0,6 user reviews,4,2,6
322580,0,2 user reviews,1,1,2
322600,5,Mixed,13,18,31
322630,5,Mixed,20,30,50
322660,8,Very Positive,110,7,117
322680,6,Mostly Positive,123,40,163
322700,0,1 user reviews,1,0,1
322750,6,Mostly Positive,64,27,91
322770,8,Very Positive,1816,174,1990
322780,5,Mixed,1958,1281,3239
322850,5,Mixed,44,41,85
322900,5,Mixed,66,61,127
322910,6,Mostly Positive,647,268,915
322920,5,Mixed,982,778,1760
322930,6,Mostly Positive,58,17,75
322950,4,Mostly Negative,6,24,30
322960,7,Positive,28,1,29
322970,5,Mixed,20,25,45
322980,5,Mixed,13,19,32
322990,3,Negative,2,16,18
323000,5,Mixed,4,6,10
323020,0,3 user reviews,3,0,3
323040,6,Mostly Positive,36,10,46
323060,6,Mostly Positive,766,295,1061
323130,0,2 user reviews,2,0,2
323140,0,2 user reviews,2,0,2
323170,0,4 user reviews,3,1,4
323180,0,5 user reviews,5,0,5
323190,8,Very Positive,15833,1557,17390
323220,8,Very Positive,1499,169,1668
323230,5,Mixed,9,7,16
323240,5,Mixed,12,10,22
323250,5,Mixed,9,4,13
323260,0,8 user reviews,4,4,8
323270,5,Mixed,8,4,12
323280,6,Mostly Positive,22,9,31
323290,0,1 user reviews,1,0,1
323320,8,Very Positive,2217,159,2376
323340,7,Positive,10,2,12
323341,7,Positive,24,3,27
323370,5,Mixed,94,43,137
323380,8,Very Positive,663,61,724
323390,0,1 user reviews,1,0,1
323410,5,Mixed,14,9,23
323420,0,7 user reviews,7,0,7
323450,8,Very Positive,47,6,53
323460,8,Very Positive,139,20,159
323470,8,Very Positive,5451,866,6317
323490,8,Very Positive,67,12,79
323500,6,Mostly Positive,540,163,703
323510,5,Mixed,6,4,10
323520,0,5 user reviews,5,0,5
323530,0,5 user reviews,4,1,5
323580,8,Very Positive,661,161,822
323620,0,5 user reviews,0,5,5
323630,0,4 user reviews,3,1,4
323670,8,Very Positive,176,38,214
323680,0,2 user reviews,0,2,2
323700,5,Mixed,11,11,22
323720,6,Mostly Positive,214,90,304
323730,0,2 user reviews,2,0,2
323740,0,1 user reviews,1,0,1
323780,5,Mixed,37,31,68
323850,8,Very Positive,2167,360,2527
323870,0,1 user reviews,1,0,1
323871,0,3 user reviews,2,1,3
323910,8,Very Positive,42,9,51
323930,0,1 user reviews,0,1,1
323931,0,2 user reviews,2,0,2
323935,0,6 user reviews,4,2,6
323936,0,1 user reviews,1,0,1
323940,0,3 user reviews,2,1,3
324020,5,Mixed,13,12,25
324030,0,6 user reviews,6,0,6
324060,4,Mostly Negative,8,16,24
324070,8,Very Positive,45,9,54
324080,8,Very Positive,1684,327,2011
324090,4,Mostly Negative,4,9,13
324110,5,Mixed,16,19,35
324120,6,Mostly Positive,119,45,164
324140,8,Very Positive,62,13,75
324160,9,Overwhelmingly Positive,1038,23,1061
324170,5,Mixed,120,59,179
324190,5,Mixed,67,97,164
324240,5,Mixed,6,8,14
324250,5,Mixed,8,4,12
324260,6,Mostly Positive,260,86,346
324270,0,4 user reviews,1,3,4
324280,4,Mostly Negative,7,18,25
324290,0,6 user reviews,2,4,6
324300,0,5 user reviews,5,0,5
324310,5,Mixed,347,245,592
324330,0,6 user reviews,4,2,6
324343,5,Mixed,7,7,14
324344,6,Mostly Positive,103,31,134
324352,0,2 user reviews,1,1,2
324360,0,2 user reviews,1,1,2
324390,0,2 user reviews,2,0,2
324400,0,8 user reviews,5,3,8
324420,5,Mixed,15,8,23
324470,6,Mostly Positive,70,22,92
324510,6,Mostly Positive,881,263,1144
324520,6,Mostly Positive,104,32,136
324570,6,Mostly Positive,349,92,441
324600,0,6 user reviews,4,2,6
324601,0,4 user reviews,4,0,4
324602,0,3 user reviews,1,2,3
324610,3,Negative,3,13,16
324650,6,Mostly Positive,92,27,119
324680,9,Overwhelmingly Positive,671,21,692
324710,8,Very Positive,126,8,134
324720,0,7 user reviews,5,2,7
324730,6,Mostly Positive,14,5,19
324740,6,Mostly Positive,165,44,209
324750,6,Mostly Positive,13,5,18
324760,5,Mixed,58,42,100
324770,5,Mixed,9,10,19
324790,5,Mixed,31,17,48
324800,8,Very Positive,5294,708,6002
324810,8,Very Positive,860,172,1032
324912,0,3 user reviews,3,0,3
324913,0,1 user reviews,1,0,1
325060,8,Very Positive,77,9,86
325070,6,Mostly Positive,29,8,37
325080,6,Mostly Positive,38,10,48
325090,8,Very Positive,123,13,136
325100,5,Mixed,32,22,54
325110,0,7 user reviews,6,1,7
325120,5,Mixed,61,36,97
325135,0,1 user reviews,1,0,1
325138,0,1 user reviews,1,0,1
325139,0,1 user reviews,1,0,1
325140,0,1 user reviews,1,0,1
325141,0,3 user reviews,3,0,3
325142,0,4 user reviews,4,0,4
325143,0,2 user reviews,1,1,2
325144,0,2 user reviews,2,0,2
325150,8,Very Positive,56,4,60
325160,7,Positive,30,1,31
325180,8,Very Positive,85,14,99
325210,5,Mixed,214,94,308
325260,0,2 user reviews,1,1,2
325300,0,5 user reviews,5,0,5
325320,6,Mostly Positive,25,10,35
325340,0,1 user reviews,1,0,1
325370,7,Positive,23,2,25
325420,6,Mostly Positive,468,142,610
325430,4,Mostly Negative,18,38,56
325470,5,Mixed,7,7,14
325500,0,5 user reviews,3,2,5
325501,0,3 user reviews,3,0,3
325502,0,2 user reviews,2,0,2
325503,0,2 user reviews,2,0,2
325504,5,Mixed,18,9,27
325520,8,Very Positive,71,16,87
325570,0,1 user reviews,1,0,1
325580,5,Mixed,14,7,21
325590,0,2 user reviews,2,0,2
325600,5,Mixed,944,699,1643
325610,6,Mostly Positive,6079,2050,8129
325630,5,Mixed,63,72,135
325723,5,Mixed,140,197,337
325724,6,Mostly Positive,712,186,898
325730,5,Mixed,108,50,158
325790,4,Mostly Negative,28,69,97
325860,0,8 user reviews,8,0,8
325870,0,9 user reviews,8,1,9
325880,5,Mixed,9,8,17
325910,7,Positive,27,4,31
325930,8,Very Positive,103,16,119
325950,7,Positive,11,2,13
325951,0,7 user reviews,3,4,7
325952,5,Mixed,6,7,13
325953,0,5 user reviews,2,3,5
325954,7,Positive,40,9,49
325955,0,7 user reviews,3,4,7
325956,7,Positive,11,2,13
325958,0,4 user reviews,0,4,4
325959,5,Mixed,5,7,12
325961,0,9 user reviews,7,2,9
325962,6,Mostly Positive,16,5,21
325963,7,Positive,17,4,21
325964,7,Positive,12,2,14
325965,5,Mixed,8,4,12
325968,7,Positive,14,2,16
325969,7,Positive,23,0,23
325970,6,Mostly Positive,45,17,62
325971,0,9 user reviews,6,3,9
325972,0,5 user reviews,4,1,5
325973,5,Mixed,7,5,12
325974,5,Mixed,30,16,46
325976,7,Positive,37,5,42
325977,6,Mostly Positive,12,5,17
325979,0,5 user reviews,5,0,5
325981,5,Mixed,6,5,11
325987,6,Mostly Positive,10,3,13
325988,5,Mixed,8,11,19
325989,5,Mixed,8,5,13
325990,7,Positive,27,2,29
325991,0,7 user reviews,6,1,7
325992,7,Positive,22,2,24
325993,7,Positive,22,3,25
325994,0,2 user reviews,1,1,2
326005,0,3 user reviews,1,2,3
326010,0,2 user reviews,2,0,2
326011,0,3 user reviews,3,0,3
326015,0,2 user reviews,2,0,2
326016,0,1 user reviews,0,1,1
326017,0,3 user reviews,3,0,3
326018,0,1 user reviews,1,0,1
326023,0,2 user reviews,2,0,2
326024,0,5 user reviews,3,2,5
326026,0,1 user reviews,1,0,1
326031,0,1 user reviews,1,0,1
326033,0,2 user reviews,2,0,2
326034,0,1 user reviews,1,0,1
326036,0,3 user reviews,3,0,3
326037,0,3 user reviews,3,0,3
326040,0,1 user reviews,0,1,1
326043,0,2 user reviews,2,0,2
326047,0,3 user reviews,3,0,3
326050,0,2 user reviews,1,1,2
326060,6,Mostly Positive,22,8,30
326110,4,Mostly Negative,3,7,10
326120,7,Positive,9,1,10
326130,0,3 user reviews,1,2,3
326150,8,Very Positive,301,27,328
326160,5,Mixed,327,336,663
326180,5,Mixed,290,156,446
326190,6,Mostly Positive,212,80,292
326210,0,3 user reviews,2,1,3
326220,0,2 user reviews,1,1,2
326230,4,Mostly Negative,4,7,11
326270,0,1 user reviews,1,0,1
326290,0,1 user reviews,1,0,1
326300,0,2 user reviews,2,0,2
326310,0,2 user reviews,1,1,2
326340,6,Mostly Positive,63,27,90
326370,0,4 user reviews,4,0,4
326380,5,Mixed,16,7,23
326390,0,4 user reviews,4,0,4
326391,0,7 user reviews,6,1,7
326410,8,Very Positive,1343,324,1667
326420,4,Mostly Negative,5,13,18
326430,7,Positive,11,1,12
326431,7,Positive,13,3,16
326460,8,Very Positive,10477,825,11302
326470,0,7 user reviews,3,4,7
326480,8,Very Positive,1664,153,1817
326520,6,Mostly Positive,21,9,30
326530,0,7 user reviews,5,2,7
326590,6,Mostly Positive,38,11,49
326600,0,6 user reviews,6,0,6
326610,0,5 user reviews,5,0,5
326620,7,Positive,21,0,21
326621,5,Mixed,21,10,31
326630,4,Mostly Negative,6,12,18
326650,3,Negative,0,20,20
326670,6,Mostly Positive,318,131,449
326720,8,Very Positive,93,13,106
326730,5,Mixed,16,14,30
326760,7,Positive,13,0,13
326770,0,1 user reviews,0,1,1
326810,0,3 user reviews,3,0,3
326840,8,Very Positive,198,43,241
326950,6,Mostly Positive,70,22,92
326990,0,2 user reviews,1,1,2
327000,0,5 user reviews,1,4,5
327010,5,Mixed,18,21,39
327030,6,Mostly Positive,1170,324,1494
327040,0,2 user reviews,1,1,2
327060,6,Mostly Positive,146,56,202
327070,6,Mostly Positive,1375,580,1955
327090,5,Mixed,548,443,991
327100,0,1 user reviews,0,1,1
327130,5,Mixed,43,41,84
327140,8,Very Positive,317,19,336
327150,6,Mostly Positive,21,9,30
327170,0,7 user reviews,6,1,7
327171,0,5 user reviews,5,0,5
327172,0,7 user reviews,4,3,7
327173,6,Mostly Positive,12,4,16
327175,7,Positive,25,6,31
327210,7,Positive,14,1,15
327220,8,Very Positive,337,49,386
327231,5,Mixed,5,5,10
327232,0,3 user reviews,2,1,3
327260,6,Mostly Positive,93,34,127
327270,0,1 user reviews,1,0,1
327280,5,Mixed,169,146,315
327310,8,Very Positive,79,16,95
327340,8,Very Positive,57,1,58
327370,6,Mostly Positive,21,7,28
327380,5,Mixed,17,17,34
327390,8,Very Positive,62,6,68
327400,8,Very Positive,268,17,285
327410,8,Very Positive,1811,334,2145
327440,6,Mostly Positive,97,26,123
327450,7,Positive,25,1,26
327490,4,Mostly Negative,8,22,30
327500,7,Positive,38,6,44
327510,6,Mostly Positive,389,104,493
327520,5,Mixed,31,17,48
327530,0,8 user reviews,8,0,8
327560,8,Very Positive,455,41,496
327610,0,3 user reviews,3,0,3
327640,0,5 user reviews,2,3,5
327650,0,6 user reviews,3,3,6
327670,6,Mostly Positive,402,120,522
327690,7,Positive,10,0,10
327740,8,Very Positive,265,32,297
327760,6,Mostly Positive,11,3,14
327830,6,Mostly Positive,74,27,101
327831,5,Mixed,6,4,10
327840,0,2 user reviews,2,0,2
327860,6,Mostly Positive,1027,293,1320
327870,0,2 user reviews,2,0,2
327880,8,Very Positive,308,48,356
327890,6,Mostly Positive,2262,685,2947
327910,5,Mixed,17,9,26
327920,5,Mixed,7,9,16
327930,8,Very Positive,108,11,119
327940,6,Mostly Positive,10,3,13
327950,8,Very Positive,93,5,98
327960,0,9 user reviews,1,8,9
327980,7,Positive,20,2,22
328000,5,Mixed,8,8,16
328020,0,2 user reviews,0,2,2
328060,0,7 user reviews,4,3,7
328070,8,Very Positive,943,150,1093
328080,8,Very Positive,3336,358,3694
328100,5,Mixed,9,13,22
328110,0,3 user reviews,3,0,3
328130,0,1 user reviews,0,1,1
328140,5,Mixed,62,70,132
328200,0,1 user reviews,1,0,1
328210,7,Positive,11,0,11
328220,4,Mostly Negative,43,112,155
328230,7,Positive,18,0,18
328260,0,1 user reviews,0,1,1
328270,5,Mixed,72,39,111
328280,0,1 user reviews,1,0,1
328290,0,1 user reviews,1,0,1
328310,4,Mostly Negative,6,13,19
328402,0,1 user reviews,1,0,1
328430,5,Mixed,7,5,12
328440,4,Mostly Negative,14,33,47
328450,6,Mostly Positive,20,8,28
328460,5,Mixed,22,16,38
328470,8,Very Positive,76,8,84
328500,8,Very Positive,121,24,145
328510,5,Mixed,29,13,42
328550,7,Positive,22,4,26
328590,6,Mostly Positive,99,36,135
328600,5,Mixed,36,26,62
328640,5,Mixed,5,6,11
328650,0,6 user reviews,4,2,6
328670,4,Mostly Negative,3,9,12
328680,0,8 user reviews,6,2,8
328710,5,Mixed,23,20,43
328730,8,Very Positive,135,5,140
328740,4,Mostly Negative,5,10,15
328760,8,Very Positive,699,51,750
328780,7,Positive,15,3,18
328802,7,Positive,10,0,10
328803,0,1 user reviews,1,0,1
328804,0,2 user reviews,2,0,2
328810,0,2 user reviews,0,2,2
328814,0,3 user reviews,3,0,3
328818,0,1 user reviews,0,1,1
328820,0,1 user reviews,1,0,1
328821,0,2 user reviews,1,1,2
328830,5,Mixed,26,30,56
328850,0,6 user reviews,6,0,6
328880,5,Mixed,5,5,10
328890,0,9 user reviews,4,5,9
328900,7,Positive,39,8,47
328920,8,Very Positive,46,9,55
328930,7,Positive,17,3,20
328940,5,Mixed,95,77,172
328990,0,4 user reviews,0,4,4
329000,4,Mostly Negative,5,10,15
329010,6,Mostly Positive,109,37,146
329011,5,Mixed,6,4,10
329012,5,Mixed,15,7,22
329013,0,5 user reviews,1,4,5
329020,0,1 user reviews,1,0,1
329040,6,Mostly Positive,36,13,49
329050,8,Very Positive,1744,211,1955
329070,6,Mostly Positive,311,79,390
329100,0,8 user reviews,7,1,8
329110,7,Positive,32,8,40
329130,8,Very Positive,1700,112,1812
329150,0,8 user reviews,7,1,8
329180,0,1 user reviews,1,0,1
329190,5,Mixed,64,39,103
329200,5,Mixed,71,40,111
329240,5,Mixed,9,6,15
329270,0,7 user reviews,5,2,7
329280,5,Mixed,6,9,15
329310,6,Mostly Positive,24,8,32
329320,7,Positive,18,3,21
329340,0,7 user reviews,7,0,7
329380,5,Mixed,20,12,32
329430,6,Mostly Positive,2229,776,3005
329440,5,Mixed,529,341,870
329460,8,Very Positive,141,7,148
329480,0,2 user reviews,0,2,2
329490,8,Very Positive,713,155,868
329510,0,1 user reviews,1,0,1
329530,8,Very Positive,82,4,86
329550,0,3 user reviews,3,0,3
329551,0,3 user reviews,3,0,3
329610,5,Mixed,54,73,127
329620,5,Mixed,10,6,16
329630,7,Positive,30,1,31
329640,7,Positive,25,5,30
329650,6,Mostly Positive,90,26,116
329670,5,Mixed,14,8,22
329680,5,Mixed,9,6,15
329690,7,Positive,37,9,46
329770,5,Mixed,34,24,58
329790,0,2 user reviews,2,0,2
329820,0,5 user reviews,4,1,5
329821,0,3 user reviews,2,1,3
329822,0,4 user reviews,4,0,4
329830,6,Mostly Positive,416,126,542
329860,8,Very Positive,583,80,663
329880,0,4 user reviews,4,0,4
329910,0,4 user reviews,4,0,4
329920,8,Very Positive,64,4,68
329970,8,Very Positive,420,58,478
329980,5,Mixed,13,9,22
329991,0,1 user reviews,1,0,1
330000,0,3 user reviews,0,3,3
330020,8,Very Positive,2646,201,2847
330070,6,Mostly Positive,509,197,706
330100,6,Mostly Positive,101,31,132
330130,0,7 user reviews,3,4,7
330160,7,Positive,10,0,10
330180,8,Very Positive,67,11,78
330210,2,Very Negative,10,47,57
330230,0,2 user reviews,1,1,2
330240,0,3 user reviews,0,3,3
330260,7,Positive,19,2,21
330270,5,Mixed,61,57,118
330350,4,Mostly Negative,64,224,288
330370,7,Positive,24,3,27
330390,8,Very Positive,822,108,930
330420,7,Positive,31,5,36
330450,0,2 user reviews,2,0,2
330460,6,Mostly Positive,196,62,258
330470,5,Mixed,48,28,76
330500,0,8 user reviews,6,2,8
330510,0,1 user reviews,0,1,1
330520,0,1 user reviews,0,1,1
330570,5,Mixed,120,106,226
330580,8,Very Positive,497,116,613
330590,0,7 user reviews,4,3,7
330620,6,Mostly Positive,73,24,97
330631,0,4 user reviews,2,2,4
330650,7,Positive,9,1,10
330660,7,Positive,8,2,10
330670,0,7 user reviews,6,1,7
330680,0,5 user reviews,0,5,5
330720,8,Very Positive,88,12,100
330730,7,Positive,19,0,19
330750,5,Mixed,5,5,10
330760,0,2 user reviews,1,1,2
330770,6,Mostly Positive,72,22,94
330810,0,1 user reviews,1,0,1
330820,8,Very Positive,359,61,420
330830,8,Very Positive,7735,430,8165
330840,6,Mostly Positive,3829,1489,5318
330880,0,8 user reviews,3,5,8
330990,5,Mixed,43,26,69
331000,0,1 user reviews,0,1,1
331050,4,Mostly Negative,3,8,11
331060,5,Mixed,5,5,10
331061,5,Mixed,9,4,13
331062,0,2 user reviews,2,0,2
331063,0,2 user reviews,1,1,2
331064,0,5 user reviews,2,3,5
331065,5,Mixed,10,5,15
331066,0,2 user reviews,0,2,2
331067,0,3 user reviews,1,2,3
331068,0,5 user reviews,4,1,5
331069,7,Positive,8,2,10
331070,0,6 user reviews,1,5,6
331071,0,5 user reviews,1,4,5
331072,4,Mostly Negative,4,9,13
331120,0,6 user reviews,3,3,6
331130,0,5 user reviews,5,0,5
331160,6,Mostly Positive,162,54,216
331180,5,Mixed,18,8,26
331181,7,Positive,24,3,27
331190,8,Very Positive,118,28,146
331200,5,Mixed,231,118,349
331210,5,Mixed,5,7,12
331220,6,Mostly Positive,56,23,79
331290,0,7 user reviews,5,2,7
331300,0,3 user reviews,1,2,3
331310,0,2 user reviews,2,0,2
331330,5,Mixed,14,9,23
331340,5,Mixed,23,10,33
331352,0,2 user reviews,2,0,2
331353,0,1 user reviews,1,0,1
331354,0,3 user reviews,3,0,3
331355,0,2 user reviews,2,0,2
331358,0,1 user reviews,1,0,1
331360,6,Mostly Positive,143,40,183
331390,6,Mostly Positive,69,18,87
331400,0,4 user reviews,1,3,4
331440,6,Mostly Positive,544,152,696
331450,5,Mixed,19,10,29
331460,7,Positive,22,4,26
331470,8,Very Positive,47,6,53
331480,8,Very Positive,492,57,549
331490,0,3 user reviews,3,0,3
331491,0,5 user reviews,1,4,5
331492,0,9 user reviews,3,6,9
331500,8,Very Positive,903,149,1052
331510,6,Mostly Positive,46,18,64
331520,0,1 user reviews,1,0,1
331570,0,1 user reviews,1,0,1
331580,0,7 user reviews,4,3,7
331600,6,Mostly Positive,1464,388,1852
331610,4,Mostly Negative,8,25,33
331620,0,2 user reviews,2,0,2
331650,5,Mixed,50,22,72
331660,0,7 user reviews,3,4,7
331670,8,Very Positive,896,76,972
331690,6,Mostly Positive,248,91,339
331720,5,Mixed,24,14,38
331740,0,3 user reviews,2,1,3
331750,8,Very Positive,112,6,118
331760,6,Mostly Positive,11,4,15
331790,5,Mixed,23,13,36
331800,0,4 user reviews,4,0,4
331810,4,Mostly Negative,12,37,49
331870,8,Very Positive,780,96,876
331880,5,Mixed,18,26,44
331890,0,1 user reviews,0,1,1
331900,6,Mostly Positive,296,100,396
331920,6,Mostly Positive,107,45,152
331930,8,Very Positive,74,15,89
331970,8,Very Positive,88,3,91
331980,5,Mixed,16,12,28
332070,5,Mixed,11,13,24
332120,0,1 user reviews,1,0,1
332130,0,1 user reviews,1,0,1
332150,0,2 user reviews,0,2,2
332200,8,Very Positive,2482,184,2666
332240,0,3 user reviews,3,0,3
332250,5,Mixed,50,24,74
332260,7,Positive,40,5,45
332270,6,Mostly Positive,21,7,28
332290,0,3 user reviews,3,0,3
332291,0,2 user reviews,2,0,2
332292,0,3 user reviews,2,1,3
332293,0,4 user reviews,3,1,4
332310,6,Mostly Positive,5022,1669,6691
332330,8,Very Positive,57,10,67
332340,0,2 user reviews,1,1,2
332350,6,Mostly Positive,271,99,370
332360,6,Mostly Positive,65,22,87
332370,0,4 user reviews,3,1,4
332380,5,Mixed,17,9,26
332390,6,Mostly Positive,54,17,71
332400,5,Mixed,34,15,49
332410,5,Mixed,24,14,38
332460,0,2 user reviews,2,0,2
332480,6,Mostly Positive,84,23,107
332490,6,Mostly Positive,150,47,197
332500,5,Mixed,1319,1293,2612
332530,7,Positive,25,3,28
332540,7,Positive,31,3,34
332570,8,Very Positive,2315,240,2555
332580,8,Very Positive,52,9,61
332610,8,Very Positive,84,13,97
332620,5,Mixed,40,19,59
332630,7,Positive,18,2,20
332650,5,Mixed,48,44,92
332700,4,Mostly Negative,5,11,16
332710,5,Mixed,8,7,15
332730,0,4 user reviews,0,4,4
332740,0,3 user reviews,3,0,3
332760,0,6 user reviews,5,1,6
332790,5,Mixed,53,79,132
332800,8,Very Positive,5893,574,6467
332810,0,5 user reviews,4,1,5
332830,7,Positive,44,4,48
332880,7,Positive,16,4,20
332950,8,Very Positive,63,3,66
333030,0,2 user reviews,1,1,2
333040,0,3 user reviews,2,1,3
333060,0,3 user reviews,3,0,3
333080,0,8 user reviews,2,6,8
333081,0,5 user reviews,2,3,5
333084,0,4 user reviews,2,2,4
333087,0,1 user reviews,0,1,1
333088,0,1 user reviews,0,1,1
333090,0,7 user reviews,5,2,7
333091,6,Mostly Positive,8,3,11
333100,4,Mostly Negative,6,10,16
333110,7,Positive,40,2,42
333120,5,Mixed,7,6,13
333130,0,4 user reviews,3,1,4
333150,0,6 user reviews,5,1,6
333160,7,Positive,16,0,16
333170,0,6 user reviews,6,0,6
333210,5,Mixed,83,54,137
333220,8,Very Positive,52,8,60
333230,0,1 user reviews,1,0,1
333250,6,Mostly Positive,359,112,471
333260,8,Very Positive,61,0,61
333290,7,Positive,10,0,10
333300,8,Very Positive,574,76,650
333320,0,2 user reviews,2,0,2
333330,7,Positive,38,7,45
333340,4,Mostly Negative,31,59,90
333350,5,Mixed,25,17,42
333380,0,8 user reviews,4,4,8
333390,6,Mostly Positive,31,10,41
333400,0,4 user reviews,4,0,4
333420,6,Mostly Positive,1428,461,1889
333430,5,Mixed,43,21,64
333460,0,3 user reviews,3,0,3
333490,0,4 user reviews,3,1,4
333510,7,Positive,16,3,19
333530,5,Mixed,19,11,30
333540,5,Mixed,8,6,14
333580,0,5 user reviews,5,0,5
333600,8,Very Positive,5567,296,5863
333640,9,Overwhelmingly Positive,2362,106,2468
333650,7,Positive,10,1,11
333660,5,Mixed,27,17,44
333690,0,8 user reviews,4,4,8
333710,0,1 user reviews,1,0,1
333730,0,6 user reviews,3,3,6
333740,5,Mixed,36,50,86
333760,7,Positive,22,5,27
333770,0,4 user reviews,4,0,4
333771,0,1 user reviews,1,0,1
333772,0,2 user reviews,2,0,2
333773,0,3 user reviews,3,0,3
333800,4,Mostly Negative,10,38,48
333810,0,9 user reviews,5,4,9
333811,0,2 user reviews,2,0,2
333812,0,5 user reviews,4,1,5
333813,0,1 user reviews,1,0,1
333816,0,2 user reviews,2,0,2
333817,0,2 user reviews,2,0,2
333820,8,Very Positive,290,19,309
333850,0,2 user reviews,0,2,2
333860,4,Mostly Negative,4,8,12
333870,7,Positive,37,8,45
333880,8,Very Positive,84,21,105
333891,0,2 user reviews,2,0,2
333910,0,1 user reviews,1,0,1
333921,0,3 user reviews,2,1,3
333930,8,Very Positive,729,167,896
333950,5,Mixed,1883,1500,3383
333970,6,Mostly Positive,40,12,52
333980,8,Very Positive,1138,151,1289
333990,6,Mostly Positive,36,11,47
334030,0,1 user reviews,1,0,1
334040,4,Mostly Negative,312,535,847
334050,0,6 user reviews,4,2,6
334070,5,Mixed,105,57,162
334080,7,Positive,47,0,47
334100,7,Positive,14,2,16
334120,5,Mixed,257,182,439
334140,8,Very Positive,48,2,50
334161,0,1 user reviews,1,0,1
334180,0,2 user reviews,1,1,2
334190,6,Mostly Positive,97,27,124
334210,6,Mostly Positive,95,27,122
334220,0,1 user reviews,1,0,1
334230,8,Very Positive,16407,2065,18472
334260,0,2 user reviews,2,0,2
334270,5,Mixed,19,15,34
334280,0,8 user reviews,3,5,8
334290,5,Mixed,30,29,59
334300,7,Positive,15,2,17
334310,8,Very Positive,191,33,224
334340,5,Mixed,9,8,17
334360,0,1 user reviews,0,1,1
334370,0,3 user reviews,1,2,3
334380,0,2 user reviews,2,0,2
334390,0,4 user reviews,4,0,4
334402,0,6 user reviews,5,1,6
334410,5,Mixed,21,10,31
334420,5,Mixed,303,160,463
334440,0,3 user reviews,2,1,3
334441,0,4 user reviews,4,0,4
334442,0,1 user reviews,0,1,1
334450,0,8 user reviews,8,0,8
334470,0,3 user reviews,1,2,3
334480,0,1 user reviews,1,0,1
334490,0,2 user reviews,1,1,2
334510,0,1 user reviews,0,1,1
334520,0,1 user reviews,1,0,1
334530,0,3 user reviews,2,1,3
334540,8,Very Positive,522,42,564
334560,7,Positive,39,8,47
334620,0,7 user reviews,3,4,7
334660,0,3 user reviews,3,0,3
334690,6,Mostly Positive,49,18,67
334710,6,Mostly Positive,37,13,50
334740,0,5 user reviews,5,0,5
334770,7,Positive,24,2,26
334771,7,Positive,10,1,11
334772,7,Positive,44,5,49
334773,7,Positive,27,0,27
334774,7,Positive,32,0,32
334780,7,Positive,31,0,31
334781,7,Positive,24,3,27
334782,7,Positive,19,1,20
334790,7,Positive,31,3,34
334791,7,Positive,16,2,18
334792,5,Mixed,4,6,10
334793,7,Positive,26,4,30
334810,7,Positive,10,2,12
334830,5,Mixed,12,10,22
334840,0,6 user reviews,6,0,6
334850,5,Mixed,65,30,95
334920,0,1 user reviews,1,0,1
334930,0,5 user reviews,0,5,5
334940,9,Overwhelmingly Positive,635,17,652
334960,0,8 user reviews,5,3,8
334970,0,4 user reviews,3,1,4
334980,5,Mixed,16,21,37
335000,8,Very Positive,1019,80,1099
335010,6,Mostly Positive,17,6,23
335020,5,Mixed,72,53,125
335030,4,Mostly Negative,132,289,421
335050,2,Very Negative,11,68,79
335060,0,6 user reviews,4,2,6
335070,6,Mostly Positive,191,51,242
335090,7,Positive,13,0,13
335100,6,Mostly Positive,77,27,104
335110,0,1 user reviews,1,0,1
335120,5,Mixed,67,39,106
335170,0,2 user reviews,2,0,2
335180,6,Mostly Positive,10,4,14
335190,8,Very Positive,153,24,177
335200,5,Mixed,19,13,32
335210,3,Negative,1,10,11
335220,0,4 user reviews,2,2,4
335240,8,Very Positive,80,13,93
335260,0,8 user reviews,8,0,8
335290,6,Mostly Positive,14,6,20
335300,8,Very Positive,11999,2246,14245
335310,0,3 user reviews,1,2,3
335320,5,Mixed,29,16,45
335330,4,Mostly Negative,5,15,20
335350,7,Positive,32,5,37
335370,5,Mixed,9,5,14
335420,0,2 user reviews,2,0,2
335430,8,Very Positive,48,9,57
335440,0,1 user reviews,0,1,1
335450,0,6 user reviews,5,1,6
335460,7,Positive,13,0,13
335475,0,1 user reviews,1,0,1
335476,0,1 user reviews,1,0,1
335477,0,1 user reviews,1,0,1
335478,0,1 user reviews,1,0,1
335510,7,Positive,33,4,37
335550,0,6 user reviews,6,0,6
335560,0,1 user reviews,1,0,1
335570,0,4 user reviews,2,2,4
335580,0,1 user reviews,1,0,1
335620,8,Very Positive,1778,239,2017
335640,0,2 user reviews,2,0,2
335660,5,Mixed,26,13,39
335670,9,Overwhelmingly Positive,6688,271,6959
335690,5,Mixed,7,6,13
335700,5,Mixed,26,20,46
335770,5,Mixed,9,4,13
335790,6,Mostly Positive,223,56,279
335800,0,1 user reviews,1,0,1
335820,0,2 user reviews,2,0,2
335830,5,Mixed,116,74,190
335840,7,Positive,32,2,34
335850,3,Negative,2,17,19
335890,0,1 user reviews,1,0,1
335900,0,5 user reviews,3,2,5
335920,8,Very Positive,90,10,100
335930,5,Mixed,9,11,20
335940,4,Mostly Negative,3,8,11
335950,0,3 user reviews,2,1,3
335981,0,3 user reviews,0,3,3
336010,6,Mostly Positive,26,11,37
336020,0,5 user reviews,2,3,5
336030,5,Mixed,9,4,13
336040,0,1 user reviews,1,0,1
336060,6,Mostly Positive,164,42,206
336070,0,1 user reviews,1,0,1
336080,6,Mostly Positive,182,47,229
336090,6,Mostly Positive,19,5,24
336100,5,Mixed,38,18,56
336110,6,Mostly Positive,18,7,25
336130,8,Very Positive,272,29,301
336140,9,Overwhelmingly Positive,830,34,864
336150,6,Mostly Positive,167,43,210
336160,0,2 user reviews,1,1,2
336170,7,Positive,10,0,10
336200,0,7 user reviews,4,3,7
336210,3,Negative,2,11,13
336220,5,Mixed,18,8,26
336230,0,8 user reviews,7,1,8
336240,8,Very Positive,177,32,209
336250,4,Mostly Negative,13,21,34
336270,0,7 user reviews,6,1,7
336300,8,Very Positive,149,30,179
336310,7,Positive,41,6,47
336320,0,1 user reviews,1,0,1
336370,8,Very Positive,77,3,80
336380,5,Mixed,17,14,31
336420,8,Very Positive,69,12,81
336440,7,Positive,33,5,38
336520,0,2 user reviews,1,1,2
336530,5,Mixed,10,7,17
336610,8,Very Positive,189,19,208
336630,5,Mixed,6,6,12
336660,0,1 user reviews,1,0,1
336670,0,2 user reviews,1,1,2
336680,7,Positive,8,2,10
336700,7,Positive,13,2,15
336710,0,3 user reviews,3,0,3
336730,0,6 user reviews,3,3,6
336760,0,7 user reviews,7,0,7
336770,0,3 user reviews,3,0,3
336780,0,1 user reviews,0,1,1
336790,5,Mixed,37,21,58
336840,0,8 user reviews,8,0,8
336850,0,1 user reviews,1,0,1
336851,0,4 user reviews,2,2,4
336900,0,1 user reviews,0,1,1
336930,5,Mixed,5,5,10
336940,8,Very Positive,103,17,120
337000,6,Mostly Positive,7925,3380,11305
337040,5,Mixed,69,31,100
337070,5,Mixed,139,94,233
337100,0,1 user reviews,0,1,1
337103,0,1 user reviews,1,0,1
337104,0,2 user reviews,1,1,2
337110,5,Mixed,5,5,10
337130,0,6 user reviews,5,1,6
337150,8,Very Positive,685,53,738
337180,6,Mostly Positive,26,11,37
337210,5,Mixed,19,26,45
337220,5,Mixed,25,26,51
337270,8,Very Positive,99,18,117
337280,6,Mostly Positive,27,10,37
337290,8,Very Positive,51,8,59
337320,8,Very Positive,4952,317,5269
337340,9,Overwhelmingly Positive,3051,54,3105
337350,8,Very Positive,165,9,174
337360,5,Mixed,40,31,71
337400,0,3 user reviews,3,0,3
337420,5,Mixed,31,23,54
337450,7,Positive,12,2,14
337460,0,4 user reviews,3,1,4
337480,6,Mostly Positive,41,15,56
337490,6,Mostly Positive,104,32,136
337570,0,1 user reviews,1,0,1
337630,7,Positive,16,3,19
337650,7,Positive,18,2,20
337660,5,Mixed,141,174,315
337661,6,Mostly Positive,298,91,389
337670,7,Positive,22,1,23
337680,8,Very Positive,73,18,91
337700,5,Mixed,7,8,15
337720,8,Very Positive,120,3,123
337730,0,4 user reviews,2,2,4
337740,0,1 user reviews,0,1,1
337760,7,Positive,38,5,43
337820,5,Mixed,50,31,81
337840,7,Positive,33,3,36
337850,8,Very Positive,100,8,108
337880,4,Mostly Negative,19,49,68
337890,6,Mostly Positive,20,6,26
337900,0,2 user reviews,0,2,2
337901,0,1 user reviews,1,0,1
337902,0,6 user reviews,5,1,6
337930,8,Very Positive,367,27,394
337940,6,Mostly Positive,13,4,17
337950,3,Negative,7,35,42
337960,6,Mostly Positive,41,11,52
337970,0,8 user reviews,4,4,8
337980,5,Mixed,15,20,35
338000,0,3 user reviews,3,0,3
338030,0,1 user reviews,0,1,1
338040,5,Mixed,20,17,37
338050,5,Mixed,7,9,16
338060,6,Mostly Positive,90,30,120
338070,0,2 user reviews,2,0,2
338110,7,Positive,9,1,10
338120,5,Mixed,22,24,46
338130,5,Mixed,52,26,78
338140,6,Mostly Positive,123,46,169
338160,6,Mostly Positive,163,55,218
338161,5,Mixed,15,9,24
338162,7,Positive,21,3,24
338163,5,Mixed,179,169,348
338170,8,Very Positive,1276,148,1424
338180,6,Mostly Positive,7,3,10
338190,8,Very Positive,95,12,107
338201,0,1 user reviews,1,0,1
338202,0,3 user reviews,3,0,3
338250,7,Positive,29,2,31
338260,5,Mixed,6,4,10
338290,0,6 user reviews,4,2,6
338300,0,8 user reviews,5,3,8
338310,7,Positive,31,4,35
338320,6,Mostly Positive,111,41,152
338330,5,Mixed,12,9,21
338350,5,Mixed,4,6,10
338360,7,Positive,36,0,36
338370,0,2 user reviews,2,0,2
338371,0,1 user reviews,1,0,1
338372,0,2 user reviews,1,1,2
338390,5,Mixed,817,361,1178
338400,5,Mixed,75,48,123
338420,6,Mostly Positive,17,7,24
338470,5,Mixed,27,14,41
338520,0,1 user reviews,1,0,1
338525,0,1 user reviews,1,0,1
338530,5,Mixed,44,32,76
338540,0,3 user reviews,0,3,3
338550,7,Positive,13,2,15
338590,5,Mixed,17,12,29
338600,0,2 user reviews,2,0,2
338620,2,Very Negative,20,86,106
338630,6,Mostly Positive,14,4,18
338640,5,Mixed,14,8,22
338650,0,3 user reviews,0,3,3
338661,0,3 user reviews,0,3,3
338700,0,1 user reviews,1,0,1
338710,5,Mixed,18,23,41
338720,7,Positive,32,3,35
338721,0,8 user reviews,4,4,8
338722,0,2 user reviews,1,1,2
338723,0,4 user reviews,2,2,4
338743,0,7 user reviews,5,2,7
338744,0,6 user reviews,6,0,6
338745,0,6 user reviews,4,2,6
338746,0,2 user reviews,2,0,2
338760,7,Positive,47,2,49
338770,0,9 user reviews,9,0,9
338800,8,Very Positive,97,23,120
338830,5,Mixed,12,12,24
338882,5,Mixed,4,6,10
338890,6,Mostly Positive,12,4,16
338960,7,Positive,33,1,34
338980,6,Mostly Positive,55,16,71
339000,5,Mixed,6,8,14
339030,5,Mixed,13,11,24
339031,0,1 user reviews,0,1,1
339032,0,1 user reviews,0,1,1
339033,0,9 user reviews,5,4,9
339034,0,9 user reviews,3,6,9
339040,8,Very Positive,88,14,102
339070,0,6 user reviews,6,0,6
339080,0,2 user reviews,2,0,2
339090,7,Positive,18,0,18
339110,0,3 user reviews,0,3,3
339120,0,3 user reviews,3,0,3
339130,8,Very Positive,134,17,151
339160,7,Positive,15,2,17
339190,6,Mostly Positive,175,60,235
339200,8,Very Positive,403,92,495
339210,5,Mixed,44,41,85
339230,5,Mixed,528,324,852
339240,3,Negative,2,9,11
339250,5,Mixed,8,5,13
339280,6,Mostly Positive,19,8,27
339290,0,9 user reviews,1,8,9
339320,6,Mostly Positive,13,4,17
339330,7,Positive,24,1,25
339340,8,Very Positive,931,217,1148
339350,9,Overwhelmingly Positive,1515,50,1565
339360,0,1 user reviews,1,0,1
339381,0,2 user reviews,2,0,2
339382,0,1 user reviews,1,0,1
339383,0,1 user reviews,1,0,1
339384,0,1 user reviews,1,0,1
339386,0,1 user reviews,1,0,1
339387,0,1 user reviews,1,0,1
339388,0,1 user reviews,1,0,1
339390,0,4 user reviews,4,0,4
339391,0,2 user reviews,2,0,2
339392,0,2 user reviews,2,0,2
339395,0,2 user reviews,2,0,2
339400,6,Mostly Positive,71,26,97
339430,0,5 user reviews,4,1,5
339440,8,Very Positive,133,19,152
339460,7,Positive,17,3,20
339470,4,Mostly Negative,16,45,61
339480,5,Mixed,99,110,209
339500,0,3 user reviews,0,3,3
339510,8,Very Positive,93,22,115
339530,0,9 user reviews,3,6,9
339540,4,Mostly Negative,7,11,18
339550,7,Positive,40,0,40
339570,8,Very Positive,91,18,109
339580,6,Mostly Positive,444,138,582
339590,5,Mixed,6,6,12
339600,5,Mixed,22,23,45
339610,5,Mixed,55,30,85
339620,0,1 user reviews,1,0,1
339640,5,Mixed,35,31,66
339690,0,4 user reviews,4,0,4
339700,5,Mixed,16,17,33
339710,0,3 user reviews,1,2,3
339720,0,7 user reviews,6,1,7
339750,0,1 user reviews,1,0,1
339760,0,1 user reviews,1,0,1
339770,0,2 user reviews,2,0,2
339790,8,Very Positive,172,15,187
339800,9,Overwhelmingly Positive,14182,515,14697
339820,0,3 user reviews,0,3,3
339830,5,Mixed,26,17,43
339840,5,Mixed,9,11,20
339850,6,Mostly Positive,16,6,22
339860,0,8 user reviews,0,8,8
339900,4,Mostly Negative,8,25,33
339910,8,Very Positive,114,27,141
340000,8,Very Positive,329,39,368
340030,3,Negative,0,11,11
340050,8,Very Positive,973,216,1189
340070,5,Mixed,111,164,275
340080,7,Positive,32,1,33
340090,0,5 user reviews,5,0,5
340120,6,Mostly Positive,27,8,35
340130,0,7 user reviews,6,1,7
340140,0,2 user reviews,0,2,2
340150,6,Mostly Positive,813,239,1052
340170,5,Mixed,769,489,1258
340190,0,1 user reviews,1,0,1
340200,4,Mostly Negative,5,10,15
340210,5,Mixed,24,18,42
340220,4,Mostly Negative,8,19,27
340230,0,1 user reviews,1,0,1
340231,0,2 user reviews,1,1,2
340233,0,1 user reviews,1,0,1
340250,0,5 user reviews,5,0,5
340260,0,9 user reviews,7,2,9
340270,6,Mostly Positive,128,34,162
340280,8,Very Positive,99,14,113
340290,5,Mixed,16,7,23
340300,8,Very Positive,181,26,207
340310,6,Mostly Positive,114,35,149
340320,8,Very Positive,72,15,87
340330,0,4 user reviews,3,1,4
340340,6,Mostly Positive,194,49,243
340350,0,3 user reviews,2,1,3
340360,8,Very Positive,129,28,157
340370,7,Positive,13,1,14
340380,7,Positive,8,2,10
340400,0,4 user reviews,4,0,4
340410,0,2 user reviews,0,2,2
340440,6,Mostly Positive,18,7,25
340450,6,Mostly Positive,18,6,24
340460,0,1 user reviews,0,1,1
340470,6,Mostly Positive,40,13,53
340480,6,Mostly Positive,9,3,12
340490,8,Very Positive,296,70,366
340500,7,Positive,12,2,14
340520,8,Very Positive,258,26,284
340530,3,Negative,2,9,11
340540,0,1 user reviews,0,1,1
340550,5,Mixed,9,9,18
340560,0,4 user reviews,2,2,4
340570,0,5 user reviews,3,2,5
340580,8,Very Positive,108,12,120
340600,7,Positive,17,1,18
340610,5,Mixed,8,6,14
340620,0,3 user reviews,1,2,3
340630,4,Mostly Negative,8,14,22
340640,0,5 user reviews,2,3,5
340650,5,Mixed,14,11,25
340680,0,1 user reviews,1,0,1
340700,0,3 user reviews,2,1,3
340720,7,Positive,11,2,13
340730,8,Very Positive,494,94,588
340750,0,8 user reviews,4,4,8
340770,6,Mostly Positive,81,21,102
340800,8,Very Positive,86,6,92
340810,0,7 user reviews,5,2,7
340830,6,Mostly Positive,116,35,151
340840,5,Mixed,9,4,13
340860,8,Very Positive,50,10,60
340880,7,Positive,15,1,16
340920,0,4 user reviews,2,2,4
340950,5,Mixed,9,4,13
340960,5,Mixed,18,8,26
340990,6,Mostly Positive,10,4,14
341000,8,Very Positive,1094,148,1242
341020,5,Mixed,79,39,118
341030,5,Mixed,66,48,114
341040,8,Very Positive,50,11,61
341060,5,Mixed,17,20,37
341070,0,9 user reviews,6,3,9
341080,0,5 user reviews,3,2,5
341090,8,Very Positive,53,4,57
341120,8,Very Positive,59,3,62
341150,8,Very Positive,140,27,167
341160,0,5 user reviews,3,2,5
341170,7,Positive,9,1,10
341190,0,4 user reviews,3,1,4
341220,0,1 user reviews,0,1,1
341260,0,3 user reviews,1,2,3
341270,0,6 user reviews,2,4,6
341290,7,Positive,8,2,10
341310,6,Mostly Positive,538,209,747
341360,0,9 user reviews,6,3,9
341380,4,Mostly Negative,3,9,12
341390,6,Mostly Positive,84,34,118
341410,0,2 user reviews,2,0,2
341440,7,Positive,12,3,15
341470,5,Mixed,5,6,11
341490,0,1 user reviews,1,0,1
341500,5,Mixed,258,167,425
341510,6,Mostly Positive,12,5,17
341530,7,Positive,31,3,34
341540,5,Mixed,11,7,18
341550,8,Very Positive,154,17,171
341570,7,Positive,11,2,13
341610,0,3 user reviews,3,0,3
341640,5,Mixed,5,6,11
341660,4,Mostly Negative,13,28,41
341680,7,Positive,25,3,28
341690,5,Mixed,10,8,18
341700,6,Mostly Positive,26,11,37
341710,5,Mixed,148,82,230
341720,0,2 user reviews,2,0,2
341730,8,Very Positive,75,11,86
341750,0,8 user reviews,4,4,8
341760,7,Positive,9,2,11
341770,0,6 user reviews,2,4,6
341790,0,1 user reviews,1,0,1
341800,9,Overwhelmingly Positive,4661,60,4721
341810,7,Positive,16,3,19
341820,7,Positive,32,8,40
341840,0,3 user reviews,3,0,3
341842,7,Positive,10,0,10
341844,0,2 user reviews,2,0,2
341845,0,6 user reviews,2,4,6
341846,0,1 user reviews,1,0,1
341847,0,1 user reviews,0,1,1
341848,0,4 user reviews,1,3,4
341849,0,1 user reviews,1,0,1
341850,0,1 user reviews,1,0,1
341870,5,Mixed,148,64,212
341890,5,Mixed,7,5,12
341910,7,Positive,21,5,26
341930,5,Mixed,14,16,30
341940,6,Mostly Positive,3364,959,4323
341950,8,Very Positive,85,18,103
341960,7,Positive,14,2,16
342000,4,Mostly Negative,8,22,30
342010,0,1 user reviews,1,0,1
342020,5,Mixed,12,7,19
342090,4,Mostly Negative,2,8,10
342100,6,Mostly Positive,11,3,14
342130,0,7 user reviews,4,3,7
342180,8,Very Positive,2850,649,3499
342190,6,Mostly Positive,85,25,110
342200,5,Mixed,65,30,95
342230,5,Mixed,27,22,49
342240,0,6 user reviews,3,3,6
342250,0,1 user reviews,1,0,1
342260,5,Mixed,87,38,125
342280,8,Very Positive,60,9,69
342290,0,1 user reviews,0,1,1
342300,8,Very Positive,215,16,231
342310,5,Mixed,304,173,477
342350,8,Very Positive,83,20,103
342360,5,Mixed,5,5,10
342370,7,Positive,8,2,10
342380,8,Very Positive,708,140,848
342430,0,4 user reviews,4,0,4
342450,5,Mixed,40,44,84
342480,7,Positive,39,7,46
342490,6,Mostly Positive,94,25,119
342500,4,Mostly Negative,4,15,19
342510,0,4 user reviews,3,1,4
342520,5,Mixed,6,4,10
342530,6,Mostly Positive,16,6,22
342540,0,8 user reviews,3,5,8
342550,4,Mostly Negative,36,61,97
342560,9,Overwhelmingly Positive,2267,97,2364
342570,0,3 user reviews,0,3,3
342580,8,Very Positive,637,67,704
342610,8,Very Positive,191,6,197
342620,6,Mostly Positive,63,19,82
342630,7,Positive,31,3,34
342640,5,Mixed,313,140,453
342650,0,8 user reviews,5,3,8
342660,0,2 user reviews,1,1,2
342680,0,7 user reviews,5,2,7
342740,5,Mixed,7,7,14
342751,0,1 user reviews,1,0,1
342753,0,2 user reviews,2,0,2
342754,0,6 user reviews,6,0,6
342755,0,2 user reviews,2,0,2
342756,0,2 user reviews,2,0,2
342758,0,1 user reviews,1,0,1
342761,0,2 user reviews,2,0,2
342763,0,1 user reviews,1,0,1
342767,0,1 user reviews,0,1,1
342768,0,2 user reviews,1,1,2
342769,0,1 user reviews,0,1,1
342776,0,2 user reviews,2,0,2
342779,0,1 user reviews,1,0,1
342780,0,1 user reviews,1,0,1
342785,0,1 user reviews,1,0,1
342786,0,2 user reviews,1,1,2
342789,0,2 user reviews,2,0,2
342790,0,5 user reviews,5,0,5
342792,0,2 user reviews,2,0,2
342796,0,1 user reviews,1,0,1
342800,0,1 user reviews,1,0,1
342806,0,2 user reviews,2,0,2
342811,0,2 user reviews,2,0,2
342812,0,1 user reviews,1,0,1
342815,0,1 user reviews,1,0,1
342816,0,2 user reviews,1,1,2
342817,0,1 user reviews,1,0,1
342819,0,1 user reviews,1,0,1
342822,0,2 user reviews,2,0,2
342825,0,6 user reviews,6,0,6
342829,0,2 user reviews,2,0,2
342830,0,1 user reviews,1,0,1
342831,0,6 user reviews,5,1,6
342835,0,1 user reviews,1,0,1
342836,0,1 user reviews,1,0,1
342837,0,1 user reviews,1,0,1
342839,0,1 user reviews,1,0,1
342841,7,Positive,11,0,11
342842,0,1 user reviews,1,0,1
342843,0,3 user reviews,3,0,3
342844,0,2 user reviews,2,0,2
342846,0,1 user reviews,1,0,1
342847,0,1 user reviews,1,0,1
342849,0,1 user reviews,1,0,1
342851,0,3 user reviews,3,0,3
342853,0,1 user reviews,1,0,1
342859,0,1 user reviews,0,1,1
342860,5,Mixed,32,15,47
342870,5,Mixed,6,5,11
342880,0,7 user reviews,5,2,7
342890,5,Mixed,20,17,37
342910,5,Mixed,19,16,35
342920,0,9 user reviews,7,2,9
342940,8,Very Positive,905,135,1040
342970,5,Mixed,54,42,96
342980,0,7 user reviews,4,3,7
342990,5,Mixed,24,31,55
343000,5,Mixed,13,14,27
343020,0,1 user reviews,1,0,1
343070,5,Mixed,75,55,130
343090,8,Very Positive,146,33,179
343100,6,Mostly Positive,252,100,352
343120,5,Mixed,23,14,37
343140,0,8 user reviews,4,4,8
343150,4,Mostly Negative,12,19,31
343170,0,7 user reviews,3,4,7
343180,0,8 user reviews,5,3,8
343250,0,3 user reviews,2,1,3
343270,5,Mixed,119,78,197
343280,4,Mostly Negative,18,33,51
343290,0,7 user reviews,7,0,7
343300,7,Positive,12,1,13
343320,7,Positive,8,2,10
343340,4,Mostly Negative,4,10,14
343360,5,Mixed,109,75,184
343370,8,Very Positive,85,5,90
343390,5,Mixed,17,8,25
343410,0,3 user reviews,3,0,3
343430,7,Positive,10,2,12
343440,8,Very Positive,290,51,341
343460,5,Mixed,44,35,79
343461,6,Mostly Positive,69,19,88
343462,5,Mixed,99,54,153
343463,8,Very Positive,113,13,126
343464,5,Mixed,319,168,487
343510,0,1 user reviews,1,0,1
343560,8,Very Positive,148,26,174
343570,7,Positive,11,2,13
343580,7,Positive,16,2,18
343591,0,2 user reviews,1,1,2
343592,0,3 user reviews,1,2,3
343594,4,Mostly Negative,7,13,20
343595,5,Mixed,4,6,10
343596,0,6 user reviews,0,6,6
343597,0,1 user reviews,0,1,1
343598,0,3 user reviews,1,2,3
343599,0,1 user reviews,0,1,1
343600,5,Mixed,14,10,24
343610,5,Mixed,7,7,14
343611,4,Mostly Negative,14,38,52
343612,0,2 user reviews,0,2,2
343615,0,2 user reviews,0,2,2
343690,4,Mostly Negative,4,11,15
343710,5,Mixed,429,247,676
343730,0,4 user reviews,2,2,4
343740,0,2 user reviews,2,0,2
343750,0,7 user reviews,2,5,7
343760,0,2 user reviews,1,1,2
343770,0,1 user reviews,0,1,1
343780,8,Very Positive,1273,94,1367
343800,6,Mostly Positive,22,8,30
343810,7,Positive,34,2,36
343820,6,Mostly Positive,29,8,37
343830,0,7 user reviews,5,2,7
343840,7,Positive,28,4,32
343860,8,Very Positive,1379,172,1551
343930,5,Mixed,32,17,49
343950,5,Mixed,6,6,12
343951,0,8 user reviews,2,6,8
343952,5,Mixed,5,6,11
343953,6,Mostly Positive,25,10,35
343955,4,Mostly Negative,8,14,22
343956,6,Mostly Positive,16,5,21
343959,5,Mixed,16,7,23
343961,5,Mixed,9,8,17
343962,5,Mixed,8,5,13
343990,5,Mixed,6,8,14
344030,5,Mixed,9,7,16
344050,0,5 user reviews,4,1,5
344060,0,3 user reviews,3,0,3
344070,0,4 user reviews,4,0,4
344100,0,5 user reviews,2,3,5
344120,0,2 user reviews,2,0,2
344130,7,Positive,12,2,14
344140,5,Mixed,169,83,252
344160,3,Negative,3,17,20
344172,0,1 user reviews,1,0,1
344173,0,1 user reviews,1,0,1
344178,0,1 user reviews,1,0,1
344180,6,Mostly Positive,28,12,40
344190,0,1 user reviews,1,0,1
344210,0,4 user reviews,3,1,4
344220,0,9 user reviews,4,5,9
344230,5,Mixed,19,11,30
344240,5,Mixed,288,165,453
344260,0,3 user reviews,2,1,3
344270,0,7 user reviews,7,0,7
344290,5,Mixed,12,6,18
344300,5,Mixed,13,7,20
344340,8,Very Positive,92,21,113
344410,5,Mixed,88,43,131
344440,8,Very Positive,61,8,69
344450,8,Very Positive,283,45,328
344461,5,Mixed,47,30,77
344462,5,Mixed,29,27,56
344463,8,Very Positive,63,14,77
344480,8,Very Positive,104,1,105
344490,0,1 user reviews,1,0,1
344500,7,Positive,42,6,48
344510,6,Mostly Positive,19,5,24
344530,0,1 user reviews,1,0,1
344630,8,Very Positive,91,9,100
344730,0,6 user reviews,6,0,6
344740,8,Very Positive,482,95,577
344760,5,Mixed,4175,3583,7758
344770,8,Very Positive,440,8,448
344790,5,Mixed,13,14,27
344800,8,Very Positive,49,8,57
344810,8,Very Positive,54,13,67
344820,4,Mostly Negative,15,45,60
344840,4,Mostly Negative,67,105,172
344850,6,Mostly Positive,599,179,778
344860,8,Very Positive,169,9,178
344890,4,Mostly Negative,10,25,35
344900,4,Mostly Negative,16,26,42
344910,5,Mixed,104,85,189
344920,0,1 user reviews,1,0,1
344960,0,4 user reviews,3,1,4
345010,5,Mixed,165,78,243
345020,6,Mostly Positive,23,6,29
345030,5,Mixed,6,9,15
345040,0,4 user reviews,4,0,4
345050,0,9 user reviews,7,2,9
345060,6,Mostly Positive,22,8,30
345080,5,Mixed,55,29,84
345090,8,Very Positive,207,41,248
345120,8,Very Positive,92,20,112
345130,0,9 user reviews,8,1,9
345140,5,Mixed,39,28,67
345150,0,1 user reviews,1,0,1
345180,8,Very Positive,1121,161,1282
345200,8,Very Positive,143,15,158
345220,7,Positive,12,2,14
345230,5,Mixed,31,19,50
345240,8,Very Positive,244,33,277
345260,5,Mixed,463,238,701
345280,5,Mixed,19,24,43
345290,0,4 user reviews,3,1,4
345300,0,1 user reviews,1,0,1
345310,0,2 user reviews,2,0,2
345330,6,Mostly Positive,95,26,121
345340,5,Mixed,7,4,11
345350,8,Very Positive,1177,278,1455
345370,8,Very Positive,275,60,335
345390,8,Very Positive,867,108,975
345430,8,Very Positive,162,25,187
345440,4,Mostly Negative,16,46,62
345470,0,1 user reviews,1,0,1
345480,6,Mostly Positive,33,10,43
345540,7,Positive,33,8,41
345557,0,1 user reviews,1,0,1
345570,0,3 user reviews,3,0,3
345580,5,Mixed,7,6,13
345610,8,Very Positive,470,29,499
345620,8,Very Positive,53,8,61
345630,7,Positive,37,1,38
345640,5,Mixed,15,11,26
345650,0,7 user reviews,5,2,7
345660,5,Mixed,278,135,413
345670,7,Positive,12,0,12
345680,0,8 user reviews,7,1,8
345681,0,9 user reviews,7,2,9
345690,0,3 user reviews,0,3,3
345700,5,Mixed,22,13,35
345710,3,Negative,2,20,22
345720,7,Positive,12,0,12
345740,7,Positive,36,4,40
345741,7,Positive,12,0,12
345750,5,Mixed,30,28,58
345790,0,9 user reviews,5,4,9
345800,8,Very Positive,51,8,59
345820,9,Overwhelmingly Positive,706,32,738
345860,8,Very Positive,91,20,111
345870,7,Positive,12,3,15
345890,5,Mixed,239,111,350
345900,0,2 user reviews,2,0,2
345930,0,1 user reviews,1,0,1
345980,6,Mostly Positive,95,38,133
345990,6,Mostly Positive,13,4,17
346010,9,Overwhelmingly Positive,15838,803,16641
346040,5,Mixed,12,13,25
346060,7,Positive,11,0,11
346071,0,1 user reviews,1,0,1
346080,4,Mostly Negative,4,10,14
346090,7,Positive,21,4,25
346110,6,Mostly Positive,102386,34564,136950
346120,7,Positive,41,6,47
346130,0,1 user reviews,1,0,1
346140,5,Mixed,36,31,67
346150,4,Mostly Negative,3,10,13
346160,5,Mixed,10,11,21
346170,8,Very Positive,92,2,94
346180,6,Mostly Positive,303,78,381
346200,0,5 user reviews,4,1,5
346210,7,Positive,9,2,11
346220,5,Mixed,64,52,116
346240,5,Mixed,20,13,33
346250,6,Mostly Positive,16,6,22
346270,4,Mostly Negative,28,73,101
346290,0,1 user reviews,0,1,1
346300,4,Mostly Negative,3,7,10
346320,5,Mixed,10,14,24
346330,7,Positive,31,5,36
346340,7,Positive,19,4,23
346360,7,Positive,11,1,12
346370,0,2 user reviews,1,1,2
346400,0,1 user reviews,1,0,1
346420,6,Mostly Positive,123,51,174
346430,0,3 user reviews,1,2,3
346440,6,Mostly Positive,9,3,12
346450,6,Mostly Positive,29,11,40
346460,8,Very Positive,141,33,174
346470,8,Very Positive,202,11,213
346480,0,1 user reviews,1,0,1
346490,0,5 user reviews,2,3,5
346500,6,Mostly Positive,25,9,34
346510,7,Positive,19,2,21
346550,5,Mixed,21,23,44
346560,8,Very Positive,466,32,498
346610,5,Mixed,19,16,35
346630,5,Mixed,51,27,78
346650,3,Negative,0,11,11
346670,0,7 user reviews,4,3,7
346720,0,9 user reviews,6,3,9
346730,8,Very Positive,153,28,181
346740,0,8 user reviews,7,1,8
346741,0,8 user reviews,8,0,8
346742,7,Positive,8,2,10
346760,0,2 user reviews,0,2,2
346770,7,Positive,19,2,21
346780,0,3 user reviews,2,1,3
346800,0,6 user reviews,4,2,6
346810,6,Mostly Positive,194,57,251
346830,5,Mixed,113,83,196
346850,8,Very Positive,338,34,372
346900,8,Very Positive,252,44,296
346920,4,Mostly Negative,4,9,13
346930,5,Mixed,21,16,37
346940,8,Very Positive,1707,284,1991
346950,5,Mixed,7,5,12
346970,8,Very Positive,161,33,194
347000,5,Mixed,33,16,49
347040,6,Mostly Positive,8,3,11
347050,0,1 user reviews,0,1,1
347060,4,Mostly Negative,10,19,29
347070,0,5 user reviews,5,0,5
347090,6,Mostly Positive,122,40,162
347100,0,1 user reviews,0,1,1
347110,0,1 user reviews,1,0,1
347160,8,Very Positive,256,36,292
347170,5,Mixed,93,75,168
347190,7,Positive,11,2,13
347210,7,Positive,11,1,12
347211,7,Positive,26,1,27
347212,7,Positive,17,4,21
347213,7,Positive,28,3,31
347230,5,Mixed,12,7,19
347240,0,1 user reviews,1,0,1
347250,7,Positive,23,0,23
347260,6,Mostly Positive,10,3,13
347270,5,Mixed,7,4,11
347280,6,Mostly Positive,7,3,10
347290,5,Mixed,107,56,163
347330,0,4 user reviews,2,2,4
347400,6,Mostly Positive,74,20,94
347410,0,6 user reviews,1,5,6
347430,6,Mostly Positive,416,145,561
347440,5,Mixed,55,27,82
347450,0,3 user reviews,2,1,3
347470,7,Positive,32,1,33
347480,0,9 user reviews,4,5,9
347510,7,Positive,31,4,35
347520,7,Positive,9,1,10
347560,6,Mostly Positive,255,109,364
347580,3,Negative,2,16,18
347590,7,Positive,24,0,24
347600,6,Mostly Positive,311,105,416
347610,8,Very Positive,89,6,95
347620,8,Very Positive,170,21,191
347660,7,Positive,13,2,15
347670,8,Very Positive,261,51,312
347680,0,1 user reviews,1,0,1
347690,5,Mixed,11,8,19
347710,8,Very Positive,71,16,87
347720,8,Very Positive,285,17,302
347730,7,Positive,18,1,19
347790,7,Positive,20,4,24
347820,6,Mostly Positive,14,5,19
347830,8,Very Positive,1109,123,1232
347930,0,6 user reviews,0,6,6
347940,5,Mixed,136,95,231
347980,7,Positive,11,2,13
347981,0,9 user reviews,8,1,9
347990,8,Very Positive,217,6,223
348000,0,2 user reviews,1,1,2
348010,0,1 user reviews,1,0,1
348030,5,Mixed,118,84,202
348040,8,Very Positive,431,2,433
348070,0,1 user reviews,1,0,1
348090,6,Mostly Positive,397,138,535
348091,6,Mostly Positive,98,42,140
348100,0,1 user reviews,1,0,1
348160,0,5 user reviews,5,0,5
348180,5,Mixed,18,16,34
348200,8,Very Positive,264,28,292
348210,0,6 user reviews,4,2,6
348240,7,Positive,39,6,45
348250,7,Positive,46,3,49
348270,5,Mixed,40,42,82
348280,5,Mixed,5,6,11
348290,5,Mixed,31,44,75
348300,8,Very Positive,66,6,72
348310,0,1 user reviews,1,0,1
348320,0,1 user reviews,1,0,1
348330,7,Positive,38,2,40
348340,5,Mixed,21,16,37
348360,6,Mostly Positive,162,49,211
348380,4,Mostly Negative,20,53,73
348400,5,Mixed,39,27,66
348430,7,Positive,43,0,43
348440,7,Positive,38,2,40
348450,4,Mostly Negative,15,30,45
348460,5,Mixed,62,31,93
348470,6,Mostly Positive,363,124,487
348490,6,Mostly Positive,103,29,132
348510,4,Mostly Negative,67,142,209
348540,5,Mixed,29,13,42
348550,9,Overwhelmingly Positive,518,18,536
348560,8,Very Positive,48,2,50
348561,8,Very Positive,90,9,99
348620,7,Positive,12,2,14
348650,3,Negative,1,10,11
348670,5,Mixed,118,101,219
348680,0,3 user reviews,2,1,3
348681,0,5 user reviews,5,0,5
348682,0,3 user reviews,3,0,3
348684,0,2 user reviews,2,0,2
348685,0,2 user reviews,2,0,2
348686,0,2 user reviews,1,1,2
348687,0,8 user reviews,8,0,8
348700,0,1 user reviews,0,1,1
348710,8,Very Positive,274,33,307
348730,4,Mostly Negative,6,12,18
348740,0,2 user reviews,0,2,2
348750,0,2 user reviews,2,0,2
348760,0,1 user reviews,1,0,1
348790,5,Mixed,10,6,16
348800,0,8 user reviews,7,1,8
348810,5,Mixed,9,5,14
348820,8,Very Positive,97,13,110
348850,0,4 user reviews,2,2,4
348860,0,9 user reviews,2,7,9
348870,5,Mixed,22,17,39
348910,6,Mostly Positive,64,17,81
348940,0,8 user reviews,7,1,8
348950,8,Very Positive,48,4,52
348960,5,Mixed,6,5,11
348980,0,6 user reviews,2,4,6
348990,6,Mostly Positive,9,3,12
349000,0,6 user reviews,5,1,6
349020,5,Mixed,9,8,17
349040,8,Very Positive,5937,1088,7025
349060,0,7 user reviews,4,3,7
349080,0,1 user reviews,1,0,1
349100,7,Positive,38,0,38
349140,6,Mostly Positive,66,23,89
349150,0,3 user reviews,2,1,3
349190,5,Mixed,11,10,21
349220,8,Very Positive,320,44,364
349230,0,8 user reviews,6,2,8
349231,0,5 user reviews,4,1,5
349240,6,Mostly Positive,11,3,14
349250,8,Very Positive,150,3,153
349260,7,Positive,17,4,21
349270,6,Mostly Positive,35,15,50
349280,5,Mixed,6,4,10
349300,8,Very Positive,41,10,51
349310,8,Very Positive,104,7,111
349320,6,Mostly Positive,9,3,12
349350,6,Mostly Positive,23,9,32
349370,0,1 user reviews,1,0,1
349440,4,Mostly Negative,9,29,38
349450,5,Mixed,11,10,21
349460,0,8 user reviews,4,4,8
349480,0,7 user reviews,6,1,7
349500,8,Very Positive,181,39,220
349510,8,Very Positive,54,6,60
349530,5,Mixed,12,8,20
349540,5,Mixed,13,15,28
349550,5,Mixed,24,13,37
349580,4,Mostly Negative,36,59,95
349650,0,6 user reviews,4,2,6
349670,0,9 user reviews,4,5,9
349680,8,Very Positive,69,5,74
349690,7,Positive,24,1,25
349700,5,Mixed,18,15,33
349710,0,1 user reviews,1,0,1
349720,0,8 user reviews,3,5,8
349730,8,Very Positive,257,42,299
349740,7,Positive,15,0,15
349750,0,6 user reviews,1,5,6
349760,7,Positive,25,1,26
349770,6,Mostly Positive,12,5,17
349780,0,2 user reviews,2,0,2
349790,5,Mixed,89,53,142
349810,0,1 user reviews,1,0,1
349830,5,Mixed,193,109,302
349840,4,Mostly Negative,4,8,12
349934,0,1 user reviews,1,0,1
349935,0,4 user reviews,4,0,4
349937,0,1 user reviews,1,0,1
349938,0,1 user reviews,1,0,1
349940,0,2 user reviews,0,2,2
349950,0,9 user reviews,7,2,9
349960,0,2 user reviews,2,0,2
349980,0,1 user reviews,0,1,1
350000,0,6 user reviews,3,3,6
350010,5,Mixed,46,58,104
350020,0,1 user reviews,0,1,1
350060,5,Mixed,8,4,12
350070,8,Very Positive,534,74,608
350080,8,Very Positive,3722,547,4269
350090,5,Mixed,5,5,10
350110,5,Mixed,66,85,151
350150,6,Mostly Positive,60,20,80
350200,4,Mostly Negative,13,38,51
350210,6,Mostly Positive,21,6,27
350220,2,Very Negative,16,74,90
350270,0,5 user reviews,4,1,5
350271,0,5 user reviews,4,1,5
350272,4,Mostly Negative,6,12,18
350280,6,Mostly Positive,2220,862,3082
350300,0,2 user reviews,2,0,2
350310,5,Mixed,120,60,180
350380,3,Negative,6,32,38
350400,0,1 user reviews,1,0,1
350410,0,1 user reviews,1,0,1
350412,0,1 user reviews,0,1,1
350414,0,3 user reviews,3,0,3
350460,7,Positive,29,3,32
350480,6,Mostly Positive,14,6,20
350490,5,Mixed,8,12,20
350500,5,Mixed,43,52,95
350530,4,Mostly Negative,15,29,44
350550,7,Positive,12,0,12
350600,5,Mixed,52,31,83
350610,7,Positive,16,3,19
350620,7,Positive,24,5,29
350630,6,Mostly Positive,13,5,18
350640,6,Mostly Positive,930,293,1223
350660,0,1 user reviews,1,0,1
350680,0,1 user reviews,1,0,1
350690,6,Mostly Positive,29,8,37
350700,0,2 user reviews,0,2,2
350710,5,Mixed,15,8,23
350740,8,Very Positive,257,29,286
350770,5,Mixed,42,31,73
350780,8,Very Positive,74,12,86
350800,0,6 user reviews,1,5,6
350810,8,Very Positive,54,9,63
350840,0,5 user reviews,1,4,5
350880,7,Positive,12,2,14
350910,8,Very Positive,201,4,205
350970,8,Very Positive,58,7,65
351030,8,Very Positive,172,30,202
351040,5,Mixed,81,66,147
351050,5,Mixed,21,15,36
351060,4,Mostly Negative,9,25,34
351070,0,1 user reviews,1,0,1
351080,5,Mixed,28,13,41
351090,8,Very Positive,253,7,260
351100,5,Mixed,230,112,342
351140,0,6 user reviews,2,4,6
351150,5,Mixed,145,63,208
351170,0,6 user reviews,5,1,6
351220,0,8 user reviews,5,3,8
351230,8,Very Positive,77,11,88
351240,7,Positive,28,3,31
351250,8,Very Positive,52,4,56
351290,5,Mixed,1211,1312,2523
351300,5,Mixed,41,34,75
351320,7,Positive,12,2,14
351330,6,Mostly Positive,15,4,19
351340,6,Mostly Positive,170,68,238
351390,0,6 user reviews,5,1,6
351400,0,9 user reviews,7,2,9
351410,0,1 user reviews,1,0,1
351420,0,7 user reviews,5,2,7
351430,0,2 user reviews,1,1,2
351450,5,Mixed,18,15,33
351461,0,8 user reviews,8,0,8
351470,5,Mixed,32,18,50
351480,8,Very Positive,174,12,186
351490,6,Mostly Positive,282,75,357
351510,8,Very Positive,495,39,534
351570,7,Positive,8,2,10
351590,0,7 user reviews,7,0,7
351591,0,9 user reviews,9,0,9
351630,0,1 user reviews,0,1,1
351640,8,Very Positive,80,2,82
351680,0,3 user reviews,3,0,3
351690,0,4 user reviews,4,0,4
351700,9,Overwhelmingly Positive,537,25,562
351710,8,Very Positive,1212,110,1322
351720,5,Mixed,7,6,13
351730,5,Mixed,39,19,58
351740,0,8 user reviews,6,2,8
351790,0,3 user reviews,3,0,3
351800,6,Mostly Positive,9,3,12
351810,7,Positive,9,1,10
351820,6,Mostly Positive,11,3,14
351860,6,Mostly Positive,85,29,114
351870,6,Mostly Positive,58,16,74
351890,5,Mixed,165,238,403
351900,5,Mixed,105,81,186
351910,5,Mixed,92,84,176
351920,9,Overwhelmingly Positive,1344,62,1406
351930,0,1 user reviews,1,0,1
351940,6,Mostly Positive,151,57,208
351970,8,Very Positive,2321,538,2859
351990,8,Very Positive,806,146,952
352000,8,Very Positive,84,21,105
352010,6,Mostly Positive,63,25,88
352030,7,Positive,17,2,19
352050,6,Mostly Positive,9,3,12
352070,8,Very Positive,74,8,82
352080,6,Mostly Positive,10,3,13
352120,4,Mostly Negative,5,8,13
352130,5,Mixed,15,12,27
352140,6,Mostly Positive,40,12,52
352150,4,Mostly Negative,4,7,11
352170,4,Mostly Negative,8,13,21
352182,0,7 user reviews,5,2,7
352183,0,4 user reviews,2,2,4
352184,5,Mixed,7,7,14
352185,0,2 user reviews,2,0,2
352186,7,Positive,9,2,11
352187,0,4 user reviews,3,1,4
352188,0,4 user reviews,1,3,4
352189,0,4 user reviews,2,2,4
352190,5,Mixed,13,6,19
352200,0,6 user reviews,2,4,6
352210,0,4 user reviews,2,2,4
352220,6,Mostly Positive,168,44,212
352230,7,Positive,12,0,12
352240,5,Mixed,60,38,98
352280,0,8 user reviews,2,6,8
352290,0,9 user reviews,8,1,9
352360,5,Mixed,9,6,15
352370,6,Mostly Positive,14,6,20
352400,8,Very Positive,1154,222,1376
352430,5,Mixed,73,46,119
352440,7,Positive,12,3,15
352520,8,Very Positive,2105,155,2260
352530,0,4 user reviews,2,2,4
352550,4,Mostly Negative,202,512,714
352560,0,6 user reviews,4,2,6
352580,5,Mixed,14,13,27
352590,5,Mixed,10,5,15
352610,8,Very Positive,90,12,102
352620,7,Positive,20,2,22
352640,7,Positive,13,1,14
352700,0,3 user reviews,3,0,3
352710,0,7 user reviews,7,0,7
352720,8,Very Positive,1880,430,2310
352730,0,6 user reviews,4,2,6
352740,6,Mostly Positive,12,4,16
352750,0,3 user reviews,2,1,3
352760,5,Mixed,10,5,15
352780,8,Very Positive,155,33,188
352790,7,Positive,8,2,10
352810,6,Mostly Positive,8,3,11
352840,8,Very Positive,75,0,75
352850,0,5 user reviews,2,3,5
352890,5,Mixed,78,38,116
352900,0,7 user reviews,4,3,7
352950,4,Mostly Negative,66,154,220
352960,4,Mostly Negative,13,21,34
352980,0,2 user reviews,1,1,2
352990,0,2 user reviews,0,2,2
352991,0,8 user reviews,6,2,8
353000,0,2 user reviews,2,0,2
353050,7,Positive,13,2,15
353051,0,6 user reviews,2,4,6
353052,0,5 user reviews,3,2,5
353053,0,7 user reviews,5,2,7
353060,0,2 user reviews,0,2,2
353070,5,Mixed,33,29,62
353080,0,7 user reviews,6,1,7
353090,8,Very Positive,272,9,281
353110,6,Mostly Positive,13,4,17
353130,5,Mixed,5,5,10
353140,0,9 user reviews,5,4,9
353190,5,Mixed,61,35,96
353220,0,6 user reviews,2,4,6
353260,0,1 user reviews,1,0,1
353270,9,Overwhelmingly Positive,1267,57,1324
353280,7,Positive,32,2,34
353300,0,5 user reviews,2,3,5
353330,8,Very Positive,439,29,468
353340,6,Mostly Positive,15,4,19
353360,7,Positive,11,1,12
353370,6,Mostly Positive,5186,1810,6996
353380,6,Mostly Positive,2817,1039,3856
353390,0,7 user reviews,6,1,7
353540,8,Very Positive,401,14,415
353550,5,Mixed,118,74,192
353560,8,Very Positive,1540,279,1819
353570,0,3 user reviews,3,0,3
353571,0,4 user reviews,4,0,4
353580,7,Positive,28,7,35
353600,0,5 user reviews,2,3,5
353610,5,Mixed,8,9,17
353620,0,8 user reviews,3,5,8
353630,5,Mixed,18,27,45
353640,8,Very Positive,816,117,933
353700,8,Very Positive,429,47,476
353760,0,7 user reviews,5,2,7
353761,0,5 user reviews,4,1,5
353770,0,3 user reviews,1,2,3
353790,0,8 user reviews,8,0,8
353820,7,Positive,12,1,13
353830,6,Mostly Positive,255,92,347
353850,0,2 user reviews,2,0,2
353890,6,Mostly Positive,40,13,53
353940,5,Mixed,6,6,12
353970,0,6 user reviews,4,2,6
353980,5,Mixed,18,9,27
353990,5,Mixed,6,4,10
354020,0,2 user reviews,2,0,2
354030,0,7 user reviews,6,1,7
354040,0,1 user reviews,1,0,1
354050,5,Mixed,11,9,20
354140,8,Very Positive,3161,468,3629
354160,5,Mixed,43,51,94
354170,0,1 user reviews,0,1,1
354180,5,Mixed,10,7,17
354200,4,Mostly Negative,3,7,10
354230,5,Mixed,15,9,24
354240,8,Very Positive,1298,226,1524
354270,0,1 user reviews,1,0,1
354280,0,7 user reviews,5,2,7
354290,0,7 user reviews,5,2,7
354310,7,Positive,17,1,18
354330,6,Mostly Positive,98,34,132
354331,5,Mixed,14,13,27
354350,0,8 user reviews,8,0,8
354380,5,Mixed,470,207,677
354400,8,Very Positive,174,8,182
354430,6,Mostly Positive,112,45,157
354461,0,1 user reviews,1,0,1
354462,0,1 user reviews,1,0,1
354463,0,1 user reviews,1,0,1
354464,0,4 user reviews,4,0,4
354465,0,3 user reviews,3,0,3
354466,0,2 user reviews,2,0,2
354467,7,Positive,10,1,11
354468,5,Mixed,14,13,27
354469,0,1 user reviews,1,0,1
354500,0,2 user reviews,1,1,2
354520,0,1 user reviews,1,0,1
354560,5,Mixed,8,5,13
354600,7,Positive,17,2,19
354620,7,Positive,40,8,48
354640,4,Mostly Negative,4,7,11
354650,8,Very Positive,202,34,236
354680,8,Very Positive,215,29,244
354690,0,5 user reviews,1,4,5
354700,0,3 user reviews,1,2,3
354701,0,3 user reviews,2,1,3
354702,0,2 user reviews,1,1,2
354720,5,Mixed,11,6,17
354730,5,Mixed,12,17,29
354740,8,Very Positive,71,11,82
354770,0,8 user reviews,6,2,8
354810,0,4 user reviews,1,3,4
354820,3,Negative,1,14,15
354830,8,Very Positive,3722,547,4269
354860,6,Mostly Positive,27,10,37
354900,0,3 user reviews,3,0,3
354920,5,Mixed,8,6,14
354930,0,3 user reviews,2,1,3
354950,5,Mixed,12,8,20
354960,5,Mixed,7,5,12
354970,5,Mixed,21,13,34
355000,0,7 user reviews,4,3,7
355010,5,Mixed,19,14,33
355020,0,1 user reviews,0,1,1
355030,6,Mostly Positive,14,6,20
355050,8,Very Positive,472,58,530
355060,5,Mixed,73,77,150
355080,0,6 user reviews,3,3,6
355100,5,Mixed,12,8,20
355120,0,6 user reviews,1,5,6
355130,6,Mostly Positive,105,45,150
355140,7,Positive,10,2,12
355150,5,Mixed,161,183,344
355170,8,Very Positive,138,6,144
355180,8,Very Positive,132,22,154
355190,5,Mixed,11,7,18
355203,0,1 user reviews,0,1,1
355230,7,Positive,13,3,16
355240,8,Very Positive,125,25,150
355250,8,Very Positive,219,53,272
355260,0,1 user reviews,0,1,1
355270,8,Very Positive,121,11,132
355280,0,5 user reviews,5,0,5
355300,0,1 user reviews,1,0,1
355310,6,Mostly Positive,15,4,19
355340,5,Mixed,8,6,14
355341,5,Mixed,11,7,18
355350,7,Positive,23,5,28
355360,0,8 user reviews,7,1,8
355370,6,Mostly Positive,11,3,14
355380,0,2 user reviews,0,2,2
355400,5,Mixed,69,31,100
355410,8,Very Positive,45,8,53
355420,8,Very Positive,67,5,72
355430,5,Mixed,9,8,17
355440,0,1 user reviews,1,0,1
355450,0,1 user reviews,1,0,1
355460,5,Mixed,11,13,24
355490,5,Mixed,9,6,15
355500,0,1 user reviews,1,0,1
355510,0,2 user reviews,1,1,2
355520,8,Very Positive,113,20,133
355530,8,Very Positive,143,24,167
355560,7,Positive,11,2,13
355570,7,Positive,15,1,16
355630,8,Very Positive,82,8,90
355640,0,4 user reviews,3,1,4
355641,7,Positive,13,2,15
355650,0,5 user reviews,4,1,5
355670,0,2 user reviews,2,0,2
355680,6,Mostly Positive,99,42,141
355690,7,Positive,11,2,13
355730,7,Positive,16,1,17
355740,7,Positive,30,6,36
355760,5,Mixed,115,114,229
355770,0,1 user reviews,0,1,1
355790,8,Very Positive,825,180,1005
355800,6,Mostly Positive,276,115,391
355810,5,Mixed,6,6,12
355820,7,Positive,36,2,38
355840,5,Mixed,71,47,118
355860,6,Mostly Positive,152,58,210
355880,9,Overwhelmingly Positive,1145,13,1158
355900,0,7 user reviews,5,2,7
355910,5,Mixed,7,4,11
355920,7,Positive,27,3,30
355950,8,Very Positive,249,62,311
355960,4,Mostly Negative,237,430,667
355970,6,Mostly Positive,194,71,265
355980,9,Overwhelmingly Positive,622,30,652
356000,6,Mostly Positive,67,20,87
356030,0,7 user reviews,4,3,7
356040,6,Mostly Positive,1475,493,1968
356050,6,Mostly Positive,248,100,348
356070,0,6 user reviews,3,3,6
356090,7,Positive,16,1,17
356100,6,Mostly Positive,11,4,15
356110,0,3 user reviews,3,0,3
356130,0,3 user reviews,2,1,3
356140,0,1 user reviews,1,0,1
356160,4,Mostly Negative,6,14,20
356170,0,3 user reviews,1,2,3
356180,5,Mixed,51,25,76
356190,8,Very Positive,11930,2231,14161
356200,6,Mostly Positive,22,6,28
356210,0,9 user reviews,4,5,9
356230,0,3 user reviews,3,0,3
356231,0,3 user reviews,3,0,3
356240,7,Positive,9,1,10
356250,8,Very Positive,80,8,88
356260,8,Very Positive,66,16,82
356270,5,Mixed,39,19,58
356280,5,Mixed,6,9,15
356290,5,Mixed,9,6,15
356310,0,6 user reviews,4,2,6
356380,5,Mixed,27,13,40
356390,8,Very Positive,47,11,58
356400,8,Very Positive,1813,143,1956
356410,0,3 user reviews,3,0,3
356420,8,Very Positive,97,14,111
356430,8,Very Positive,180,38,218
356440,7,Positive,11,1,12
356450,6,Mostly Positive,52,18,70
356460,6,Mostly Positive,11,3,14
356500,8,Very Positive,1108,118,1226
356510,4,Mostly Negative,10,23,33
356520,7,Positive,11,0,11
356530,8,Very Positive,111,13,124
356540,7,Positive,9,2,11
356550,7,Positive,10,2,12
356560,7,Positive,12,1,13
356570,8,Very Positive,1994,346,2340
356580,5,Mixed,40,22,62
356630,0,2 user reviews,2,0,2
356650,6,Mostly Positive,837,302,1139
356670,8,Very Positive,82,2,84
356710,0,2 user reviews,2,0,2
356730,0,4 user reviews,3,1,4
356741,0,2 user reviews,2,0,2
356744,0,1 user reviews,1,0,1
356750,0,7 user reviews,6,1,7
356751,0,2 user reviews,2,0,2
356770,5,Mixed,22,14,36
356790,7,Positive,21,4,25
356800,5,Mixed,8,10,18
356820,0,1 user reviews,1,0,1
356831,8,Very Positive,107,2,109
356870,0,5 user reviews,1,4,5
356880,5,Mixed,64,39,103
356890,5,Mixed,55,31,86
356910,6,Mostly Positive,52,19,71
356960,5,Mixed,34,31,65
356970,0,1 user reviews,1,0,1
357030,0,7 user reviews,2,5,7
357040,0,2 user reviews,1,1,2
357070,8,Very Positive,825,98,923
357110,0,2 user reviews,1,1,2
357120,6,Mostly Positive,42,17,59
357163,0,3 user reviews,1,2,3
357180,7,Positive,16,1,17
357190,8,Very Positive,1237,137,1374
357200,0,5 user reviews,2,3,5
357260,0,1 user reviews,1,0,1
357261,0,1 user reviews,1,0,1
357262,0,1 user reviews,1,0,1
357280,6,Mostly Positive,22,8,30
357290,4,Mostly Negative,69,105,174
357300,8,Very Positive,417,21,438
357310,6,Mostly Positive,465,175,640
357320,5,Mixed,19,15,34
357330,8,Very Positive,608,43,651
357340,8,Very Positive,159,26,185
357350,0,2 user reviews,2,0,2
357360,7,Positive,40,8,48
357370,5,Mixed,18,14,32
357380,8,Very Positive,318,78,396
357400,7,Positive,23,1,24
357410,8,Very Positive,71,0,71
357460,5,Mixed,42,19,61
357470,0,4 user reviews,4,0,4
357480,7,Positive,10,2,12
357490,7,Positive,9,1,10
357500,5,Mixed,9,9,18
357600,8,Very Positive,74,4,78
357650,5,Mixed,66,34,100
357670,6,Mostly Positive,112,48,160
357690,5,Mixed,11,7,18
357700,0,8 user reviews,6,2,8
357710,0,2 user reviews,2,0,2
357711,0,2 user reviews,2,0,2
357720,8,Very Positive,73,15,88
357730,5,Mixed,7,4,11
357750,7,Positive,14,1,15
357760,5,Mixed,72,71,143
357780,6,Mostly Positive,174,54,228
357800,0,6 user reviews,6,0,6
357820,0,4 user reviews,1,3,4
357830,6,Mostly Positive,14,5,19
357840,5,Mixed,12,10,22
357850,7,Positive,24,2,26
357890,7,Positive,23,4,27
357900,5,Mixed,74,101,175
357910,4,Mostly Negative,4,8,12
357920,4,Mostly Negative,7,17,24
357930,0,7 user reviews,4,3,7
357940,6,Mostly Positive,45,15,60
358000,5,Mixed,10,9,19
358010,0,1 user reviews,1,0,1
358020,7,Positive,22,1,23
358030,7,Positive,26,2,28
358070,8,Very Positive,103,9,112
358080,0,6 user reviews,3,3,6
358090,8,Very Positive,751,170,921
358120,0,7 user reviews,6,1,7
358130,8,Very Positive,847,125,972
358140,6,Mostly Positive,13,4,17
358141,7,Positive,14,1,15
358142,7,Positive,25,2,27
358143,0,3 user reviews,3,0,3
358144,0,7 user reviews,4,3,7
358150,8,Very Positive,475,78,553
358170,6,Mostly Positive,8,3,11
358180,7,Positive,20,1,21
358190,7,Positive,27,2,29
358200,7,Positive,12,1,13
358210,7,Positive,20,0,20
358220,7,Positive,12,1,13
358230,0,9 user reviews,9,0,9
358240,0,4 user reviews,3,1,4
358250,7,Positive,44,2,46
358260,7,Positive,42,2,44
358270,8,Very Positive,78,2,80
358280,7,Positive,13,1,14
358290,7,Positive,33,6,39
358300,6,Mostly Positive,8,3,11
358310,7,Positive,12,1,13
358320,0,6 user reviews,6,0,6
358330,0,8 user reviews,4,4,8
358340,7,Positive,21,2,23
358350,7,Positive,29,3,32
358360,8,Very Positive,58,5,63
358370,7,Positive,23,2,25
358380,7,Positive,37,5,42
358390,0,7 user reviews,7,0,7
358400,0,3 user reviews,2,1,3
358410,7,Positive,29,4,33
358420,0,8 user reviews,3,5,8
358430,0,7 user reviews,6,1,7
358440,0,4 user reviews,3,1,4
358470,8,Very Positive,427,20,447
358480,0,8 user reviews,2,6,8
358650,7,Positive,31,3,34
358700,4,Mostly Negative,3,9,12
358750,8,Very Positive,308,62,370
358760,6,Mostly Positive,8,3,11
358770,8,Very Positive,97,13,110
358800,7,Positive,8,2,10
358810,8,Very Positive,40,10,50
358820,0,2 user reviews,1,1,2
358830,8,Very Positive,116,11,127
358840,0,7 user reviews,3,4,7
358850,0,6 user reviews,4,2,6
358880,0,2 user reviews,2,0,2
358920,6,Mostly Positive,42,13,55
358930,5,Mixed,7,7,14
358960,8,Very Positive,75,6,81
359040,8,Very Positive,171,18,189
359050,9,Overwhelmingly Positive,4114,178,4292
359060,4,Mostly Negative,4,9,13
359070,4,Mostly Negative,4,7,11
359090,0,2 user reviews,2,0,2
359100,8,Very Positive,274,68,342
359110,0,1 user reviews,1,0,1
359130,0,1 user reviews,1,0,1
359140,8,Very Positive,90,6,96
359160,4,Mostly Negative,4,13,17
359180,0,3 user reviews,3,0,3
359190,7,Positive,10,2,12
359220,5,Mixed,170,75,245
359230,5,Mixed,292,167,459
359250,5,Mixed,10,5,15
359260,0,4 user reviews,2,2,4
359280,6,Mostly Positive,15,6,21
359290,4,Mostly Negative,6,11,17
359300,0,4 user reviews,2,2,4
359310,8,Very Positive,729,126,855
359320,6,Mostly Positive,21576,7132,28708
359340,5,Mixed,8,4,12
359350,8,Very Positive,182,23,205
359370,5,Mixed,16,24,40
359380,0,2 user reviews,2,0,2
359390,8,Very Positive,1302,104,1406
359400,8,Very Positive,248,9,257
359410,8,Very Positive,95,18,113
359420,7,Positive,28,0,28
359440,6,Mostly Positive,65,27,92
359480,8,Very Positive,152,22,174
359490,0,5 user reviews,4,1,5
359491,7,Positive,15,0,15
359492,0,1 user reviews,1,0,1
359493,0,3 user reviews,3,0,3
359494,0,1 user reviews,1,0,1
359495,0,6 user reviews,6,0,6
359496,7,Positive,11,1,12
359497,0,3 user reviews,3,0,3
359510,8,Very Positive,418,12,430
359520,0,4 user reviews,3,1,4
359521,0,5 user reviews,5,0,5
359522,0,2 user reviews,2,0,2
359550,8,Very Positive,258326,28588,286914
359560,6,Mostly Positive,70,18,88
359570,0,8 user reviews,7,1,8
359580,5,Mixed,106,70,176
359600,5,Mixed,72,75,147
359610,5,Mixed,109,72,181
359620,5,Mixed,9,7,16
359630,5,Mixed,26,12,38
359650,8,Very Positive,66,6,72
359670,6,Mostly Positive,7,3,10
359760,0,4 user reviews,4,0,4
359780,7,Positive,9,1,10
359781,0,9 user reviews,8,1,9
359790,0,7 user reviews,7,0,7
359800,0,6 user reviews,3,3,6
359810,5,Mixed,49,48,97
359840,8,Very Positive,101,13,114
359850,0,4 user reviews,3,1,4
359860,0,1 user reviews,1,0,1
359870,8,Very Positive,4464,451,4915
359900,5,Mixed,198,159,357
359920,6,Mostly Positive,90,33,123
359930,8,Very Positive,83,9,92
359940,5,Mixed,57,26,83
359960,8,Very Positive,57,6,63
359970,0,8 user reviews,8,0,8
360010,7,Positive,14,2,16
360020,0,5 user reviews,4,1,5
360030,6,Mostly Positive,12,4,16
360040,0,8 user reviews,5,3,8
360070,0,5 user reviews,3,2,5
360080,6,Mostly Positive,11,4,15
360090,6,Mostly Positive,12,4,16
360114,0,5 user reviews,4,1,5
360115,0,6 user reviews,5,1,6
360140,0,2 user reviews,2,0,2
360150,5,Mixed,180,171,351
360170,5,Mixed,1142,559,1701
360240,0,4 user reviews,4,0,4
360270,5,Mixed,22,19,41
360280,7,Positive,15,3,18
360290,0,4 user reviews,3,1,4
360340,7,Positive,9,1,10
360350,6,Mostly Positive,13,5,18
360380,5,Mixed,133,111,244
360390,5,Mixed,23,23,46
360430,5,Mixed,4621,3618,8239
360450,6,Mostly Positive,51,14,65
360480,0,7 user reviews,7,0,7
360510,5,Mixed,93,139,232
360520,7,Positive,9,2,11
360530,7,Positive,15,0,15
360550,8,Very Positive,93,18,111
360580,5,Mixed,4,6,10
360590,3,Negative,1,10,11
360600,6,Mostly Positive,11,4,15
360610,5,Mixed,9,11,20
360620,8,Very Positive,59,10,69
360640,8,Very Positive,454,56,510
360650,8,Very Positive,190,43,233
360680,0,2 user reviews,1,1,2
360720,0,4 user reviews,2,2,4
360730,6,Mostly Positive,30,11,41
360740,9,Overwhelmingly Positive,3309,91,3400
360750,0,9 user reviews,4,5,9
360770,0,1 user reviews,0,1,1
360820,7,Positive,18,2,20
360830,6,Mostly Positive,1105,327,1432
360840,7,Positive,34,5,39
360850,7,Positive,23,2,25
360870,0,7 user reviews,4,3,7
360880,5,Mixed,6,5,11
360890,4,Mostly Negative,20,46,66
360940,8,Very Positive,2850,642,3492
360960,9,Overwhelmingly Positive,1093,50,1143
360970,5,Mixed,17,9,26
360990,0,2 user reviews,1,1,2
361020,7,Positive,20,1,21
361040,8,Very Positive,153,16,169
361100,0,9 user reviews,9,0,9
361110,0,6 user reviews,4,2,6
361130,5,Mixed,16,13,29
361160,0,2 user reviews,2,0,2
361180,0,5 user reviews,3,2,5
361181,5,Mixed,6,7,13
361182,0,1 user reviews,1,0,1
361183,5,Mixed,8,4,12
361190,5,Mixed,72,66,138
361200,4,Mostly Negative,5,20,25
361210,0,1 user reviews,1,0,1
361220,0,6 user reviews,6,0,6
361230,8,Very Positive,106,6,112
361280,8,Very Positive,2194,210,2404
361290,6,Mostly Positive,74,25,99
361300,8,Very Positive,922,177,1099
361310,7,Positive,21,2,23
361312,0,3 user reviews,3,0,3
361313,0,3 user reviews,2,1,3
361314,0,7 user reviews,6,1,7
361320,6,Mostly Positive,57,16,73
361330,4,Mostly Negative,5,17,22
361350,8,Very Positive,40,10,50
361360,8,Very Positive,83,10,93
361380,6,Mostly Positive,54,20,74
361420,8,Very Positive,24217,2750,26967
361430,5,Mixed,13,7,20
361440,0,5 user reviews,5,0,5
361470,0,2 user reviews,1,1,2
361500,0,1 user reviews,1,0,1
361550,5,Mixed,481,288,769
361560,0,6 user reviews,1,5,6
361600,7,Positive,10,1,11
361620,5,Mixed,5,5,10
361630,0,5 user reviews,3,2,5
361670,8,Very Positive,145,31,176
361680,0,2 user reviews,2,0,2
361690,6,Mostly Positive,90,25,115
361700,0,3 user reviews,3,0,3
361780,0,1 user reviews,1,0,1
361790,0,5 user reviews,3,2,5
361800,5,Mixed,1188,704,1892
361820,8,Very Positive,64,10,74
361830,8,Very Positive,40,10,50
361840,6,Mostly Positive,38,12,50
361841,7,Positive,35,2,37
361842,7,Positive,30,2,32
361843,8,Very Positive,53,9,62
361850,8,Very Positive,74,8,82
361880,0,4 user reviews,3,1,4
361890,5,Mixed,12,16,28
361930,6,Mostly Positive,9,3,12
361950,6,Mostly Positive,18,5,23
361970,5,Mixed,5,5,10
361990,8,Very Positive,522,37,559
362003,0,3 user reviews,3,0,3
362010,0,2 user reviews,2,0,2
362020,0,9 user reviews,7,2,9
362030,0,2 user reviews,2,0,2
362050,0,1 user reviews,1,0,1
362070,0,2 user reviews,2,0,2
362090,8,Very Positive,130,18,148
362100,0,1 user reviews,1,0,1
362110,0,6 user reviews,5,1,6
362120,0,1 user reviews,1,0,1
362130,7,Positive,21,5,26
362140,0,8 user reviews,2,6,8
362150,0,5 user reviews,4,1,5
362160,7,Positive,9,1,10
362280,0,1 user reviews,1,0,1
362290,5,Mixed,13,6,19
362300,5,Mixed,78,42,120
362310,6,Mostly Positive,24,7,31
362320,0,3 user reviews,2,1,3
362350,5,Mixed,127,92,219
362360,0,5 user reviews,2,3,5
362370,0,3 user reviews,1,2,3
362380,7,Positive,17,2,19
362400,0,2 user reviews,1,1,2
362410,5,Mixed,43,28,71
362490,8,Very Positive,3529,821,4350
362500,0,1 user reviews,1,0,1
362530,0,1 user reviews,1,0,1
362560,0,1 user reviews,1,0,1
362580,0,1 user reviews,1,0,1
362610,0,4 user reviews,2,2,4
362620,8,Very Positive,2796,204,3000
362660,6,Mostly Positive,17,7,24
362680,9,Overwhelmingly Positive,3090,127,3217
362740,0,6 user reviews,5,1,6
362760,0,1 user reviews,1,0,1
362780,5,Mixed,28,14,42
362790,7,Positive,14,0,14
362810,8,Very Positive,159,27,186
362830,4,Mostly Negative,8,16,24
362860,6,Mostly Positive,52,14,66
362870,8,Very Positive,223,28,251
362890,9,Overwhelmingly Positive,23612,1092,24704
362900,0,7 user reviews,7,0,7
362920,4,Mostly Negative,10,21,31
362930,8,Very Positive,4663,460,5123
362940,7,Positive,13,1,14
362950,0,1 user reviews,1,0,1
362960,8,Very Positive,3735,643,4378
362980,0,4 user reviews,2,2,4
363020,4,Mostly Negative,10,21,31
363030,0,2 user reviews,2,0,2
363031,0,4 user reviews,3,1,4
363050,7,Positive,20,0,20
363060,0,6 user reviews,6,0,6
363070,0,8 user reviews,7,1,8
363090,0,8 user reviews,6,2,8
363110,0,9 user reviews,5,4,9
363130,5,Mixed,247,136,383
363150,5,Mixed,442,243,685
363180,0,6 user reviews,4,2,6
363200,0,3 user reviews,3,0,3
363220,0,6 user reviews,6,0,6
363240,7,Positive,18,3,21
363270,0,6 user reviews,3,3,6
363330,8,Very Positive,121,16,137
363350,0,3 user reviews,1,2,3
363351,0,3 user reviews,0,3,3
363360,6,Mostly Positive,484,191,675
363410,6,Mostly Positive,45,13,58
363420,8,Very Positive,132,8,140
363430,4,Mostly Negative,18,30,48
363440,8,Very Positive,1042,208,1250
363460,8,Very Positive,218,28,246
363490,4,Mostly Negative,68,112,180
363500,7,Positive,17,3,20
363510,4,Mostly Negative,14,28,42
363520,5,Mixed,37,30,67
363530,4,Mostly Negative,59,170,229
363580,0,3 user reviews,2,1,3
363600,6,Mostly Positive,484,175,659
363610,4,Mostly Negative,24,62,86
363620,6,Mostly Positive,41,14,55
363630,0,5 user reviews,4,1,5
363640,0,1 user reviews,1,0,1
363650,5,Mixed,11,16,27
363660,3,Negative,2,12,14
363670,0,4 user reviews,3,1,4
363680,5,Mixed,2036,992,3028
363790,6,Mostly Positive,145,37,182
363800,0,4 user reviews,3,1,4
363810,0,1 user reviews,1,0,1
363830,0,3 user reviews,2,1,3
363840,0,5 user reviews,4,1,5
363890,8,Very Positive,1635,155,1790
363900,0,6 user reviews,4,2,6
363920,0,2 user reviews,2,0,2
363930,8,Very Positive,1371,291,1662
363940,3,Negative,2,10,12
363950,5,Mixed,51,22,73
363960,4,Mostly Negative,5,9,14
363970,8,Very Positive,302,39,341
363980,8,Very Positive,154,30,184
363990,6,Mostly Positive,25,10,35
364000,0,6 user reviews,3,3,6
364020,0,1 user reviews,0,1,1
364050,5,Mixed,104,89,193
364060,0,7 user reviews,5,2,7
364100,0,4 user reviews,4,0,4
364130,0,4 user reviews,3,1,4
364180,0,1 user reviews,0,1,1
364190,0,1 user reviews,1,0,1
364200,5,Mixed,20,12,32
364210,0,3 user reviews,3,0,3
364230,8,Very Positive,88,4,92
364240,5,Mixed,10,9,19
364250,7,Positive,21,1,22
364260,0,5 user reviews,4,1,5
364270,6,Mostly Positive,115,29,144
364300,5,Mixed,132,84,216
364320,5,Mixed,11,16,27
364321,7,Positive,10,2,12
364322,7,Positive,10,1,11
364323,5,Mixed,24,14,38
364324,6,Mostly Positive,63,26,89
364325,7,Positive,22,2,24
364326,0,5 user reviews,0,5,5
364327,0,5 user reviews,2,3,5
364328,5,Mixed,7,10,17
364329,7,Positive,10,2,12
364340,6,Mostly Positive,102,31,133
364350,5,Mixed,10,9,19
364360,8,Very Positive,12744,2846,15590
364370,5,Mixed,9,7,16
364380,5,Mixed,21,27,48
364390,8,Very Positive,306,25,331
364400,0,2 user reviews,2,0,2
364420,6,Mostly Positive,1382,369,1751
364480,0,8 user reviews,3,5,8
364510,8,Very Positive,78,6,84
364630,5,Mixed,77,41,118
364640,8,Very Positive,103,23,126
364660,0,2 user reviews,0,2,2
364670,0,5 user reviews,2,3,5
364690,4,Mostly Negative,35,57,92
364700,0,6 user reviews,5,1,6
364710,3,Negative,3,31,34
364720,0,8 user reviews,7,1,8
364740,7,Positive,9,2,11
364750,0,5 user reviews,4,1,5
364770,7,Positive,18,4,22
364790,0,8 user reviews,7,1,8
364800,7,Positive,20,1,21
364810,6,Mostly Positive,51,14,65
364820,5,Mixed,56,42,98
364830,0,9 user reviews,9,0,9
364840,6,Mostly Positive,19,5,24
364850,0,3 user reviews,1,2,3
364890,5,Mixed,16,13,29
364910,4,Mostly Negative,20,38,58
364930,8,Very Positive,291,8,299
364940,6,Mostly Positive,93,35,128
364970,5,Mixed,16,8,24
364980,0,9 user reviews,5,4,9
365020,5,Mixed,140,104,244
365050,0,5 user reviews,4,1,5
365060,0,6 user reviews,5,1,6
365070,0,6 user reviews,3,3,6
365080,0,8 user reviews,6,2,8
365090,0,3 user reviews,3,0,3
365110,5,Mixed,6,6,12
365120,5,Mixed,31,15,46
365140,0,7 user reviews,3,4,7
365150,0,4 user reviews,3,1,4
365160,8,Very Positive,791,157,948
365170,8,Very Positive,73,8,81
365190,8,Very Positive,63,15,78
365210,8,Very Positive,63,10,73
365240,5,Mixed,7,5,12
365260,8,Very Positive,82,11,93
365280,0,5 user reviews,2,3,5
365290,0,1 user reviews,1,0,1
365300,8,Very Positive,148,10,158
365310,5,Mixed,5,5,10
365320,6,Mostly Positive,46,19,65
365330,6,Mostly Positive,27,10,37
365340,6,Mostly Positive,12,4,16
365350,6,Mostly Positive,39,10,49
365360,8,Very Positive,6312,737,7049
365380,7,Positive,14,1,15
365400,0,1 user reviews,0,1,1
365420,4,Mostly Negative,5,17,22
365430,7,Positive,8,2,10
365440,5,Mixed,24,11,35
365450,8,Very Positive,4740,322,5062
365460,0,2 user reviews,0,2,2
365480,5,Mixed,24,13,37
365500,7,Positive,21,3,24
365510,0,5 user reviews,5,0,5
365520,0,4 user reviews,4,0,4
365530,0,5 user reviews,3,2,5
365540,0,2 user reviews,2,0,2
365560,5,Mixed,45,20,65
365580,8,Very Positive,50,2,52
365590,5,Mixed,14874,6595,21469
365620,4,Mostly Negative,7,17,24
365630,0,3 user reviews,2,1,3
365660,8,Very Positive,211,37,248
365670,8,Very Positive,78,3,81
365680,5,Mixed,9,6,15
365720,7,Positive,15,0,15
365730,0,6 user reviews,6,0,6
365750,4,Mostly Negative,3,12,15
365760,7,Positive,22,4,26
365770,8,Very Positive,199,43,242
365800,5,Mixed,14,20,34
365810,6,Mostly Positive,150,60,210
365820,6,Mostly Positive,33,9,42
365840,7,Positive,10,0,10
365850,6,Mostly Positive,14,5,19
365860,7,Positive,24,5,29
365870,7,Positive,35,4,39
365880,5,Mixed,44,23,67
365890,5,Mixed,62,31,93
365900,8,Very Positive,145,20,165
365940,7,Positive,10,0,10
365960,8,Very Positive,1094,186,1280
365970,0,2 user reviews,2,0,2
365980,0,8 user reviews,4,4,8
366000,6,Mostly Positive,92,38,130
366010,7,Positive,22,4,26
366050,0,2 user reviews,2,0,2
366060,6,Mostly Positive,7,3,10
366080,7,Positive,23,1,24
366090,8,Very Positive,2708,284,2992
366100,0,4 user reviews,4,0,4
366180,4,Mostly Negative,5,8,13
366190,0,1 user reviews,1,0,1
366210,6,Mostly Positive,12,4,16
366220,5,Mixed,844,369,1213
366230,7,Positive,18,4,22
366240,8,Very Positive,323,14,337
366250,8,Very Positive,381,57,438
366260,8,Very Positive,68,14,82
366270,7,Positive,22,5,27
366280,6,Mostly Positive,29,9,38
366290,5,Mixed,42,31,73
366320,8,Very Positive,690,148,838
366330,0,3 user reviews,2,1,3
366331,0,5 user reviews,3,2,5
366350,0,3 user reviews,3,0,3
366380,7,Positive,17,2,19
366400,6,Mostly Positive,21,9,30
366410,0,5 user reviews,5,0,5
366420,7,Positive,31,0,31
366440,5,Mixed,357,355,712
366460,0,6 user reviews,4,2,6
366510,6,Mostly Positive,38,14,52
366550,7,Positive,13,1,14
366570,0,2 user reviews,2,0,2
366590,7,Positive,22,2,24
366600,0,1 user reviews,1,0,1
366610,0,5 user reviews,1,4,5
366620,0,8 user reviews,5,3,8
366640,5,Mixed,73,35,108
366650,5,Mixed,10,13,23
366660,5,Mixed,163,207,370
366670,5,Mixed,9,4,13
366690,8,Very Positive,81,16,97
366700,0,4 user reviews,1,3,4
366730,0,1 user reviews,1,0,1
366760,0,6 user reviews,4,2,6
366780,7,Positive,18,0,18
366800,0,2 user reviews,2,0,2
366810,5,Mixed,24,13,37
366843,6,Mostly Positive,302,126,428
366844,8,Very Positive,178,42,220
366845,6,Mostly Positive,68,25,93
366849,8,Very Positive,147,31,178
366870,6,Mostly Positive,264,94,358
366910,5,Mixed,224,199,423
366920,7,Positive,16,0,16
366960,0,5 user reviews,2,3,5
366970,8,Very Positive,144,11,155
366990,0,5 user reviews,5,0,5
367000,8,Very Positive,108,13,121
367010,5,Mixed,14,16,30
367020,8,Very Positive,107,20,127
367030,5,Mixed,17,8,25
367040,0,4 user reviews,1,3,4
367050,0,6 user reviews,6,0,6
367060,0,8 user reviews,6,2,8
367080,6,Mostly Positive,69,22,91
367090,0,6 user reviews,6,0,6
367110,8,Very Positive,70,17,87
367120,7,Positive,16,1,17
367140,7,Positive,29,0,29
367180,0,1 user reviews,1,0,1
367210,0,6 user reviews,6,0,6
367220,0,4 user reviews,0,4,4
367240,0,6 user reviews,2,4,6
367250,0,2 user reviews,2,0,2
367260,6,Mostly Positive,15,5,20
367270,8,Very Positive,1464,312,1776
367290,0,1 user reviews,1,0,1
367300,7,Positive,30,0,30
367320,0,1 user reviews,1,0,1
367330,7,Positive,36,9,45
367340,4,Mostly Negative,6,17,23
367350,5,Mixed,9,4,13
367380,0,2 user reviews,1,1,2
367410,0,7 user reviews,7,0,7
367411,0,5 user reviews,2,3,5
367412,0,8 user reviews,8,0,8
367413,0,6 user reviews,6,0,6
367414,0,6 user reviews,5,1,6
367415,0,7 user reviews,7,0,7
367430,7,Positive,10,1,11
367450,8,Very Positive,3275,375,3650
367480,5,Mixed,85,44,129
367500,8,Very Positive,9183,1106,10289
367520,9,Overwhelmingly Positive,39372,1231,40603
367550,5,Mixed,24,13,37
367570,8,Very Positive,290,33,323
367580,9,Overwhelmingly Positive,3228,109,3337
367600,5,Mixed,264,184,448
367640,0,1 user reviews,1,0,1
367660,0,1 user reviews,0,1,1
367670,8,Very Positive,1009,103,1112
367680,6,Mostly Positive,49,15,64
367700,0,2 user reviews,1,1,2
367710,5,Mixed,33,27,60
367780,7,Positive,19,2,21
367800,0,3 user reviews,1,2,3
367820,0,9 user reviews,6,3,9
367850,8,Very Positive,50,2,52
367890,0,2 user reviews,2,0,2
367910,7,Positive,18,1,19
367930,0,5 user reviews,5,0,5
367950,7,Positive,13,1,14
367990,4,Mostly Negative,2,8,10
368000,6,Mostly Positive,67,26,93
368040,7,Positive,17,1,18
368050,7,Positive,31,6,37
368070,5,Mixed,1386,878,2264
368080,8,Very Positive,48,7,55
368140,6,Mostly Positive,27,7,34
368150,7,Positive,13,2,15
368160,8,Very Positive,97,2,99
368180,6,Mostly Positive,75,21,96
368190,0,9 user reviews,9,0,9
368220,5,Mixed,37,19,56
368230,8,Very Positive,2575,396,2971
368250,5,Mixed,11,5,16
368290,5,Mixed,8,5,13
368310,0,5 user reviews,3,2,5
368340,9,Overwhelmingly Positive,4786,236,5022
368360,6,Mostly Positive,2211,623,2834
368370,8,Very Positive,2945,366,3311
368390,9,Overwhelmingly Positive,643,30,673
368401,0,1 user reviews,1,0,1
368410,0,1 user reviews,1,0,1
368420,5,Mixed,219,95,314
368430,6,Mostly Positive,229,97,326
368450,5,Mixed,56,48,104
368470,5,Mixed,14,16,30
368500,6,Mostly Positive,3287,1125,4412
368550,0,1 user reviews,1,0,1
368570,8,Very Positive,54,8,62
368590,5,Mixed,102,57,159
368600,7,Positive,34,1,35
368610,8,Very Positive,223,14,237
368620,8,Very Positive,646,116,762
368640,5,Mixed,58,35,93
368650,8,Very Positive,239,19,258
368670,0,2 user reviews,2,0,2
368680,8,Very Positive,48,3,51
368690,0,8 user reviews,4,4,8
368700,7,Positive,8,2,10
368710,6,Mostly Positive,11,4,15
368720,5,Mixed,38,25,63
368730,8,Very Positive,507,125,632
368740,5,Mixed,49,30,79
368750,5,Mixed,22,19,41
368760,0,7 user reviews,3,4,7
368770,5,Mixed,5,5,10
368780,4,Mostly Negative,5,13,18
368790,4,Mostly Negative,13,31,44
368800,6,Mostly Positive,14,4,18
368820,0,1 user reviews,1,0,1
368830,7,Positive,26,2,28
368840,6,Mostly Positive,22,8,30
368860,4,Mostly Negative,181,415,596
368870,8,Very Positive,193,30,223
368880,0,5 user reviews,1,4,5
368890,7,Positive,44,5,49
368920,0,9 user reviews,9,0,9
368930,0,1 user reviews,0,1,1
368950,0,7 user reviews,7,0,7
368960,5,Mixed,20,10,30
368970,0,5 user reviews,3,2,5
368980,5,Mixed,15,8,23
368990,4,Mostly Negative,279,543,822
369000,5,Mixed,126,55,181
369030,0,2 user reviews,1,1,2
369040,3,Negative,1,9,10
369050,0,4 user reviews,4,0,4
369060,0,3 user reviews,3,0,3
369070,5,Mixed,479,219,698
369080,3,Negative,3,30,33
369100,0,8 user reviews,4,4,8
369110,5,Mixed,206,125,331
369120,0,7 user reviews,4,3,7
369150,8,Very Positive,263,51,314
369180,5,Mixed,13,11,24
369190,5,Mixed,10,8,18
369230,5,Mixed,22,12,34
369270,7,Positive,15,2,17
369280,5,Mixed,10,5,15
369290,6,Mostly Positive,100,33,133
369310,7,Positive,11,0,11
369340,0,4 user reviews,4,0,4
369360,0,2 user reviews,1,1,2
369370,5,Mixed,12,16,28
369390,6,Mostly Positive,64,22,86
369400,0,8 user reviews,6,2,8
369420,8,Very Positive,118,16,134
369440,5,Mixed,176,88,264
369450,0,1 user reviews,0,1,1
369460,0,3 user reviews,0,3,3
369470,0,5 user reviews,3,2,5
369490,0,2 user reviews,2,0,2
369530,8,Very Positive,343,56,399
369550,8,Very Positive,56,14,70
369560,6,Mostly Positive,25,7,32
369570,5,Mixed,14,7,21
369580,8,Very Positive,1331,154,1485
369610,0,4 user reviews,2,2,4
369620,0,8 user reviews,8,0,8
369640,5,Mixed,5,5,10
369650,0,9 user reviews,5,4,9
369660,0,4 user reviews,3,1,4
369670,0,1 user reviews,1,0,1
369700,6,Mostly Positive,12,4,16
369720,4,Mostly Negative,9,18,27
369763,0,2 user reviews,2,0,2
369764,0,1 user reviews,1,0,1
369766,0,1 user reviews,1,0,1
369767,0,6 user reviews,5,1,6
369770,0,1 user reviews,1,0,1
369771,0,1 user reviews,1,0,1
369772,0,1 user reviews,1,0,1
369773,0,1 user reviews,1,0,1
369776,0,2 user reviews,2,0,2
369777,0,1 user reviews,1,0,1
369781,0,1 user reviews,1,0,1
369782,0,3 user reviews,2,1,3
369783,0,1 user reviews,1,0,1
369787,0,2 user reviews,1,1,2
369789,0,1 user reviews,1,0,1
369793,0,2 user reviews,2,0,2
369796,0,2 user reviews,2,0,2
369802,0,3 user reviews,3,0,3
369804,0,2 user reviews,2,0,2
369805,0,1 user reviews,1,0,1
369809,0,1 user reviews,1,0,1
369811,0,1 user reviews,1,0,1
369816,0,2 user reviews,2,0,2
369822,0,1 user reviews,0,1,1
369823,0,1 user reviews,1,0,1
369826,0,3 user reviews,1,2,3
369827,0,1 user reviews,1,0,1
369828,0,1 user reviews,1,0,1
369830,8,Very Positive,90,3,93
369860,0,3 user reviews,1,2,3
369890,6,Mostly Positive,45,17,62
369990,8,Very Positive,734,158,892
370001,8,Very Positive,51,2,53
370002,8,Very Positive,58,2,60
370003,7,Positive,20,0,20
370020,9,Overwhelmingly Positive,618,30,648
370040,7,Positive,12,1,13
370050,7,Positive,17,0,17
370060,8,Very Positive,245,46,291
370070,6,Mostly Positive,19,5,24
370080,7,Positive,16,1,17
370090,6,Mostly Positive,48,20,68
370120,0,6 user reviews,6,0,6
370130,0,4 user reviews,2,2,4
370140,0,2 user reviews,1,1,2
370150,8,Very Positive,79,3,82
370160,5,Mixed,16,15,31
370170,0,4 user reviews,3,1,4
370190,5,Mixed,5,5,10
370200,0,2 user reviews,2,0,2
370210,0,9 user reviews,8,1,9
370220,0,5 user reviews,1,4,5
370230,0,2 user reviews,1,1,2
370240,5,Mixed,906,926,1832
370250,6,Mostly Positive,19,7,26
370270,5,Mixed,11,5,16
370280,8,Very Positive,118,9,127
370300,7,Positive,20,0,20
370310,0,1 user reviews,1,0,1
370340,7,Positive,9,2,11
370341,7,Positive,9,2,11
370350,4,Mostly Negative,18,41,59
370360,9,Overwhelmingly Positive,1842,47,1889
370390,5,Mixed,14,9,23
370400,0,4 user reviews,2,2,4
370401,0,1 user reviews,1,0,1
370402,0,1 user reviews,1,0,1
370440,5,Mixed,17,9,26
370460,8,Very Positive,117,20,137
370480,7,Positive,37,7,44
370490,7,Positive,15,0,15
370500,0,1 user reviews,1,0,1
370510,5,Mixed,184,132,316
370540,8,Very Positive,179,15,194
370550,7,Positive,21,3,24
370560,0,9 user reviews,5,4,9
370570,7,Positive,11,2,13
370590,5,Mixed,7,7,14
370600,5,Mixed,10,5,15
370620,0,9 user reviews,5,4,9
370640,5,Mixed,7,7,14
370650,0,6 user reviews,6,0,6
370660,6,Mostly Positive,11,4,15
370670,7,Positive,27,3,30
370690,0,7 user reviews,5,2,7
370700,5,Mixed,17,10,27
370710,6,Mostly Positive,28,9,37
370730,0,4 user reviews,1,3,4
370770,7,Positive,10,0,10
370780,4,Mostly Negative,5,8,13
370800,5,Mixed,9,5,14
370810,0,6 user reviews,5,1,6
370840,5,Mixed,38,25,63
370870,6,Mostly Positive,109,36,145
370910,8,Very Positive,849,59,908
370920,7,Positive,33,0,33
370940,7,Positive,12,2,14
370970,0,1 user reviews,1,0,1
371000,7,Positive,8,2,10
371010,5,Mixed,92,43,135
371100,8,Very Positive,90,22,112
371110,0,2 user reviews,1,1,2
371120,5,Mixed,14,14,28
371140,6,Mostly Positive,51,18,69
371180,8,Very Positive,305,20,325
371190,8,Very Positive,71,14,85
371200,6,Mostly Positive,681,178,859
371220,5,Mixed,29,23,52
371230,6,Mostly Positive,17,5,22
371240,7,Positive,16,3,19
371250,0,3 user reviews,0,3,3
371260,0,9 user reviews,4,5,9
371270,6,Mostly Positive,50,16,66
371280,5,Mixed,4,6,10
371290,0,5 user reviews,3,2,5
371300,6,Mostly Positive,71,19,90
371310,0,1 user reviews,1,0,1
371320,7,Positive,11,2,13
371330,6,Mostly Positive,60,17,77
371360,3,Negative,2,13,15
371370,0,5 user reviews,3,2,5
371380,0,3 user reviews,3,0,3
371390,0,1 user reviews,1,0,1
371400,0,5 user reviews,3,2,5
371410,0,3 user reviews,0,3,3
371420,6,Mostly Positive,195,66,261
371430,7,Positive,28,5,33
371450,6,Mostly Positive,79,27,106
371460,5,Mixed,16,7,23
371500,8,Very Positive,163,21,184
371510,4,Mostly Negative,19,33,52
371520,6,Mostly Positive,277,118,395
371530,7,Positive,12,1,13
371550,8,Very Positive,93,21,114
371570,5,Mixed,99,57,156
371600,0,1 user reviews,1,0,1
371620,0,1 user reviews,0,1,1
371650,6,Mostly Positive,47,17,64
371660,8,Very Positive,5150,1151,6301
371670,4,Mostly Negative,86,142,228
371690,0,9 user reviews,6,3,9
371710,4,Mostly Negative,7,19,26
371740,0,1 user reviews,0,1,1
371790,0,2 user reviews,1,1,2
371810,0,6 user reviews,1,5,6
371850,6,Mostly Positive,19,6,25
371880,0,6 user reviews,4,2,6
371890,0,3 user reviews,2,1,3
371900,0,7 user reviews,6,1,7
371930,0,1 user reviews,1,0,1
371970,8,Very Positive,1282,117,1399
372000,5,Mixed,1843,1281,3124
372020,0,3 user reviews,3,0,3
372030,7,Positive,14,0,14
372060,5,Mixed,15,11,26
372080,7,Positive,19,4,23
372110,0,9 user reviews,8,1,9
372112,0,6 user reviews,4,2,6
372140,0,2 user reviews,2,0,2
372150,0,2 user reviews,2,0,2
372160,0,9 user reviews,2,7,9
372170,0,1 user reviews,1,0,1
372200,0,4 user reviews,3,1,4
372210,8,Very Positive,162,20,182
372250,5,Mixed,13,6,19
372260,7,Positive,27,0,27
372280,0,1 user reviews,1,0,1
372320,7,Positive,11,1,12
372330,6,Mostly Positive,36,12,48
372350,8,Very Positive,82,10,92
372360,8,Very Positive,1472,300,1772
372380,6,Mostly Positive,18,7,25
372390,6,Mostly Positive,158,44,202
372430,0,5 user reviews,1,4,5
372440,0,2 user reviews,0,2,2
372470,0,1 user reviews,1,0,1
372480,5,Mixed,8,10,18
372490,0,2 user reviews,0,2,2
372500,0,2 user reviews,2,0,2
372510,0,2 user reviews,1,1,2
372540,0,9 user reviews,4,5,9
372550,0,1 user reviews,1,0,1
372560,0,3 user reviews,2,1,3
372570,0,8 user reviews,4,4,8
372590,7,Positive,41,3,44
372660,0,3 user reviews,3,0,3
372670,0,2 user reviews,1,1,2
372690,8,Very Positive,117,24,141
372710,5,Mixed,7,5,12
372720,5,Mixed,7,5,12
372740,4,Mostly Negative,6,13,19
372750,5,Mixed,32,36,68
372770,0,6 user reviews,4,2,6
372780,4,Mostly Negative,9,14,23
372800,7,Positive,35,8,43
372810,0,1 user reviews,1,0,1
372820,0,3 user reviews,2,1,3
372830,7,Positive,40,9,49
372870,0,1 user reviews,1,0,1
372890,0,2 user reviews,0,2,2
372930,8,Very Positive,67,5,72
372940,8,Very Positive,93,3,96
372950,0,6 user reviews,5,1,6
372960,7,Positive,23,1,24
372970,6,Mostly Positive,19,7,26
372980,0,1 user reviews,0,1,1
373000,0,2 user reviews,1,1,2
373020,6,Mostly Positive,31,9,40
373080,3,Negative,6,32,38
373090,0,2 user reviews,2,0,2
373120,0,3 user reviews,3,0,3
373140,0,6 user reviews,5,1,6
373150,5,Mixed,30,17,47
373170,0,3 user reviews,2,1,3
373171,0,4 user reviews,2,2,4
373180,8,Very Positive,1085,122,1207
373200,0,1 user reviews,1,0,1
373240,5,Mixed,43,27,70
373280,4,Mostly Negative,4,12,16
373290,5,Mixed,23,24,47
373330,0,6 user reviews,2,4,6
373340,8,Very Positive,85,21,106
373360,5,Mixed,21,10,31
373370,5,Mixed,106,142,248
373380,5,Mixed,11,7,18
373390,9,Overwhelmingly Positive,1564,73,1637
373400,7,Positive,12,1,13
373420,8,Very Positive,5683,829,6512
373440,5,Mixed,27,12,39
373460,0,7 user reviews,4,3,7
373480,7,Positive,14,1,15
373490,5,Mixed,11,9,20
373491,0,4 user reviews,3,1,4
373590,0,9 user reviews,5,4,9
373600,7,Positive,16,3,19
373610,7,Positive,40,7,47
373620,7,Positive,18,3,21
373630,7,Positive,13,2,15
373640,0,2 user reviews,2,0,2
373650,6,Mostly Positive,63,25,88
373670,0,1 user reviews,1,0,1
373690,0,3 user reviews,3,0,3
373730,5,Mixed,18,20,38
373740,8,Very Positive,53,11,64
373750,8,Very Positive,105,8,113
373770,9,Overwhelmingly Positive,1486,40,1526
373780,0,1 user reviews,1,0,1
373800,0,8 user reviews,5,3,8
373810,5,Mixed,5,5,10
373820,0,4 user reviews,3,1,4
373860,0,8 user reviews,3,5,8
373870,0,6 user reviews,2,4,6
373880,0,6 user reviews,2,4,6
373890,0,4 user reviews,2,2,4
373920,5,Mixed,94,85,179
373930,6,Mostly Positive,708,238,946
373940,5,Mixed,15,21,36
373950,7,Positive,26,0,26
373951,7,Positive,21,1,22
373960,0,5 user reviews,0,5,5
373970,8,Very Positive,162,9,171
373980,5,Mixed,10,13,23
373990,6,Mostly Positive,9,3,12
374010,5,Mixed,23,11,34
374030,5,Mixed,596,354,950
374040,8,Very Positive,3012,710,3722
374050,5,Mixed,11,9,20
374060,5,Mixed,81,40,121
374080,0,4 user reviews,3,1,4
374100,0,1 user reviews,1,0,1
374120,0,5 user reviews,0,5,5
374150,6,Mostly Positive,12,4,16
374160,0,1 user reviews,1,0,1
374170,5,Mixed,10,5,15
374240,5,Mixed,7,6,13
374250,0,1 user reviews,1,0,1
374280,5,Mixed,250,178,428
374300,6,Mostly Positive,242,94,336
374301,8,Very Positive,364,72,436
374320,8,Very Positive,48415,4070,52485
374380,6,Mostly Positive,33,13,46
374390,7,Positive,26,6,32
374400,6,Mostly Positive,79,23,102
374410,8,Very Positive,66,4,70
374420,0,1 user reviews,1,0,1
374430,0,1 user reviews,1,0,1
374450,5,Mixed,10,5,15
374460,7,Positive,11,2,13
374500,7,Positive,31,7,38
374510,4,Mostly Negative,6,10,16
374520,5,Mixed,18,26,44
374570,7,Positive,40,0,40
374620,0,5 user reviews,2,3,5
374630,0,4 user reviews,4,0,4
374640,4,Mostly Negative,10,37,47
374660,0,1 user reviews,1,0,1
374670,7,Positive,16,2,18
374680,0,3 user reviews,3,0,3
374690,0,8 user reviews,1,7,8
374770,0,2 user reviews,2,0,2
374800,0,1 user reviews,1,0,1
374810,0,1 user reviews,1,0,1
374830,7,Positive,36,0,36
374850,7,Positive,8,2,10
374851,6,Mostly Positive,48,13,61
374871,0,3 user reviews,1,2,3
374880,0,4 user reviews,4,0,4
374900,6,Mostly Positive,280,82,362
374940,0,3 user reviews,3,0,3
374950,4,Mostly Negative,19,29,48
374960,0,4 user reviews,3,1,4
374970,0,3 user reviews,0,3,3
374990,0,6 user reviews,3,3,6
375000,0,5 user reviews,3,2,5
375010,0,6 user reviews,4,2,6
375020,5,Mixed,6,4,10
375030,6,Mostly Positive,21,9,30
375040,5,Mixed,15,7,22
375090,6,Mostly Positive,9,3,12
375120,8,Very Positive,110,23,133
375130,8,Very Positive,231,9,240
375160,0,1 user reviews,1,0,1
375170,7,Positive,10,1,11
375180,5,Mixed,98,63,161
375190,5,Mixed,9,4,13
375200,8,Very Positive,389,40,429
375210,7,Positive,27,5,32
375220,0,1 user reviews,1,0,1
375230,5,Mixed,1271,1199,2470
375250,8,Very Positive,94,8,102
375290,0,7 user reviews,6,1,7
375310,7,Positive,32,3,35
375320,5,Mixed,22,19,41
375330,5,Mixed,14,10,24
375420,0,4 user reviews,3,1,4
375430,0,3 user reviews,2,1,3
375440,8,Very Positive,170,17,187
375450,6,Mostly Positive,62,16,78
375460,4,Mostly Negative,52,142,194
375480,9,Overwhelmingly Positive,1600,59,1659
375500,5,Mixed,45,22,67
375510,5,Mixed,187,245,432
375520,6,Mostly Positive,25,10,35
375530,8,Very Positive,865,83,948
375550,0,3 user reviews,3,0,3
375580,0,6 user reviews,4,2,6
375600,6,Mostly Positive,223,81,304
375680,5,Mixed,22,27,49
375710,6,Mostly Positive,63,17,80
375720,0,1 user reviews,0,1,1
375750,8,Very Positive,166,18,184
375760,0,6 user reviews,4,2,6
375770,6,Mostly Positive,11,4,15
375790,6,Mostly Positive,11,3,14
375810,0,6 user reviews,3,3,6
375820,8,Very Positive,876,70,946
375840,8,Very Positive,135,26,161
375850,5,Mixed,5,7,12
375870,0,2 user reviews,2,0,2
375890,0,2 user reviews,2,0,2
375900,5,Mixed,374,229,603
375910,5,Mixed,1358,657,2015
375930,6,Mostly Positive,10,3,13
375950,8,Very Positive,89,9,98
375960,5,Mixed,139,188,327
375980,0,1 user reviews,0,1,1
376110,5,Mixed,14,14,28
376120,4,Mostly Negative,3,12,15
376130,5,Mixed,20,16,36
376150,4,Mostly Negative,7,11,18
376160,0,1 user reviews,1,0,1
376190,0,1 user reviews,1,0,1
376200,7,Positive,43,0,43
376210,8,Very Positive,12811,3202,16013
376230,0,1 user reviews,0,1,1
376240,7,Positive,25,1,26
376250,5,Mixed,13,9,22
376300,8,Very Positive,775,58,833
376310,4,Mostly Negative,69,117,186
376320,0,2 user reviews,2,0,2
376350,0,3 user reviews,1,2,3
376360,0,2 user reviews,0,2,2
376370,7,Positive,11,0,11
376371,0,2 user reviews,2,0,2
376372,0,6 user reviews,6,0,6
376373,0,1 user reviews,1,0,1
376390,7,Positive,35,0,35
376391,7,Positive,44,3,47
376410,5,Mixed,13,13,26
376450,5,Mixed,10,12,22
376480,0,4 user reviews,0,4,4
376490,6,Mostly Positive,11,4,15
376520,8,Very Positive,274,39,313
376560,0,3 user reviews,2,1,3
376570,6,Mostly Positive,59,21,80
376660,5,Mixed,32,15,47
376680,6,Mostly Positive,165,45,210
376700,7,Positive,21,4,25
376730,5,Mixed,46,36,82
376750,4,Mostly Negative,9,14,23
376760,7,Positive,16,4,20
376770,7,Positive,20,2,22
376780,5,Mixed,9,4,13
376790,6,Mostly Positive,12,4,16
376870,6,Mostly Positive,2428,966,3394
376880,5,Mixed,21,19,40
376920,6,Mostly Positive,60,17,77
376930,6,Mostly Positive,26,8,34
376931,7,Positive,20,0,20
376932,7,Positive,35,5,40
376933,4,Mostly Negative,8,15,23
376934,7,Positive,11,1,12
376935,5,Mixed,6,4,10
376936,4,Mostly Negative,4,12,16
376938,6,Mostly Positive,33,12,45
376942,7,Positive,26,0,26
376943,7,Positive,15,2,17
376944,6,Mostly Positive,14,5,19
376945,0,6 user reviews,5,1,6
376946,7,Positive,33,6,39
376949,0,6 user reviews,4,2,6
376950,7,Positive,13,3,16
376951,7,Positive,13,1,14
376952,0,7 user reviews,7,0,7
376953,6,Mostly Positive,13,4,17
376954,0,6 user reviews,2,4,6
376955,0,9 user reviews,3,6,9
376956,0,3 user reviews,3,0,3
376957,0,4 user reviews,3,1,4
376958,0,4 user reviews,3,1,4
376959,7,Positive,31,6,37
376960,0,4 user reviews,4,0,4
376961,7,Positive,29,2,31
376963,7,Positive,12,1,13
376964,0,7 user reviews,5,2,7
376965,7,Positive,11,0,11
376966,7,Positive,21,2,23
376967,0,9 user reviews,3,6,9
376969,0,5 user reviews,4,1,5
376970,7,Positive,29,2,31
376971,0,7 user reviews,4,3,7
376972,4,Mostly Negative,4,8,12
376975,5,Mixed,13,14,27
376976,0,4 user reviews,3,1,4
376977,0,5 user reviews,5,0,5
376979,7,Positive,32,1,33
376980,8,Very Positive,46,4,50
376990,0,2 user reviews,2,0,2
377000,0,1 user reviews,0,1,1
377030,0,3 user reviews,2,1,3
377060,5,Mixed,126,66,192
377070,7,Positive,20,4,24
377080,8,Very Positive,228,11,239
377100,0,2 user reviews,2,0,2
377120,5,Mixed,31,21,52
377140,5,Mixed,129,121,250
377150,6,Mostly Positive,11,4,15
377160,6,Mostly Positive,63204,19917,83121
377170,0,2 user reviews,2,0,2
377190,7,Positive,16,1,17
377200,0,6 user reviews,3,3,6
377250,0,2 user reviews,2,0,2
377280,5,Mixed,12,9,21
377290,4,Mostly Negative,16,30,46
377310,5,Mixed,14,8,22
377320,7,Positive,17,3,20
377330,8,Very Positive,75,2,77
377340,0,1 user reviews,1,0,1
377350,0,4 user reviews,1,3,4
377360,6,Mostly Positive,19,7,26
377420,7,Positive,10,0,10
377430,0,4 user reviews,4,0,4
377440,0,2 user reviews,2,0,2
377450,8,Very Positive,59,1,60
377460,8,Very Positive,77,3,80
377470,5,Mixed,30,21,51
377480,5,Mixed,27,22,49
377500,6,Mostly Positive,12,4,16
377520,6,Mostly Positive,113,32,145
377530,8,Very Positive,372,70,442
377550,5,Mixed,5,5,10
377560,6,Mostly Positive,21,8,29
377570,6,Mostly Positive,9,3,12
377600,8,Very Positive,87,13,100
377640,0,1 user reviews,1,0,1
377660,8,Very Positive,63,1,64
377670,8,Very Positive,197,12,209
377680,8,Very Positive,288,69,357
377690,8,Very Positive,128,9,137
377710,7,Positive,46,2,48
377720,7,Positive,19,1,20
377730,0,2 user reviews,2,0,2
377760,8,Very Positive,81,10,91
377840,8,Very Positive,2820,220,3040
377860,8,Very Positive,432,9,441
377870,8,Very Positive,161,31,192
377880,8,Very Positive,74,8,82
377890,0,7 user reviews,5,2,7
377900,6,Mostly Positive,294,112,406
377940,6,Mostly Positive,10,3,13
377950,8,Very Positive,59,6,65
377970,5,Mixed,105,54,159
377980,5,Mixed,6,8,14
378030,7,Positive,32,7,39
378040,5,Mixed,33,23,56
378041,6,Mostly Positive,16,5,21
378061,0,1 user reviews,1,0,1
378070,5,Mixed,9,6,15
378080,7,Positive,32,8,40
378090,5,Mixed,7,4,11
378100,5,Mixed,8,10,18
378110,8,Very Positive,73,17,90
378120,6,Mostly Positive,785,318,1103
378240,0,6 user reviews,3,3,6
378260,5,Mixed,43,19,62
378270,5,Mixed,91,41,132
378280,5,Mixed,8,7,15
378300,0,1 user reviews,1,0,1
378350,0,9 user reviews,7,2,9
378360,6,Mostly Positive,216,91,307
378370,5,Mixed,132,62,194
378400,0,1 user reviews,1,0,1
378410,7,Positive,12,1,13
378420,2,Very Negative,1,52,53
378450,0,2 user reviews,1,1,2
378460,0,2 user reviews,1,1,2
378461,0,4 user reviews,0,4,4
378470,0,1 user reviews,1,0,1
378471,0,1 user reviews,1,0,1
378472,0,4 user reviews,2,2,4
378473,0,3 user reviews,1,2,3
378474,0,3 user reviews,3,0,3
378475,0,3 user reviews,3,0,3
378478,0,1 user reviews,1,0,1
378480,0,9 user reviews,5,4,9
378490,5,Mixed,17,12,29
378504,7,Positive,10,1,11
378505,0,5 user reviews,4,1,5
378510,0,4 user reviews,3,1,4
378530,6,Mostly Positive,19,6,25
378540,6,Mostly Positive,2033,633,2666
378550,0,5 user reviews,3,2,5
378551,0,2 user reviews,0,2,2
378552,0,1 user reviews,1,0,1
378570,0,9 user reviews,6,3,9
378580,5,Mixed,61,32,93
378590,0,4 user reviews,1,3,4
378610,8,Very Positive,3251,327,3578
378620,0,1 user reviews,1,0,1
378630,6,Mostly Positive,14,4,18
378642,7,Positive,22,0,22
378643,7,Positive,24,1,25
378644,7,Positive,29,3,32
378645,7,Positive,33,0,33
378646,8,Very Positive,169,5,174
378647,7,Positive,28,4,32
378648,9,Overwhelmingly Positive,2716,31,2747
378649,9,Overwhelmingly Positive,1749,52,1801
378660,5,Mixed,265,212,477
378700,5,Mixed,16,8,24
378710,0,8 user reviews,8,0,8
378720,8,Very Positive,1712,175,1887
378730,0,8 user reviews,6,2,8
378731,7,Positive,36,3,39
378750,8,Very Positive,61,2,63
378770,8,Very Positive,62,4,66
378790,7,Positive,10,1,11
378800,5,Mixed,69,54,123
378810,7,Positive,17,4,21
378830,5,Mixed,7,10,17
378850,5,Mixed,6,4,10
378860,6,Mostly Positive,3224,914,4138
378910,0,1 user reviews,1,0,1
378950,7,Positive,24,0,24
379190,0,6 user reviews,6,0,6
379210,8,Very Positive,438,78,516
379230,5,Mixed,7,7,14
379232,0,6 user reviews,6,0,6
379233,5,Mixed,10,15,25
379235,5,Mixed,10,8,18
379240,0,6 user reviews,4,2,6
379241,5,Mixed,5,6,11
379242,5,Mixed,8,4,12
379243,5,Mixed,11,8,19
379260,0,7 user reviews,2,5,7
379290,5,Mixed,5,6,11
379310,8,Very Positive,392,66,458
379320,6,Mostly Positive,24,8,32
379340,0,8 user reviews,5,3,8
379350,0,9 user reviews,6,3,9
379370,5,Mixed,9,6,15
379380,0,7 user reviews,3,4,7
379390,6,Mostly Positive,10,3,13
379400,0,8 user reviews,6,2,8
379420,8,Very Positive,83,19,102
379430,6,Mostly Positive,18984,4893,23877
379520,7,Positive,15,0,15
379530,6,Mostly Positive,60,17,77
379541,7,Positive,12,3,15
379542,5,Mixed,77,60,137
379543,0,4 user reviews,3,1,4
379544,5,Mixed,6,4,10
379545,0,9 user reviews,5,4,9
379546,6,Mostly Positive,43,11,54
379547,5,Mixed,12,7,19
379548,7,Positive,15,2,17
379549,0,1 user reviews,1,0,1
379550,0,1 user reviews,1,0,1
379551,5,Mixed,9,4,13
379552,0,6 user reviews,5,1,6
379553,0,6 user reviews,5,1,6
379554,5,Mixed,21,11,32
379555,0,5 user reviews,2,3,5
379556,0,7 user reviews,4,3,7
379557,5,Mixed,11,5,16
379558,5,Mixed,14,17,31
379559,5,Mixed,5,5,10
379560,6,Mostly Positive,77,24,101
379561,5,Mixed,16,7,23
379562,0,9 user reviews,3,6,9
379563,5,Mixed,10,11,21
379564,0,9 user reviews,7,2,9
379565,5,Mixed,18,16,34
379566,7,Positive,21,4,25
379567,5,Mixed,13,15,28
379568,6,Mostly Positive,26,10,36
379570,0,1 user reviews,1,0,1
379572,0,6 user reviews,5,1,6
379575,5,Mixed,12,13,25
379576,0,2 user reviews,0,2,2
379577,0,6 user reviews,5,1,6
379578,0,5 user reviews,5,0,5
379579,0,4 user reviews,3,1,4
379582,0,4 user reviews,3,1,4
379583,5,Mixed,6,5,11
379584,6,Mostly Positive,24,10,34
379585,0,3 user reviews,1,2,3
379586,0,8 user reviews,5,3,8
379587,0,3 user reviews,3,0,3
379590,0,1 user reviews,1,0,1
379600,5,Mixed,22,11,33
379610,7,Positive,21,1,22
379640,7,Positive,23,2,25
379670,7,Positive,17,3,20
379720,8,Very Positive,47500,2514,50014
379730,0,1 user reviews,1,0,1
379750,0,1 user reviews,1,0,1
379760,7,Positive,23,3,26
379870,0,4 user reviews,4,0,4
379960,5,Mixed,51,26,77
379970,0,1 user reviews,0,1,1
379980,8,Very Positive,936,85,1021
379990,4,Mostly Negative,3,9,12
380000,5,Mixed,5,6,11
380020,5,Mixed,55,74,129
380080,5,Mixed,18,11,29
380100,0,6 user reviews,6,0,6
380120,0,5 user reviews,4,1,5
380130,0,1 user reviews,0,1,1
380140,0,3 user reviews,3,0,3
380150,6,Mostly Positive,390,111,501
380210,0,7 user reviews,6,1,7
380220,5,Mixed,342,214,556
380230,6,Mostly Positive,37,12,49
380231,6,Mostly Positive,56,18,74
380232,0,3 user reviews,2,1,3
380360,0,8 user reviews,7,1,8
380540,5,Mixed,13,17,30
380550,5,Mixed,17,10,27
380560,0,7 user reviews,4,3,7
380570,5,Mixed,21,31,52
380580,5,Mixed,118,80,198
380600,5,Mixed,104,71,175
380660,8,Very Positive,79,16,95
380670,8,Very Positive,249,17,266
380690,0,7 user reviews,6,1,7
380700,5,Mixed,7,4,11
380710,0,5 user reviews,4,1,5
380740,0,7 user reviews,7,0,7
380750,5,Mixed,135,61,196
380790,0,4 user reviews,2,2,4
380800,0,4 user reviews,4,0,4
380810,8,Very Positive,66,3,69
380840,6,Mostly Positive,17,5,22
380850,0,4 user reviews,2,2,4
380860,7,Positive,14,2,16
380890,0,2 user reviews,1,1,2
380920,7,Positive,31,5,36
380950,0,3 user reviews,3,0,3
380970,0,1 user reviews,1,0,1
380990,4,Mostly Negative,9,16,25
381010,5,Mixed,17,9,26
381020,8,Very Positive,480,42,522
381050,6,Mostly Positive,25,9,34
381090,7,Positive,12,3,15
381100,6,Mostly Positive,114,40,154
381120,5,Mixed,949,511,1460
381130,5,Mixed,4,6,10
381140,5,Mixed,10,8,18
381150,0,1 user reviews,1,0,1
381151,6,Mostly Positive,18,6,24
381152,5,Mixed,7,7,14
381170,0,5 user reviews,3,2,5
381180,5,Mixed,92,125,217
381201,0,1 user reviews,1,0,1
381210,8,Very Positive,74972,16099,91071
381220,5,Mixed,15,20,35
381240,7,Positive,38,5,43
381250,0,3 user reviews,3,0,3
381260,5,Mixed,57,26,83
381310,6,Mostly Positive,9,3,12
381320,7,Positive,29,3,32
381340,0,7 user reviews,7,0,7
381550,0,3 user reviews,2,1,3
381560,0,3 user reviews,3,0,3
381590,5,Mixed,25,24,49
381610,7,Positive,12,1,13
381650,0,1 user reviews,1,0,1
381671,0,3 user reviews,2,1,3
381710,5,Mixed,12,8,20
381711,7,Positive,10,2,12
381712,7,Positive,10,2,12
381713,0,7 user reviews,6,1,7
381750,5,Mixed,91,55,146
381760,6,Mostly Positive,11,4,15
381780,8,Very Positive,591,38,629
381790,0,3 user reviews,3,0,3
381792,0,5 user reviews,4,1,5
381800,4,Mostly Negative,4,8,12
381840,5,Mixed,6,4,10
381850,5,Mixed,6,6,12
381870,7,Positive,40,3,43
381880,7,Positive,36,9,45
381890,7,Positive,43,1,44
381900,7,Positive,34,5,39
381910,0,8 user reviews,6,2,8
381940,6,Mostly Positive,21,7,28
381960,0,1 user reviews,1,0,1
381970,0,1 user reviews,0,1,1
381990,0,9 user reviews,6,3,9
382050,8,Very Positive,376,30,406
382060,0,1 user reviews,1,0,1
382070,7,Positive,29,7,36
382080,5,Mixed,21,14,35
382090,8,Very Positive,96,23,119
382110,6,Mostly Positive,764,302,1066
382120,0,2 user reviews,2,0,2
382130,5,Mixed,21,10,31
382140,5,Mixed,221,126,347
382151,0,1 user reviews,1,0,1
382160,0,9 user reviews,2,7,9
382170,0,2 user reviews,2,0,2
382180,6,Mostly Positive,24,10,34
382200,0,5 user reviews,4,1,5
382210,7,Positive,16,4,20
382250,6,Mostly Positive,17,6,23
382260,8,Very Positive,148,14,162
382270,0,9 user reviews,7,2,9
382300,5,Mixed,49,65,114
382310,6,Mostly Positive,1706,519,2225
382320,0,4 user reviews,4,0,4
382330,5,Mixed,41,53,94
382350,5,Mixed,38,35,73
382360,5,Mixed,100,70,170
382380,8,Very Positive,89,18,107
382390,0,1 user reviews,1,0,1
382400,5,Mixed,28,16,44
382410,5,Mixed,7,6,13
382420,5,Mixed,37,32,69
382460,0,5 user reviews,5,0,5
382462,7,Positive,19,0,19
382464,7,Positive,29,0,29
382466,7,Positive,14,0,14
382467,7,Positive,13,1,14
382468,7,Positive,30,1,31
382469,7,Positive,20,0,20
382470,4,Mostly Negative,13,24,37
382480,6,Mostly Positive,31,13,44
382490,7,Positive,33,5,38
382560,8,Very Positive,1264,85,1349
382620,7,Positive,10,0,10
382630,7,Positive,36,9,45
382640,7,Positive,11,0,11
382650,0,2 user reviews,2,0,2
382660,0,8 user reviews,4,4,8
382670,0,3 user reviews,3,0,3
382680,7,Positive,9,1,10
382700,0,4 user reviews,2,2,4
382710,7,Positive,17,0,17
382720,0,2 user reviews,2,0,2
382730,0,5 user reviews,4,1,5
382740,0,6 user reviews,5,1,6
382750,7,Positive,12,0,12
382760,7,Positive,12,0,12
382770,0,1 user reviews,1,0,1
382780,6,Mostly Positive,16,5,21
382790,0,3 user reviews,1,2,3
382800,0,4 user reviews,1,3,4
382850,5,Mixed,11,13,24
382870,0,2 user reviews,2,0,2
382880,4,Mostly Negative,5,8,13
382890,6,Mostly Positive,448,161,609
382900,6,Mostly Positive,882,243,1125
382910,5,Mixed,9,5,14
382920,5,Mixed,17,8,25
382950,0,6 user reviews,6,0,6
383010,0,3 user reviews,1,2,3
383070,5,Mixed,12,14,26
383080,8,Very Positive,112,25,137
383100,7,Positive,41,2,43
383110,0,1 user reviews,1,0,1
383120,8,Very Positive,9730,2213,11943
383130,0,4 user reviews,4,0,4
383150,6,Mostly Positive,2120,653,2773
383180,5,Mixed,473,230,703
383190,0,4 user reviews,4,0,4
383230,6,Mostly Positive,599,173,772
383240,0,3 user reviews,1,2,3
383270,8,Very Positive,310,22,332
383320,0,1 user reviews,1,0,1
383330,5,Mixed,17,18,35
383380,0,1 user reviews,1,0,1
383400,0,9 user reviews,6,3,9
383430,0,1 user reviews,1,0,1
383450,0,5 user reviews,4,1,5
383460,8,Very Positive,129,16,145
383510,0,2 user reviews,2,0,2
383520,6,Mostly Positive,8,3,11
383530,0,2 user reviews,1,1,2
383540,0,7 user reviews,7,0,7
383560,5,Mixed,15,18,33
383580,6,Mostly Positive,325,113,438
383590,0,7 user reviews,4,3,7
383620,4,Mostly Negative,4,12,16
383630,0,7 user reviews,5,2,7
383660,0,3 user reviews,1,2,3
383670,6,Mostly Positive,12,5,17
383680,0,1 user reviews,1,0,1
383690,8,Very Positive,80,15,95
383700,5,Mixed,12,7,19
383710,5,Mixed,8,5,13
383720,6,Mostly Positive,26,11,37
383730,7,Positive,29,6,35
383750,0,6 user reviews,5,1,6
383760,6,Mostly Positive,8,3,11
383780,0,6 user reviews,3,3,6
383790,5,Mixed,185,143,328
383800,5,Mixed,8,4,12
383810,0,2 user reviews,1,1,2
383840,8,Very Positive,608,121,729
383860,0,1 user reviews,1,0,1
383870,8,Very Positive,23602,4244,27846
383900,5,Mixed,26,34,60
383908,0,1 user reviews,1,0,1
383930,6,Mostly Positive,42,14,56
383940,0,4 user reviews,3,1,4
383950,5,Mixed,9,4,13
383960,8,Very Positive,53,13,66
383980,9,Overwhelmingly Positive,11045,566,11611
384000,6,Mostly Positive,44,17,61
384010,0,9 user reviews,4,5,9
384020,8,Very Positive,416,76,492
384021,6,Mostly Positive,303,83,386
384030,5,Mixed,6,6,12
384040,0,6 user reviews,5,1,6
384080,5,Mixed,50,39,89
384090,5,Mixed,22,22,44
384100,5,Mixed,6,5,11
384110,8,Very Positive,563,99,662
384120,5,Mixed,15,9,24
384140,0,3 user reviews,2,1,3
384150,7,Positive,35,5,40
384170,0,1 user reviews,1,0,1
384171,0,3 user reviews,3,0,3
384180,7,Positive,30,6,36
384190,8,Very Positive,6259,491,6750
384200,5,Mixed,19,9,28
384210,0,1 user reviews,0,1,1
384240,7,Positive,17,0,17
384250,7,Positive,12,1,13
384280,8,Very Positive,72,12,84
384300,6,Mostly Positive,2016,754,2770
384310,6,Mostly Positive,93,32,125
384330,0,8 user reviews,7,1,8
384360,6,Mostly Positive,384,144,528
384370,0,2 user reviews,2,0,2
384380,5,Mixed,11,5,16
384420,4,Mostly Negative,3,7,10
384480,7,Positive,35,5,40
384490,5,Mixed,1519,1002,2521
384500,6,Mostly Positive,145,55,200
384530,0,4 user reviews,4,0,4
384531,0,2 user reviews,0,2,2
384532,0,4 user reviews,4,0,4
384540,0,1 user reviews,0,1,1
384550,5,Mixed,136,69,205
384560,0,2 user reviews,2,0,2
384570,5,Mixed,93,70,163
384590,0,8 user reviews,8,0,8
384630,8,Very Positive,642,37,679
384650,0,1 user reviews,1,0,1
384660,0,3 user reviews,3,0,3
384680,8,Very Positive,113,16,129
384690,8,Very Positive,60,3,63
384700,7,Positive,15,3,18
384710,0,2 user reviews,2,0,2
384720,0,5 user reviews,5,0,5
384740,6,Mostly Positive,317,133,450
384750,5,Mixed,97,110,207
384840,4,Mostly Negative,9,22,31
384880,0,8 user reviews,1,7,8
384890,7,Positive,12,1,13
384900,0,2 user reviews,0,2,2
384910,6,Mostly Positive,13,5,18
384920,4,Mostly Negative,8,17,25
384930,0,6 user reviews,2,4,6
384940,0,4 user reviews,4,0,4
384950,6,Mostly Positive,8,3,11
384960,8,Very Positive,103,25,128
384970,0,4 user reviews,1,3,4
384980,0,3 user reviews,1,2,3
384990,8,Very Positive,48,11,59
385020,0,9 user reviews,3,6,9
385030,7,Positive,17,0,17
385060,7,Positive,27,2,29
385070,7,Positive,36,9,45
385080,4,Mostly Negative,6,21,27
385100,7,Positive,24,0,24
385120,7,Positive,11,0,11
385130,7,Positive,23,3,26
385150,6,Mostly Positive,17,6,23
385190,0,4 user reviews,0,4,4
385220,0,3 user reviews,2,1,3
385230,6,Mostly Positive,31,8,39
385240,8,Very Positive,479,76,555
385250,8,Very Positive,274,3,277
385270,6,Mostly Positive,31,13,44
385310,4,Mostly Negative,8,14,22
385330,8,Very Positive,313,25,338
385350,5,Mixed,8,5,13
385360,5,Mixed,29,16,45
385370,7,Positive,28,5,33
385380,6,Mostly Positive,506,149,655
385390,0,7 user reviews,2,5,7
385400,4,Mostly Negative,15,40,55
385410,0,4 user reviews,1,3,4
385420,0,8 user reviews,8,0,8
385440,6,Mostly Positive,18,5,23
385460,0,5 user reviews,2,3,5
385470,0,7 user reviews,1,6,7
385490,5,Mixed,5,5,10
385510,5,Mixed,17,8,25
385511,7,Positive,22,5,27
385520,7,Positive,31,1,32
385560,8,Very Positive,157,24,181
385580,0,8 user reviews,2,6,8
385590,8,Very Positive,60,10,70
385600,5,Mixed,14,14,28
385630,0,2 user reviews,1,1,2
385650,0,2 user reviews,1,1,2
385660,0,1 user reviews,0,1,1
385670,0,4 user reviews,4,0,4
385690,7,Positive,17,2,19
385700,4,Mostly Negative,7,15,22
385710,8,Very Positive,398,65,463
385721,7,Positive,14,1,15
385730,5,Mixed,558,428,986
385760,5,Mixed,989,821,1810
385770,7,Positive,26,5,31
385800,8,Very Positive,3686,241,3927
385810,0,3 user reviews,1,2,3
385830,5,Mixed,14,10,24
385840,7,Positive,10,0,10
385860,5,Mixed,7,5,12
385870,0,4 user reviews,4,0,4
385890,0,1 user reviews,0,1,1
385900,4,Mostly Negative,4,10,14
385930,0,3 user reviews,2,1,3
385940,0,3 user reviews,1,2,3
385950,5,Mixed,5,6,11
385960,3,Negative,1,12,13
385970,6,Mostly Positive,350,143,493
385980,0,6 user reviews,2,4,6
386050,6,Mostly Positive,19,7,26
386070,8,Very Positive,4201,751,4952
386080,6,Mostly Positive,71,19,90
386090,0,6 user reviews,5,1,6
386100,7,Positive,11,2,13
386110,0,5 user reviews,0,5,5
386140,6,Mostly Positive,12,4,16
386160,5,Mixed,25,12,37
386180,5,Mixed,317,180,497
386200,7,Positive,13,2,15
386260,6,Mostly Positive,322,95,417
386270,0,1 user reviews,1,0,1
386280,5,Mixed,36,49,85
386290,4,Mostly Negative,4,12,16
386320,4,Mostly Negative,3,10,13
386330,0,3 user reviews,2,1,3
386340,5,Mixed,35,19,54
386350,5,Mixed,15,10,25
386360,6,Mostly Positive,523,136,659
386400,6,Mostly Positive,22,7,29
386420,7,Positive,17,2,19
386480,5,Mixed,134,83,217
386490,6,Mostly Positive,24,10,34
386500,0,1 user reviews,1,0,1
386510,0,1 user reviews,1,0,1
386520,8,Very Positive,115,16,131
386540,3,Negative,2,9,11
386550,5,Mixed,7,9,16
386560,8,Very Positive,59,11,70
386570,0,1 user reviews,1,0,1
386590,5,Mixed,352,229,581
386600,0,4 user reviews,4,0,4
386620,8,Very Positive,1140,130,1270
386630,0,6 user reviews,3,3,6
386640,0,1 user reviews,1,0,1
386650,5,Mixed,40,52,92
386690,6,Mostly Positive,20,7,27
386700,6,Mostly Positive,75,25,100
386710,6,Mostly Positive,11,4,15
386740,6,Mostly Positive,24,7,31
386750,6,Mostly Positive,16,6,22
386760,0,2 user reviews,2,0,2
386770,6,Mostly Positive,54,20,74
386780,0,1 user reviews,0,1,1
386840,7,Positive,18,4,22
386870,5,Mixed,25,12,37
386880,5,Mixed,939,495,1434
386900,8,Very Positive,81,8,89
386930,4,Mostly Negative,28,45,73
386940,9,Overwhelmingly Positive,5091,167,5258
386960,0,5 user reviews,4,1,5
386970,7,Positive,29,1,30
386990,8,Very Positive,65,12,77
387010,6,Mostly Positive,46,17,63
387020,8,Very Positive,76,8,84
387050,0,3 user reviews,2,1,3
387060,8,Very Positive,46,7,53
387070,0,6 user reviews,1,5,6
387090,5,Mixed,14,16,30
387100,7,Positive,21,3,24
387110,0,2 user reviews,0,2,2
387120,0,1 user reviews,0,1,1
387130,0,3 user reviews,1,2,3
387170,0,1 user reviews,1,0,1
387240,7,Positive,26,3,29
387270,0,9 user reviews,6,3,9
387280,7,Positive,15,2,17
387290,9,Overwhelmingly Positive,15109,760,15869
387340,8,Very Positive,911,109,1020
387370,5,Mixed,175,87,262
387400,0,1 user reviews,1,0,1
387430,5,Mixed,20,9,29
387440,6,Mostly Positive,238,96,334
387470,7,Positive,13,0,13
387480,0,7 user reviews,7,0,7
387490,0,9 user reviews,8,1,9
387500,0,5 user reviews,0,5,5
387510,0,3 user reviews,2,1,3
387520,0,1 user reviews,1,0,1
387530,0,3 user reviews,2,1,3
387540,0,6 user reviews,6,0,6
387550,0,3 user reviews,3,0,3
387560,6,Mostly Positive,15,4,19
387570,0,3 user reviews,3,0,3
387590,0,2 user reviews,2,0,2
387600,0,2 user reviews,1,1,2
387610,0,4 user reviews,3,1,4
387620,7,Positive,10,0,10
387630,0,3 user reviews,3,0,3
387640,7,Positive,12,2,14
387650,0,3 user reviews,1,2,3
387660,7,Positive,14,0,14
387680,0,8 user reviews,7,1,8
387690,0,6 user reviews,6,0,6
387770,0,2 user reviews,2,0,2
387780,0,1 user reviews,1,0,1
387840,8,Very Positive,48,11,59
387850,7,Positive,26,4,30
387860,7,Positive,36,8,44
387870,6,Mostly Positive,30,11,41
387880,5,Mixed,9,6,15
387890,0,1 user reviews,0,1,1
387920,0,7 user reviews,7,0,7
387921,0,4 user reviews,4,0,4
387930,5,Mixed,50,45,95
387960,0,5 user reviews,2,3,5
387970,0,4 user reviews,3,1,4
387980,7,Positive,28,2,30
387981,0,4 user reviews,4,0,4
387982,0,3 user reviews,3,0,3
387983,0,3 user reviews,2,1,3
387984,7,Positive,10,0,10
387990,8,Very Positive,21749,2183,23932
388000,0,4 user reviews,4,0,4
388010,0,4 user reviews,3,1,4
388020,0,7 user reviews,5,2,7
388050,5,Mixed,6,5,11
388060,5,Mixed,144,104,248
388080,8,Very Positive,1224,211,1435
388090,8,Very Positive,4068,329,4397
388140,6,Mostly Positive,9,3,12
388160,3,Negative,1,9,10
388210,9,Overwhelmingly Positive,1246,32,1278
388260,6,Mostly Positive,13,4,17
388270,7,Positive,19,3,22
388280,0,4 user reviews,2,2,4
388300,4,Mostly Negative,3,11,14
388320,6,Mostly Positive,403,120,523
388340,6,Mostly Positive,186,53,239
388360,5,Mixed,25,17,42
388370,0,3 user reviews,1,2,3
388390,0,4 user reviews,2,2,4
388410,6,Mostly Positive,2018,783,2801
388420,8,Very Positive,49,7,56
388430,6,Mostly Positive,29,9,38
388440,0,8 user reviews,2,6,8
388450,8,Very Positive,105,3,108
388470,8,Very Positive,328,25,353
388471,8,Very Positive,73,5,78
388472,7,Positive,20,4,24
388474,5,Mixed,20,13,33
388475,8,Very Positive,103,9,112
388476,0,7 user reviews,6,1,7
388477,6,Mostly Positive,107,35,142
388479,7,Positive,12,1,13
388490,6,Mostly Positive,8,3,11
388500,0,2 user reviews,1,1,2
388540,0,3 user reviews,2,1,3
388550,5,Mixed,6,6,12
388580,0,1 user reviews,0,1,1
388600,7,Positive,11,2,13
388620,8,Very Positive,77,8,85
388660,4,Mostly Negative,3,9,12
388680,5,Mixed,13,7,20
388710,0,1 user reviews,1,0,1
388720,6,Mostly Positive,21,6,27
388730,8,Very Positive,47,4,51
388750,9,Overwhelmingly Positive,671,32,703
388790,7,Positive,31,2,33
388800,8,Very Positive,404,79,483
388830,0,1 user reviews,0,1,1
388840,0,4 user reviews,2,2,4
388880,8,Very Positive,4390,311,4701
388900,6,Mostly Positive,52,22,74
388910,7,Positive,15,0,15
388960,0,6 user reviews,5,1,6
388970,7,Positive,40,9,49
388980,5,Mixed,44,34,78
389040,5,Mixed,263,298,561
389050,6,Mostly Positive,77,26,103
389120,5,Mixed,7,4,11
389140,8,Very Positive,599,51,650
389150,7,Positive,30,0,30
389160,5,Mixed,15,20,35
389170,8,Very Positive,46,7,53
389190,5,Mixed,25,16,41
389220,5,Mixed,120,63,183
389230,0,4 user reviews,1,3,4
389240,7,Positive,21,0,21
389250,0,3 user reviews,2,1,3
389260,8,Very Positive,53,10,63
389270,6,Mostly Positive,31,13,44
389280,5,Mixed,455,327,782
389300,0,1 user reviews,1,0,1
389310,5,Mixed,6,5,11
389330,0,6 user reviews,1,5,6
389400,5,Mixed,11,5,16
389420,6,Mostly Positive,7,3,10
389421,7,Positive,17,2,19
389430,4,Mostly Negative,9,16,25
389460,4,Mostly Negative,14,34,48
389470,6,Mostly Positive,13,5,18
389510,8,Very Positive,1029,63,1092
389570,6,Mostly Positive,57,15,72
389650,8,Very Positive,94,6,100
389670,6,Mostly Positive,200,69,269
389680,0,4 user reviews,1,3,4
389690,0,1 user reviews,0,1,1
389700,4,Mostly Negative,25,66,91
389710,0,2 user reviews,2,0,2
389720,8,Very Positive,111,8,119
389730,8,Very Positive,11633,1160,12793
389740,5,Mixed,5,5,10
389750,0,2 user reviews,2,0,2
389810,5,Mixed,9,9,18
389830,0,2 user reviews,2,0,2
389840,5,Mixed,16,16,32
389870,5,Mixed,103,60,163
389900,5,Mixed,65,50,115
389912,0,1 user reviews,1,0,1
389930,5,Mixed,12,9,21
389940,0,3 user reviews,3,0,3
389970,0,2 user reviews,1,1,2
389990,0,1 user reviews,1,0,1
390030,6,Mostly Positive,201,57,258
390040,6,Mostly Positive,42,11,53
390100,5,Mixed,29,17,46
390180,0,8 user reviews,5,3,8
390200,5,Mixed,34,20,54
390210,5,Mixed,35,19,54
390220,5,Mixed,17,11,28
390290,8,Very Positive,168,28,196
390310,5,Mixed,89,58,147
390330,6,Mostly Positive,38,10,48
390340,4,Mostly Negative,113,189,302
390362,0,1 user reviews,1,0,1
390363,0,1 user reviews,1,0,1
390366,0,1 user reviews,1,0,1
390367,0,1 user reviews,1,0,1
390371,0,1 user reviews,1,0,1
390374,0,2 user reviews,2,0,2
390376,0,1 user reviews,1,0,1
390377,0,3 user reviews,3,0,3
390379,0,1 user reviews,1,0,1
390381,0,2 user reviews,2,0,2
390383,0,1 user reviews,1,0,1
390389,0,5 user reviews,5,0,5
390390,0,1 user reviews,1,0,1
390393,0,1 user reviews,1,0,1
390399,0,3 user reviews,2,1,3
390402,0,1 user reviews,0,1,1
390403,0,2 user reviews,2,0,2
390404,0,1 user reviews,1,0,1
390407,0,1 user reviews,0,1,1
390411,0,2 user reviews,1,1,2
390412,0,2 user reviews,2,0,2
390417,0,1 user reviews,1,0,1
390423,0,1 user reviews,1,0,1
390429,0,3 user reviews,3,0,3
390430,0,3 user reviews,2,1,3
390432,0,2 user reviews,2,0,2
390433,0,1 user reviews,0,1,1
390434,0,1 user reviews,1,0,1
390435,0,6 user reviews,6,0,6
390439,0,2 user reviews,2,0,2
390441,0,1 user reviews,1,0,1
390444,0,1 user reviews,1,0,1
390445,0,4 user reviews,3,1,4
390447,0,1 user reviews,1,0,1
390451,0,4 user reviews,4,0,4
390459,0,1 user reviews,1,0,1
390460,0,5 user reviews,3,2,5
390470,0,2 user reviews,2,0,2
390490,0,3 user reviews,3,0,3
390510,4,Mostly Negative,11,26,37
390520,8,Very Positive,607,74,681
390540,0,6 user reviews,3,3,6
390560,8,Very Positive,316,47,363
390570,4,Mostly Negative,9,16,25
390580,7,Positive,15,0,15
390610,8,Very Positive,131,10,141
390620,0,2 user reviews,2,0,2
390650,0,7 user reviews,6,1,7
390651,7,Positive,16,2,18
390652,7,Positive,14,1,15
390653,0,4 user reviews,4,0,4
390654,0,5 user reviews,4,1,5
390655,7,Positive,26,2,28
390656,0,8 user reviews,7,1,8
390657,0,7 user reviews,7,0,7
390658,0,2 user reviews,2,0,2
390659,0,2 user reviews,2,0,2
390660,6,Mostly Positive,103,37,140
390670,8,Very Positive,43,9,52
390680,7,Positive,11,0,11
390710,8,Very Positive,83,8,91
390720,8,Very Positive,177,10,187
390730,8,Very Positive,112,6,118
390740,0,6 user reviews,3,3,6
390750,0,2 user reviews,2,0,2
390870,6,Mostly Positive,18,7,25
390880,5,Mixed,22,19,41
390890,8,Very Positive,51,3,54
390910,6,Mostly Positive,35,11,46
390920,7,Positive,25,3,28
390930,6,Mostly Positive,9,3,12
390940,6,Mostly Positive,10,4,14
390980,0,3 user reviews,3,0,3
391000,7,Positive,26,3,29
391030,7,Positive,18,2,20
391040,8,Very Positive,906,176,1082
391050,7,Positive,12,3,15
391070,4,Mostly Negative,115,262,377
391080,0,1 user reviews,1,0,1
391100,0,2 user reviews,1,1,2
391120,0,9 user reviews,5,4,9
391130,0,5 user reviews,2,3,5
391140,7,Positive,29,4,33
391160,6,Mostly Positive,57,22,79
391170,8,Very Positive,106,17,123
391180,7,Positive,11,2,13
391190,0,1 user reviews,1,0,1
391210,0,1 user reviews,1,0,1
391220,8,Very Positive,14739,1395,16134
391240,0,3 user reviews,3,0,3
391250,8,Very Positive,65,11,76
391260,5,Mixed,299,140,439
391270,7,Positive,36,7,43
391280,5,Mixed,93,55,148
391290,0,2 user reviews,2,0,2
391310,8,Very Positive,47,8,55
391340,4,Mostly Negative,9,18,27
391380,0,3 user reviews,2,1,3
391390,7,Positive,10,2,12
391400,0,1 user reviews,0,1,1
391410,0,2 user reviews,0,2,2
391420,6,Mostly Positive,133,44,177
391440,5,Mixed,14,12,26
391460,5,Mixed,83,51,134
391490,8,Very Positive,90,12,102
391510,7,Positive,16,0,16
391520,0,6 user reviews,3,3,6
391530,0,7 user reviews,5,2,7
391540,9,Overwhelmingly Positive,73575,3012,76587
391550,5,Mixed,8,7,15
391570,9,Overwhelmingly Positive,1086,35,1121
391580,8,Very Positive,51,7,58
391590,5,Mixed,5,6,11
391600,5,Mixed,13,12,25
391610,0,1 user reviews,1,0,1
391630,0,2 user reviews,1,1,2
391640,5,Mixed,9,5,14
391650,0,2 user reviews,2,0,2
391660,7,Positive,17,2,19
391680,8,Very Positive,754,49,803
391720,8,Very Positive,3648,462,4110
391730,8,Very Positive,1075,128,1203
391740,5,Mixed,14,17,31
391780,0,6 user reviews,6,0,6
391820,4,Mostly Negative,4,12,16
391830,0,1 user reviews,1,0,1
391860,5,Mixed,8,7,15
391880,0,4 user reviews,4,0,4
391900,0,3 user reviews,3,0,3
391910,0,6 user reviews,1,5,6
391930,0,2 user reviews,2,0,2
391950,0,1 user reviews,1,0,1
391960,0,1 user reviews,1,0,1
392000,8,Very Positive,157,37,194
392020,8,Very Positive,61,5,66
392030,7,Positive,22,2,24
392040,7,Positive,13,3,16
392070,8,Very Positive,70,11,81
392080,6,Mostly Positive,137,48,185
392090,0,2 user reviews,1,1,2
392100,0,4 user reviews,4,0,4
392110,8,Very Positive,4814,1050,5864
392120,0,7 user reviews,1,6,7
392150,0,4 user reviews,3,1,4
392160,6,Mostly Positive,3256,1270,4526
392190,6,Mostly Positive,42,18,60
392230,0,2 user reviews,2,0,2
392260,6,Mostly Positive,61,20,81
392280,5,Mixed,50,48,98
392330,7,Positive,32,3,35
392370,0,4 user reviews,3,1,4
392400,0,3 user reviews,2,1,3
392410,6,Mostly Positive,39,12,51
392420,0,1 user reviews,1,0,1
392430,0,2 user reviews,1,1,2
392450,0,3 user reviews,2,1,3
392470,8,Very Positive,311,61,372
392580,5,Mixed,263,113,376
392600,0,4 user reviews,3,1,4
392610,7,Positive,11,1,12
392620,7,Positive,12,2,14
392630,0,2 user reviews,2,0,2
392642,0,1 user reviews,1,0,1
392643,0,1 user reviews,1,0,1
392645,0,1 user reviews,1,0,1
392670,0,4 user reviews,4,0,4
392680,6,Mostly Positive,18,5,23
392690,0,1 user reviews,1,0,1
392730,0,4 user reviews,2,2,4
392760,0,2 user reviews,1,1,2
392780,0,9 user reviews,7,2,9
392790,6,Mostly Positive,13,4,17
392820,5,Mixed,11,13,24
392860,7,Positive,12,0,12
392880,0,1 user reviews,0,1,1
392890,0,7 user reviews,0,7,7
392900,0,4 user reviews,2,2,4
392920,5,Mixed,16,9,25
392930,5,Mixed,8,9,17
392940,5,Mixed,11,5,16
392950,8,Very Positive,76,10,86
392970,8,Very Positive,100,11,111
393010,9,Overwhelmingly Positive,1038,41,1079
393020,0,9 user reviews,7,2,9
393021,0,4 user reviews,2,2,4
393023,0,1 user reviews,1,0,1
393024,0,3 user reviews,0,3,3
393025,0,2 user reviews,0,2,2
393026,0,7 user reviews,5,2,7
393040,0,5 user reviews,2,3,5
393041,0,3 user reviews,1,2,3
393042,0,6 user reviews,1,5,6
393043,0,4 user reviews,3,1,4
393080,5,Mixed,674,556,1230
393150,5,Mixed,18,8,26
393170,0,4 user reviews,4,0,4
393190,8,Very Positive,119,7,126
393200,8,Very Positive,310,49,359
393220,7,Positive,21,2,23
393230,3,Negative,2,16,18
393240,5,Mixed,6,4,10
393290,4,Mostly Negative,3,7,10
393320,7,Positive,9,1,10
393330,0,5 user reviews,2,3,5
393340,0,4 user reviews,1,3,4
393350,6,Mostly Positive,16,6,22
393360,0,2 user reviews,1,1,2
393380,8,Very Positive,26109,2918,29027
393390,4,Mostly Negative,17,26,43
393410,0,2 user reviews,1,1,2
393420,5,Mixed,2910,1666,4576
393430,8,Very Positive,113,25,138
393460,4,Mostly Negative,4,7,11
393480,7,Positive,11,1,12
393500,0,1 user reviews,1,0,1
393510,0,3 user reviews,3,0,3
393520,8,Very Positive,1049,175,1224
393530,5,Mixed,14,7,21
393540,0,3 user reviews,1,2,3
393550,6,Mostly Positive,13,5,18
393560,0,4 user reviews,4,0,4
393600,0,6 user reviews,6,0,6
393610,6,Mostly Positive,54,22,76
393630,0,1 user reviews,1,0,1
393640,0,2 user reviews,2,0,2
393650,0,2 user reviews,2,0,2
393660,5,Mixed,7,6,13
393700,0,1 user reviews,0,1,1
393730,0,2 user reviews,1,1,2
393740,0,4 user reviews,2,2,4
393750,5,Mixed,72,36,108
393770,0,2 user reviews,2,0,2
393790,0,3 user reviews,3,0,3
393800,6,Mostly Positive,17,5,22
393820,3,Negative,3,19,22
393830,0,5 user reviews,2,3,5
393831,0,6 user reviews,5,1,6
393860,5,Mixed,6,6,12
393920,5,Mixed,65,69,134
393930,0,3 user reviews,0,3,3
393950,0,1 user reviews,1,0,1
393970,0,8 user reviews,6,2,8
393980,8,Very Positive,156,30,186
394000,0,2 user reviews,2,0,2
394010,0,6 user reviews,1,5,6
394030,7,Positive,20,1,21
394060,0,1 user reviews,0,1,1
394080,0,1 user reviews,1,0,1
394090,0,2 user reviews,2,0,2
394120,0,3 user reviews,1,2,3
394130,8,Very Positive,76,4,80
394140,6,Mostly Positive,17,5,22
394160,8,Very Positive,185,27,212
394220,8,Very Positive,60,14,74
394230,5,Mixed,1430,785,2215
394250,6,Mostly Positive,14,5,19
394260,0,6 user reviews,5,1,6
394270,0,6 user reviews,3,3,6
394280,5,Mixed,15,16,31
394290,7,Positive,20,1,21
394310,6,Mostly Positive,1607,664,2271
394320,5,Mixed,175,180,355
394321,4,Mostly Negative,17,29,46
394340,0,2 user reviews,2,0,2
394360,8,Very Positive,38159,3669,41828
394380,4,Mostly Negative,4,7,11
394390,7,Positive,11,2,13
394400,0,2 user reviews,0,2,2
394420,0,1 user reviews,0,1,1
394430,7,Positive,11,2,13
394450,5,Mixed,219,118,337
394480,0,1 user reviews,0,1,1
394490,4,Mostly Negative,11,25,36
394510,8,Very Positive,4653,444,5097
394540,6,Mostly Positive,131,45,176
394550,7,Positive,44,2,46
394560,0,1 user reviews,1,0,1
394561,0,1 user reviews,1,0,1
394600,6,Mostly Positive,89,29,118
394650,0,2 user reviews,1,1,2
394680,6,Mostly Positive,51,18,69
394690,8,Very Positive,4861,590,5451
394700,6,Mostly Positive,49,15,64
394750,0,1 user reviews,1,0,1
394760,6,Mostly Positive,564,205,769
394770,0,5 user reviews,0,5,5
394811,0,2 user reviews,1,1,2
394840,4,Mostly Negative,12,24,36
394850,6,Mostly Positive,68,19,87
394870,6,Mostly Positive,199,75,274
394890,0,5 user reviews,5,0,5
394900,6,Mostly Positive,7,3,10
394910,0,5 user reviews,1,4,5
394920,5,Mixed,12,8,20
394930,0,7 user reviews,3,4,7
394940,5,Mixed,9,5,14
394950,0,6 user reviews,6,0,6
394960,0,2 user reviews,2,0,2
394970,9,Overwhelmingly Positive,1840,92,1932
394990,0,1 user reviews,0,1,1
395020,0,3 user reviews,3,0,3
395050,0,4 user reviews,4,0,4
395100,0,4 user reviews,2,2,4
395140,7,Positive,10,0,10
395150,5,Mixed,6,8,14
395160,5,Mixed,72,65,137
395170,8,Very Positive,756,89,845
395180,8,Very Positive,881,211,1092
395190,0,7 user reviews,7,0,7
395200,6,Mostly Positive,505,147,652
395230,7,Positive,26,3,29
395231,7,Positive,9,1,10
395232,7,Positive,18,3,21
395233,7,Positive,22,2,24
395234,7,Positive,17,2,19
395235,7,Positive,16,1,17
395236,7,Positive,12,1,13
395237,7,Positive,11,1,12
395238,7,Positive,11,0,11
395239,7,Positive,21,4,25
395250,6,Mostly Positive,20,8,28
395260,7,Positive,14,1,15
395270,6,Mostly Positive,144,40,184
395310,0,2 user reviews,0,2,2
395350,5,Mixed,115,76,191
395380,5,Mixed,13,7,20
395400,5,Mixed,7,8,15
395410,0,6 user reviews,3,3,6
395420,6,Mostly Positive,49,18,67
395441,0,2 user reviews,2,0,2
395460,0,3 user reviews,2,1,3
395470,5,Mixed,18,13,31
395480,0,2 user reviews,2,0,2
395500,8,Very Positive,119,21,140
395520,7,Positive,26,6,32
395530,0,5 user reviews,5,0,5
395550,0,8 user reviews,7,1,8
395560,4,Mostly Negative,18,29,47
395570,5,Mixed,93,74,167
395580,0,4 user reviews,3,1,4
395600,6,Mostly Positive,36,14,50
395620,8,Very Positive,135,25,160
395640,0,2 user reviews,0,2,2
395700,0,1 user reviews,1,0,1
395760,6,Mostly Positive,42,14,56
395850,8,Very Positive,205,40,245
395860,6,Mostly Positive,63,23,86
395880,5,Mixed,6,4,10
395890,0,8 user reviews,6,2,8
395900,5,Mixed,42,30,72
395910,0,6 user reviews,2,4,6
395920,0,3 user reviews,3,0,3
395930,6,Mostly Positive,13,4,17
395940,0,2 user reviews,2,0,2
395950,0,4 user reviews,4,0,4
395960,0,4 user reviews,2,2,4
395990,7,Positive,12,1,13
396010,0,1 user reviews,1,0,1
396030,6,Mostly Positive,15,5,20
396060,0,6 user reviews,5,1,6
396090,6,Mostly Positive,106,43,149
396160,4,Mostly Negative,86,173,259
396170,7,Positive,11,2,13
396171,4,Mostly Negative,14,24,38
396172,5,Mixed,12,18,30
396173,0,7 user reviews,5,2,7
396230,8,Very Positive,118,29,147
396260,7,Positive,27,3,30
396280,7,Positive,17,3,20
396310,8,Very Positive,214,40,254
396320,6,Mostly Positive,10,3,13
396350,8,Very Positive,260,10,270
396360,5,Mixed,40,25,65
396434,0,1 user reviews,0,1,1
396435,0,1 user reviews,0,1,1
396440,0,1 user reviews,1,0,1
396450,0,5 user reviews,3,2,5
396460,0,3 user reviews,3,0,3
396480,6,Mostly Positive,344,96,440
396530,3,Negative,0,11,11
396560,6,Mostly Positive,44,18,62
396590,6,Mostly Positive,18,6,24
396610,0,2 user reviews,0,2,2
396640,8,Very Positive,157,22,179
396650,9,Overwhelmingly Positive,1069,45,1114
396660,5,Mixed,36,19,55
396680,5,Mixed,28,15,43
396690,0,3 user reviews,3,0,3
396700,0,6 user reviews,5,1,6
396710,8,Very Positive,296,23,319
396730,0,1 user reviews,0,1,1
396750,6,Mostly Positive,2904,763,3667
396760,0,1 user reviews,1,0,1
396790,6,Mostly Positive,201,76,277
396800,8,Very Positive,91,14,105
396810,0,3 user reviews,3,0,3
396820,0,6 user reviews,3,3,6
396830,5,Mixed,11,12,23
396850,4,Mostly Negative,9,16,25
396860,8,Very Positive,125,19,144
396870,5,Mixed,7,6,13
396890,8,Very Positive,133,24,157
396900,8,Very Positive,1232,170,1402
396920,0,9 user reviews,9,0,9
396930,0,8 user reviews,4,4,8
396940,0,8 user reviews,8,0,8
396990,7,Positive,11,0,11
397000,0,1 user reviews,1,0,1
397020,0,2 user reviews,1,1,2
397030,7,Positive,37,2,39
397060,8,Very Positive,455,81,536
397090,6,Mostly Positive,24,9,33
397100,7,Positive,10,1,11
397120,0,3 user reviews,1,2,3
397121,0,8 user reviews,5,3,8
397122,0,2 user reviews,1,1,2
397125,0,8 user reviews,6,2,8
397150,5,Mixed,104,66,170
397160,8,Very Positive,126,26,152
397180,6,Mostly Positive,18,6,24
397190,6,Mostly Positive,41,12,53
397200,5,Mixed,8,8,16
397210,5,Mixed,32,16,48
397220,0,1 user reviews,1,0,1
397240,0,8 user reviews,5,3,8
397270,8,Very Positive,275,30,305
397310,5,Mixed,39,18,57
397320,3,Negative,2,10,12
397330,8,Very Positive,66,12,78
397340,8,Very Positive,3967,343,4310
397350,9,Overwhelmingly Positive,478,22,500
397360,0,1 user reviews,0,1,1
397370,0,7 user reviews,6,1,7
397380,0,3 user reviews,3,0,3
397381,0,3 user reviews,3,0,3
397390,5,Mixed,114,53,167
397400,7,Positive,9,1,10
397420,5,Mixed,21,25,46
397430,8,Very Positive,471,30,501
397440,0,5 user reviews,4,1,5
397460,9,Overwhelmingly Positive,762,31,793
397500,5,Mixed,108,52,160
397540,8,Very Positive,15346,2873,18219
397550,7,Positive,9,1,10
397570,6,Mostly Positive,46,12,58
397580,4,Mostly Negative,6,11,17
397600,7,Positive,11,0,11
397640,0,6 user reviews,4,2,6
397660,6,Mostly Positive,7,3,10
397670,0,6 user reviews,1,5,6
397680,0,1 user reviews,1,0,1
397690,8,Very Positive,133,30,163
397700,0,3 user reviews,0,3,3
397720,0,3 user reviews,2,1,3
397740,9,Overwhelmingly Positive,1120,26,1146
397750,8,Very Positive,58,12,70
397760,0,2 user reviews,1,1,2
397770,5,Mixed,6,4,10
397780,6,Mostly Positive,77,20,97
397800,0,7 user reviews,1,6,7
397820,5,Mixed,11,13,24
397840,5,Mixed,20,12,32
397850,0,6 user reviews,6,0,6
397860,0,5 user reviews,4,1,5
397870,6,Mostly Positive,13,4,17
397900,0,1 user reviews,0,1,1
397910,0,4 user reviews,4,0,4
397920,0,1 user reviews,1,0,1
397930,0,6 user reviews,6,0,6
397940,5,Mixed,14,10,24
397950,8,Very Positive,4211,380,4591
397960,0,9 user reviews,7,2,9
397970,6,Mostly Positive,14,4,18
397990,0,5 user reviews,5,0,5
398000,8,Very Positive,142,0,142
398020,5,Mixed,8,9,17
398030,8,Very Positive,73,5,78
398070,6,Mostly Positive,14,4,18
398100,6,Mostly Positive,277,71,348
398110,0,5 user reviews,3,2,5
398120,4,Mostly Negative,10,20,30
398140,5,Mixed,8,10,18
398150,0,8 user reviews,6,2,8
398170,8,Very Positive,186,40,226
398180,5,Mixed,91,47,138
398210,3,Negative,1,16,17
398240,0,8 user reviews,6,2,8
398250,7,Positive,12,0,12
398260,0,3 user reviews,3,0,3
398310,0,1 user reviews,1,0,1
398450,0,4 user reviews,2,2,4
398460,6,Mostly Positive,13,4,17
398470,0,1 user reviews,0,1,1
398471,0,2 user reviews,1,1,2
398473,0,1 user reviews,0,1,1
398480,0,6 user reviews,2,4,6
398520,0,3 user reviews,3,0,3
398530,0,7 user reviews,4,3,7
398620,0,5 user reviews,5,0,5
398630,5,Mixed,8,5,13
398640,5,Mixed,33,41,74
398670,0,6 user reviews,3,3,6
398680,5,Mixed,9,5,14
398710,8,Very Positive,1263,115,1378
398810,6,Mostly Positive,81,21,102
398820,5,Mixed,6,4,10
398830,0,1 user reviews,0,1,1
398840,0,2 user reviews,0,2,2
398850,9,Overwhelmingly Positive,1503,70,1573
398860,0,1 user reviews,1,0,1
398890,0,1 user reviews,0,1,1
398900,0,1 user reviews,1,0,1
398911,7,Positive,18,1,19
398913,8,Very Positive,50,1,51
398915,6,Mostly Positive,18,5,23
398916,7,Positive,20,1,21
398917,7,Positive,12,0,12
398920,0,1 user reviews,1,0,1
398930,5,Mixed,11,7,18
398940,6,Mostly Positive,9,3,12
398950,0,1 user reviews,0,1,1
398960,7,Positive,11,0,11
398970,5,Mixed,5,6,11
398980,8,Very Positive,68,8,76
399000,0,1 user reviews,1,0,1
399020,0,1 user reviews,1,0,1
399021,0,1 user reviews,1,0,1
399040,7,Positive,36,7,43
399070,8,Very Positive,171,24,195
399090,0,2 user reviews,0,2,2
399120,5,Mixed,447,254,701
399130,5,Mixed,30,23,53
399140,7,Positive,27,5,32
399180,0,5 user reviews,2,3,5
399230,4,Mostly Negative,12,33,45
399240,0,7 user reviews,4,3,7
399260,0,6 user reviews,5,1,6
399270,0,5 user reviews,3,2,5
399420,0,4 user reviews,1,3,4
399430,5,Mixed,52,30,82
399520,0,2 user reviews,2,0,2
399530,0,3 user reviews,3,0,3
399550,0,1 user reviews,0,1,1
399600,7,Positive,25,3,28
399610,5,Mixed,12,6,18
399620,4,Mostly Negative,26,53,79
399640,8,Very Positive,245,19,264
399660,0,1 user reviews,1,0,1
399670,8,Very Positive,1454,226,1680
399720,7,Positive,39,2,41
399730,8,Very Positive,182,19,201
399780,8,Very Positive,69,3,72
399790,4,Mostly Negative,104,227,331
399810,6,Mostly Positive,1671,630,2301
399820,8,Very Positive,486,101,587
399830,0,3 user reviews,3,0,3
399831,0,5 user reviews,5,0,5
399833,0,5 user reviews,5,0,5
399834,0,4 user reviews,4,0,4
399835,0,1 user reviews,1,0,1
399860,0,4 user reviews,4,0,4
399870,0,1 user reviews,0,1,1
399880,0,5 user reviews,5,0,5
399890,8,Very Positive,62,15,77
399900,0,5 user reviews,2,3,5
399910,7,Positive,9,1,10
399920,0,6 user reviews,5,1,6
399940,0,1 user reviews,0,1,1
400020,8,Very Positive,291,58,349
400030,0,4 user reviews,0,4,4
400040,7,Positive,9,1,10
400080,8,Very Positive,193,34,227
400110,8,Very Positive,171,42,213
400130,0,8 user reviews,7,1,8
400160,8,Very Positive,190,19,209
400170,6,Mostly Positive,370,148,518
400180,6,Mostly Positive,109,40,149
400200,4,Mostly Negative,18,29,47
400220,7,Positive,8,2,10
400230,0,2 user reviews,1,1,2
400240,5,Mixed,151,68,219
400250,5,Mixed,106,89,195
400280,0,9 user reviews,7,2,9
400330,0,4 user reviews,1,3,4
400350,6,Mostly Positive,19,7,26
400360,5,Mixed,34,23,57
400370,7,Positive,27,3,30
400380,0,8 user reviews,5,3,8
400400,7,Positive,14,0,14
400410,0,3 user reviews,3,0,3
400420,0,1 user reviews,1,0,1
400430,8,Very Positive,192,36,228
400450,8,Very Positive,185,39,224
400470,5,Mixed,43,20,63
400490,8,Very Positive,59,13,72
400500,4,Mostly Negative,8,13,21
400510,5,Mixed,47,49,96
400551,6,Mostly Positive,222,61,283
400570,0,1 user reviews,1,0,1
400580,8,Very Positive,152,18,170
400600,0,2 user reviews,2,0,2
400630,8,Very Positive,695,43,738
400650,0,3 user reviews,2,1,3
400660,8,Very Positive,242,31,273
400710,7,Positive,10,1,11
400720,0,3 user reviews,2,1,3
400721,0,4 user reviews,4,0,4
400740,2,Very Negative,10,46,56
400760,8,Very Positive,61,13,74
400780,0,3 user reviews,2,1,3
400790,8,Very Positive,100,8,108
400800,5,Mixed,117,54,171
400820,0,2 user reviews,0,2,2
400840,0,5 user reviews,4,1,5
400841,0,4 user reviews,4,0,4
400842,7,Positive,12,1,13
400880,4,Mostly Negative,4,13,17
400890,0,5 user reviews,4,1,5
400892,0,3 user reviews,3,0,3
400893,0,2 user reviews,2,0,2
400894,0,1 user reviews,1,0,1
400896,0,3 user reviews,2,1,3
400899,0,1 user reviews,1,0,1
400909,0,1 user reviews,1,0,1
400910,9,Overwhelmingly Positive,1669,49,1718
400922,0,1 user reviews,1,0,1
400940,6,Mostly Positive,711,198,909
400962,0,1 user reviews,1,0,1
400988,0,1 user reviews,1,0,1
400998,0,1 user reviews,1,0,1
400999,0,5 user reviews,2,3,5
401008,0,2 user reviews,0,2,2
401014,0,1 user reviews,1,0,1
401024,0,1 user reviews,1,0,1
401063,0,1 user reviews,1,0,1
401080,0,1 user reviews,0,1,1
401090,6,Mostly Positive,58,22,80
401120,7,Positive,21,4,25
401170,0,2 user reviews,1,1,2
401190,5,Mixed,954,476,1430
401200,0,5 user reviews,5,0,5
401210,0,2 user reviews,1,1,2
401250,5,Mixed,17,16,33
401270,0,5 user reviews,5,0,5
401280,7,Positive,15,1,16
401290,7,Positive,29,3,32
401310,0,3 user reviews,1,2,3
401320,5,Mixed,14,8,22
401330,5,Mixed,6,7,13
401360,6,Mostly Positive,146,53,199
401420,0,1 user reviews,0,1,1
401430,0,2 user reviews,0,2,2
401510,0,5 user reviews,5,0,5
401550,0,6 user reviews,5,1,6
401560,0,6 user reviews,3,3,6
401590,0,4 user reviews,4,0,4
401626,0,6 user reviews,5,1,6
401635,8,Very Positive,71,9,80
401640,0,6 user reviews,6,0,6
401650,5,Mixed,164,163,327
401660,7,Positive,25,2,27
401680,8,Very Positive,863,67,930
401690,5,Mixed,92,61,153
401710,6,Mostly Positive,256,109,365
401760,6,Mostly Positive,27,10,37
401780,0,8 user reviews,3,5,8
401800,6,Mostly Positive,14,5,19
401810,8,Very Positive,251,19,270
401820,5,Mixed,51,23,74
401840,7,Positive,14,2,16
401890,5,Mixed,51,29,80
401910,7,Positive,31,4,35
401920,8,Very Positive,3072,259,3331
401970,0,2 user reviews,1,1,2
401990,0,5 user reviews,5,0,5
402020,6,Mostly Positive,1037,401,1438
402030,6,Mostly Positive,9,3,12
402040,6,Mostly Positive,182,69,251
402060,6,Mostly Positive,74,27,101
402120,8,Very Positive,180,35,215
402130,5,Mixed,122,143,265
402150,5,Mixed,15,9,24
402160,5,Mixed,96,103,199
402170,4,Mostly Negative,6,13,19
402180,8,Very Positive,922,170,1092
402190,4,Mostly Negative,3,10,13
402210,7,Positive,36,6,42
402220,6,Mostly Positive,21,6,27
402260,8,Very Positive,273,65,338
402290,7,Positive,21,5,26
402300,5,Mixed,22,14,36
402310,6,Mostly Positive,150,48,198
402330,8,Very Positive,768,94,862
402340,7,Positive,19,2,21
402350,0,3 user reviews,3,0,3
402390,0,8 user reviews,6,2,8
402430,8,Very Positive,345,22,367
402460,4,Mostly Negative,4,11,15
402530,8,Very Positive,234,16,250
402560,6,Mostly Positive,54,23,77
402570,8,Very Positive,732,62,794
402590,0,6 user reviews,4,2,6
402601,0,1 user reviews,1,0,1
402620,8,Very Positive,448,11,459
402630,8,Very Positive,54,5,59
402640,0,1 user reviews,1,0,1
402660,0,8 user reviews,8,0,8
402670,0,3 user reviews,2,1,3
402680,0,1 user reviews,1,0,1
402690,0,1 user reviews,1,0,1
402700,0,9 user reviews,7,2,9
402710,5,Mixed,3355,2237,5592
402730,0,6 user reviews,1,5,6
402750,5,Mixed,78,41,119
402800,5,Mixed,18,23,41
402840,6,Mostly Positive,18,6,24
402850,5,Mixed,18,8,26
402880,6,Mostly Positive,225,71,296
402890,0,2 user reviews,2,0,2
402910,0,2 user reviews,1,1,2
402940,0,4 user reviews,4,0,4
402970,0,1 user reviews,1,0,1
402980,4,Mostly Negative,3,8,11
402990,0,6 user reviews,5,1,6
403010,0,7 user reviews,4,3,7
403030,0,2 user reviews,2,0,2
403040,0,8 user reviews,5,3,8
403050,0,1 user reviews,1,0,1
403051,0,5 user reviews,5,0,5
403052,0,2 user reviews,2,0,2
403060,0,1 user reviews,1,0,1
403061,0,4 user reviews,3,1,4
403062,0,1 user reviews,0,1,1
403063,0,7 user reviews,7,0,7
403070,7,Positive,29,5,34
403090,7,Positive,12,0,12
403100,7,Positive,10,2,12
403120,6,Mostly Positive,548,226,774
403150,6,Mostly Positive,51,21,72
403151,7,Positive,12,2,14
403152,0,9 user reviews,9,0,9
403153,7,Positive,22,2,24
403170,0,2 user reviews,2,0,2
403180,8,Very Positive,155,33,188
403190,6,Mostly Positive,3003,958,3961
403200,4,Mostly Negative,4,16,20
403220,0,6 user reviews,6,0,6
403230,0,3 user reviews,2,1,3
403270,7,Positive,15,0,15
403290,6,Mostly Positive,69,18,87
403300,0,2 user reviews,2,0,2
403350,0,5 user reviews,5,0,5
403351,0,4 user reviews,4,0,4
403390,4,Mostly Negative,4,7,11
403400,8,Very Positive,120,18,138
403410,8,Very Positive,71,14,85
403430,8,Very Positive,255,35,290
403440,4,Mostly Negative,3,7,10
403454,0,1 user reviews,1,0,1
403455,0,1 user reviews,1,0,1
403456,0,2 user reviews,1,1,2
403457,0,1 user reviews,1,0,1
403460,0,2 user reviews,1,1,2
403470,0,3 user reviews,2,1,3
403490,0,7 user reviews,4,3,7
403500,0,4 user reviews,4,0,4
403510,6,Mostly Positive,38,13,51
403560,4,Mostly Negative,40,106,146
403590,4,Mostly Negative,46,109,155
403640,8,Very Positive,8408,1769,10177
403660,5,Mixed,9,13,22
403670,5,Mixed,21,12,33
403680,0,6 user reviews,3,3,6
403690,0,1 user reviews,1,0,1
403700,8,Very Positive,190,31,221
403740,5,Mixed,41,28,69
403780,6,Mostly Positive,10,3,13
403810,0,4 user reviews,3,1,4
403830,8,Very Positive,189,10,199
403840,0,8 user reviews,7,1,8
403850,5,Mixed,5,7,12
403860,4,Mostly Negative,15,35,50
403870,7,Positive,20,5,25
403880,5,Mixed,15,21,36
403890,0,2 user reviews,1,1,2
403900,5,Mixed,38,45,83
403910,0,3 user reviews,2,1,3
403940,5,Mixed,75,42,117
403950,8,Very Positive,309,31,340
403970,6,Mostly Positive,243,98,341
403980,2,Very Negative,11,66,77
403990,0,3 user reviews,3,0,3
404010,5,Mixed,219,315,534
404011,5,Mixed,559,800,1359
404012,5,Mixed,472,305,777
404013,8,Very Positive,288,57,345
404014,8,Very Positive,236,29,265
404015,0,8 user reviews,8,0,8
404030,7,Positive,21,3,24
404040,8,Very Positive,188,16,204
404050,5,Mixed,58,28,86
404070,5,Mixed,9,6,15
404080,5,Mixed,70,81,151
404100,6,Mostly Positive,23,6,29
404170,8,Very Positive,48,4,52
404180,6,Mostly Positive,31,8,39
404200,6,Mostly Positive,179,50,229
404211,0,5 user reviews,5,0,5
404212,0,2 user reviews,2,0,2
404213,0,1 user reviews,1,0,1
404214,0,1 user reviews,1,0,1
404215,0,1 user reviews,1,0,1
404216,0,2 user reviews,2,0,2
404217,0,1 user reviews,1,0,1
404218,0,1 user reviews,1,0,1
404230,3,Negative,2,9,11
404240,0,4 user reviews,1,3,4
404250,7,Positive,30,2,32
404270,7,Positive,16,1,17
404280,6,Mostly Positive,17,5,22
404281,0,8 user reviews,7,1,8
404282,0,6 user reviews,6,0,6
404283,0,5 user reviews,4,1,5
404284,0,5 user reviews,5,0,5
404290,0,3 user reviews,1,2,3
404300,0,3 user reviews,2,1,3
404390,0,6 user reviews,6,0,6
404400,7,Positive,8,2,10
404410,8,Very Positive,67,5,72
404420,0,9 user reviews,6,3,9
404430,8,Very Positive,94,4,98
404450,0,2 user reviews,2,0,2
404460,0,7 user reviews,7,0,7
404480,7,Positive,10,0,10
404510,6,Mostly Positive,20,6,26
404530,8,Very Positive,268,45,313
404540,8,Very Positive,622,60,682
404550,5,Mixed,42,20,62
404570,7,Positive,12,1,13
404580,0,1 user reviews,0,1,1
404590,5,Mixed,425,258,683
404620,6,Mostly Positive,444,128,572
404630,0,8 user reviews,3,5,8
404640,4,Mostly Negative,12,39,51
404660,0,6 user reviews,4,2,6
404670,0,1 user reviews,1,0,1
404680,8,Very Positive,1160,130,1290
404690,8,Very Positive,92,20,112
404700,7,Positive,38,6,44
404730,8,Very Positive,462,60,522
404750,0,2 user reviews,1,1,2
404770,5,Mixed,76,46,122
404790,7,Positive,9,1,10
404800,0,1 user reviews,1,0,1
404820,8,Very Positive,86,9,95
404840,0,8 user reviews,8,0,8
404850,0,5 user reviews,5,0,5
404860,5,Mixed,8,5,13
404890,5,Mixed,6,4,10
404920,4,Mostly Negative,28,43,71
404930,0,1 user reviews,1,0,1
404960,6,Mostly Positive,29,9,38
404980,0,1 user reviews,1,0,1
404981,0,3 user reviews,3,0,3
404982,0,3 user reviews,2,1,3
405000,6,Mostly Positive,36,10,46
405010,6,Mostly Positive,22,9,31
405032,7,Positive,14,3,17
405050,4,Mostly Negative,4,7,11
405070,0,4 user reviews,1,3,4
405080,5,Mixed,57,42,99
405130,7,Positive,26,6,32
405170,8,Very Positive,582,68,650
405180,8,Very Positive,84,17,101
405190,0,6 user reviews,1,5,6
405220,0,1 user reviews,0,1,1
405240,5,Mixed,8,7,15
405290,8,Very Positive,313,22,335
405310,6,Mostly Positive,598,184,782
405340,5,Mixed,11,9,20
405360,5,Mixed,19,19,38
405370,5,Mixed,154,92,246
405430,8,Very Positive,42,9,51
405440,0,5 user reviews,3,2,5
405450,0,2 user reviews,2,0,2
405460,0,1 user reviews,1,0,1
405470,0,9 user reviews,5,4,9
405480,0,6 user reviews,3,3,6
405500,6,Mostly Positive,84,28,112
405515,0,3 user reviews,3,0,3
405520,0,5 user reviews,3,2,5
405530,0,4 user reviews,4,0,4
405540,6,Mostly Positive,24,10,34
405550,7,Positive,22,4,26
405590,0,5 user reviews,5,0,5
405610,5,Mixed,43,61,104
405640,8,Very Positive,4748,251,4999
405650,6,Mostly Positive,31,12,43
405670,6,Mostly Positive,26,11,37
405700,0,1 user reviews,1,0,1
405710,6,Mostly Positive,922,247,1169
405720,7,Positive,10,0,10
405730,0,7 user reviews,2,5,7
405760,5,Mixed,6,4,10
405780,6,Mostly Positive,99,31,130
405810,0,5 user reviews,1,4,5
405820,9,Overwhelmingly Positive,1453,70,1523
405830,8,Very Positive,918,56,974
405860,0,4 user reviews,4,0,4
405900,8,Very Positive,1559,177,1736
405920,5,Mixed,13,6,19
405950,8,Very Positive,51,4,55
405960,5,Mixed,10,15,25
405970,6,Mostly Positive,19,8,27
406020,7,Positive,10,0,10
406030,0,1 user reviews,0,1,1
406040,0,2 user reviews,1,1,2
406050,0,1 user reviews,1,0,1
406071,0,3 user reviews,3,0,3
406072,0,1 user reviews,0,1,1
406073,0,3 user reviews,2,1,3
406077,0,1 user reviews,1,0,1
406080,5,Mixed,67,53,120
406090,0,5 user reviews,2,3,5
406110,6,Mostly Positive,15,4,19
406120,0,4 user reviews,3,1,4
406130,8,Very Positive,198,46,244
406140,0,3 user reviews,3,0,3
406150,9,Overwhelmingly Positive,6344,297,6641
406170,5,Mixed,47,42,89
406190,0,3 user reviews,2,1,3
406210,8,Very Positive,113,7,120
406220,7,Positive,35,6,41
406260,0,7 user reviews,6,1,7
406280,5,Mixed,11,14,25
406290,8,Very Positive,731,108,839
406300,0,5 user reviews,4,1,5
406310,5,Mixed,16,13,29
406350,8,Very Positive,445,85,530
406400,0,3 user reviews,2,1,3
406410,4,Mostly Negative,5,9,14
406421,0,1 user reviews,1,0,1
406440,0,3 user reviews,3,0,3
406460,0,5 user reviews,5,0,5
406470,0,3 user reviews,3,0,3
406520,0,4 user reviews,4,0,4
406521,0,3 user reviews,3,0,3
406540,8,Very Positive,78,7,85
406550,8,Very Positive,412,14,426
406560,5,Mixed,67,45,112
406580,5,Mixed,33,21,54
406590,8,Very Positive,71,17,88
406600,8,Very Positive,57,7,64
406610,4,Mostly Negative,7,16,23
406620,4,Mostly Negative,8,14,22
406650,6,Mostly Positive,38,11,49
406670,6,Mostly Positive,7,3,10
406690,0,1 user reviews,1,0,1
406700,0,2 user reviews,2,0,2
406710,5,Mixed,6,4,10
406720,5,Mixed,39,38,77
406730,5,Mixed,10,9,19
406760,0,1 user reviews,0,1,1
406780,7,Positive,14,2,16
406820,0,1 user reviews,1,0,1
406830,0,1 user reviews,1,0,1
406850,8,Very Positive,108,26,134
406860,5,Mixed,26,14,40
406870,8,Very Positive,163,14,177
406920,7,Positive,19,0,19
406930,0,4 user reviews,2,2,4
406940,5,Mixed,38,18,56
406950,7,Positive,8,2,10
406960,0,8 user reviews,7,1,8
406970,5,Mixed,303,138,441
407000,4,Mostly Negative,6,18,24
407020,8,Very Positive,63,15,78
407050,0,2 user reviews,2,0,2
407060,7,Positive,12,3,15
407070,0,4 user reviews,4,0,4
407080,6,Mostly Positive,10,3,13
407100,0,5 user reviews,5,0,5
407110,7,Positive,13,1,14
407120,0,2 user reviews,1,1,2
407130,8,Very Positive,923,135,1058
407140,0,2 user reviews,0,2,2
407150,0,4 user reviews,1,3,4
407190,0,9 user reviews,4,5,9
407200,7,Positive,14,0,14
407230,5,Mixed,134,73,207
407290,5,Mixed,29,17,46
407300,5,Mixed,68,30,98
407310,8,Very Positive,128,8,136
407320,7,Positive,14,1,15
407330,8,Very Positive,610,43,653
407340,8,Very Positive,72,4,76
407380,7,Positive,24,1,25
407420,5,Mixed,139,166,305
407450,0,1 user reviews,1,0,1
407460,0,1 user reviews,1,0,1
407474,4,Mostly Negative,4,9,13
407475,4,Mostly Negative,8,24,32
407510,5,Mixed,26,28,54
407530,5,Mixed,790,375,1165
407560,5,Mixed,304,155,459
407600,5,Mixed,24,21,45
407620,5,Mixed,22,28,50
407630,6,Mostly Positive,12,4,16
407680,5,Mixed,9,8,17
407690,5,Mixed,34,46,80
407700,4,Mostly Negative,3,9,12
407710,5,Mixed,28,16,44
407720,5,Mixed,18,19,37
407730,5,Mixed,16,15,31
407780,8,Very Positive,133,12,145
407810,8,Very Positive,482,113,595
407821,0,1 user reviews,1,0,1
407822,0,1 user reviews,1,0,1
407823,0,1 user reviews,1,0,1
407830,0,1 user reviews,0,1,1
407840,5,Mixed,1036,968,2004
407880,6,Mostly Positive,10,3,13
407890,0,5 user reviews,4,1,5
407900,7,Positive,42,4,46
407920,0,8 user reviews,8,0,8
407940,7,Positive,10,2,12
407980,6,Mostly Positive,87,32,119
408000,6,Mostly Positive,71,23,94
408030,7,Positive,49,0,49
408040,0,2 user reviews,1,1,2
408041,0,1 user reviews,1,0,1
408060,7,Positive,38,0,38
408070,0,1 user reviews,1,0,1
408100,0,7 user reviews,4,3,7
408101,0,7 user reviews,3,4,7
408102,0,9 user reviews,7,2,9
408110,7,Positive,25,5,30
408120,5,Mixed,197,88,285
408170,0,9 user reviews,9,0,9
408220,0,5 user reviews,4,1,5
408240,0,5 user reviews,4,1,5
408250,5,Mixed,77,71,148
408280,8,Very Positive,322,72,394
408300,7,Positive,28,1,29
408340,7,Positive,25,3,28
408360,7,Positive,12,1,13
408370,0,5 user reviews,5,0,5
408400,7,Positive,38,8,46
408410,8,Very Positive,528,39,567
408440,0,9 user reviews,1,8,9
408450,0,4 user reviews,3,1,4
408500,7,Positive,27,6,33
408510,0,1 user reviews,1,0,1
408520,8,Very Positive,552,53,605
408550,0,2 user reviews,2,0,2
408590,0,7 user reviews,6,1,7
408600,0,6 user reviews,6,0,6
408610,8,Very Positive,168,15,183
408640,5,Mixed,63,45,108
408650,6,Mostly Positive,76,29,105
408710,7,Positive,11,1,12
408730,7,Positive,16,3,19
408740,4,Mostly Negative,130,242,372
408750,0,4 user reviews,4,0,4
408760,5,Mixed,39,39,78
408770,6,Mostly Positive,30,10,40
408900,8,Very Positive,170,39,209
408920,5,Mixed,33,18,51
408930,7,Positive,19,2,21
408960,6,Mostly Positive,102,26,128
408970,7,Positive,14,1,15
408990,5,Mixed,167,236,403
409000,5,Mixed,116,64,180
409040,6,Mostly Positive,10,4,14
409070,7,Positive,9,2,11
409090,5,Mixed,19,11,30
409100,8,Very Positive,268,39,307
409141,0,1 user reviews,1,0,1
409142,6,Mostly Positive,7,3,10
409160,8,Very Positive,111,5,116
409170,5,Mixed,11,10,21
409180,0,2 user reviews,2,0,2
409200,0,1 user reviews,0,1,1
409210,8,Very Positive,177,7,184
409230,0,3 user reviews,2,1,3
409280,5,Mixed,7,6,13
409290,5,Mixed,11,5,16
409320,5,Mixed,66,31,97
409330,0,1 user reviews,1,0,1
409340,5,Mixed,18,14,32
409360,7,Positive,8,2,10
409380,8,Very Positive,47,6,53
409390,5,Mixed,19,13,32
409410,5,Mixed,8,8,16
409420,5,Mixed,5,7,12
409450,8,Very Positive,233,40,273
409460,5,Mixed,6,8,14
409470,0,1 user reviews,1,0,1
409480,0,3 user reviews,3,0,3
409490,5,Mixed,7,7,14
409510,4,Mostly Negative,3,9,12
409520,5,Mixed,15,17,32
409552,0,2 user reviews,2,0,2
409560,5,Mixed,11,5,16
409570,0,1 user reviews,1,0,1
409580,0,5 user reviews,1,4,5
409590,6,Mostly Positive,1298,457,1755
409600,5,Mixed,26,15,41
409610,0,1 user reviews,1,0,1
409630,5,Mixed,7,5,12
409651,0,1 user reviews,1,0,1
409660,8,Very Positive,428,31,459
409670,0,6 user reviews,5,1,6
409690,0,5 user reviews,4,1,5
409710,6,Mostly Positive,7430,2807,10237
409720,5,Mixed,2511,1687,4198
409730,6,Mostly Positive,15,4,19
409750,0,4 user reviews,4,0,4
409760,0,7 user reviews,5,2,7
409850,6,Mostly Positive,155,50,205
409870,8,Very Positive,183,16,199
409890,6,Mostly Positive,155,63,218
409910,8,Very Positive,100,19,119
409920,8,Very Positive,135,10,145
410000,0,8 user reviews,7,1,8
410040,0,1 user reviews,0,1,1
410050,5,Mixed,6,4,10
410100,0,4 user reviews,1,3,4
410110,6,Mostly Positive,561,189,750
410120,0,8 user reviews,4,4,8
410130,0,2 user reviews,2,0,2
410150,7,Positive,16,0,16
410210,4,Mostly Negative,74,182,256
410290,0,4 user reviews,3,1,4
410320,9,Overwhelmingly Positive,3473,135,3608
410330,0,6 user reviews,4,2,6
410340,8,Very Positive,1472,141,1613
410380,6,Mostly Positive,22,6,28
410390,7,Positive,9,2,11
410420,0,8 user reviews,8,0,8
410430,5,Mixed,49,46,95
410440,6,Mostly Positive,11,3,14
410450,0,1 user reviews,0,1,1
410470,0,1 user reviews,1,0,1
410480,0,3 user reviews,3,0,3
410490,0,8 user reviews,1,7,8
410530,0,4 user reviews,3,1,4
410531,0,4 user reviews,3,1,4
410540,0,4 user reviews,1,3,4
410550,0,3 user reviews,2,1,3
410570,6,Mostly Positive,94,31,125
410660,0,5 user reviews,4,1,5
410670,8,Very Positive,498,52,550
410680,0,1 user reviews,1,0,1
410710,8,Very Positive,588,55,643
410770,7,Positive,15,3,18
410780,7,Positive,22,1,23
410790,7,Positive,29,1,30
410820,8,Very Positive,203,12,215
410830,8,Very Positive,44,8,52
410840,6,Mostly Positive,149,51,200
410850,5,Mixed,309,173,482
410890,8,Very Positive,295,5,300
410900,8,Very Positive,2136,270,2406
410910,6,Mostly Positive,21,6,27
410970,8,Very Positive,115,13,128
410980,9,Overwhelmingly Positive,477,25,502
410990,5,Mixed,27,32,59
411000,8,Very Positive,233,29,262
411010,0,3 user reviews,2,1,3
411020,0,2 user reviews,1,1,2
411060,0,7 user reviews,7,0,7
411070,0,2 user reviews,0,2,2
411080,6,Mostly Positive,123,31,154
411100,0,2 user reviews,1,1,2
411110,0,7 user reviews,6,1,7
411120,8,Very Positive,45,11,56
411130,0,5 user reviews,3,2,5
411150,0,1 user reviews,1,0,1
411180,0,1 user reviews,1,0,1
411181,0,1 user reviews,1,0,1
411189,0,1 user reviews,1,0,1
411300,5,Mixed,2363,1185,3548
411310,8,Very Positive,60,8,68
411320,7,Positive,27,3,30
411330,6,Mostly Positive,117,42,159
411340,0,1 user reviews,1,0,1
411370,8,Very Positive,645,48,693
411380,7,Positive,12,1,13
411390,0,1 user reviews,0,1,1
411400,0,7 user reviews,6,1,7
411401,0,4 user reviews,4,0,4
411420,5,Mixed,6,5,11
411460,0,8 user reviews,6,2,8
411470,0,5 user reviews,5,0,5
411480,5,Mixed,13,6,19
411520,0,5 user reviews,2,3,5
411530,0,7 user reviews,6,1,7
411550,5,Mixed,6,4,10
411560,8,Very Positive,686,122,808
411570,8,Very Positive,107,13,120
411590,6,Mostly Positive,17,5,22
411600,4,Mostly Negative,19,31,50
411610,7,Positive,12,0,12
411620,5,Mixed,16,11,27
411630,5,Mixed,5,6,11
411650,6,Mostly Positive,26,11,37
411680,7,Positive,30,3,33
411690,6,Mostly Positive,14,5,19
411720,0,1 user reviews,1,0,1
411730,0,1 user reviews,1,0,1
411740,0,7 user reviews,4,3,7
411750,6,Mostly Positive,29,8,37
411760,6,Mostly Positive,54,22,76
411820,0,4 user reviews,3,1,4
411830,8,Very Positive,1402,77,1479
411870,7,Positive,12,0,12
411880,0,1 user reviews,1,0,1
411890,7,Positive,32,5,37
411891,6,Mostly Positive,41,16,57
411892,6,Mostly Positive,43,12,55
411893,8,Very Positive,171,12,183
411894,7,Positive,41,3,44
411900,0,5 user reviews,1,4,5
411901,0,3 user reviews,2,1,3
411910,6,Mostly Positive,28,10,38
411911,0,9 user reviews,9,0,9
411920,6,Mostly Positive,15,4,19
411930,7,Positive,30,4,34
411950,8,Very Positive,208,9,217
411960,9,Overwhelmingly Positive,1737,25,1762
411970,8,Very Positive,372,14,386
411980,8,Very Positive,85,3,88
412010,0,9 user reviews,2,7,9
412020,8,Very Positive,8677,1769,10446
412050,8,Very Positive,247,42,289
412090,4,Mostly Negative,5,8,13
412170,8,Very Positive,58,11,69
412210,0,6 user reviews,3,3,6
412230,0,4 user reviews,2,2,4
412250,0,5 user reviews,3,2,5
412270,6,Mostly Positive,26,9,35
412290,4,Mostly Negative,4,11,15
412310,6,Mostly Positive,40,13,53
412330,7,Positive,17,2,19
412331,0,9 user reviews,8,1,9
412332,6,Mostly Positive,19,7,26
412333,7,Positive,20,4,24
412352,0,1 user reviews,0,1,1
412360,0,4 user reviews,4,0,4
412370,0,7 user reviews,4,3,7
412380,0,6 user reviews,5,1,6
412400,5,Mixed,10,14,24
412410,5,Mixed,14,13,27
412440,0,4 user reviews,1,3,4
412450,5,Mixed,455,323,778
412460,4,Mostly Negative,35,64,99
412470,0,5 user reviews,3,2,5
412480,7,Positive,22,2,24
412490,0,6 user reviews,3,3,6
412520,5,Mixed,95,41,136
412530,5,Mixed,6,4,10
412540,0,4 user reviews,2,2,4
412560,0,1 user reviews,0,1,1
412580,7,Positive,12,1,13
412600,4,Mostly Negative,14,22,36
412620,8,Very Positive,67,2,69
412630,0,1 user reviews,0,1,1
412640,0,2 user reviews,1,1,2
412660,6,Mostly Positive,44,17,61
412670,8,Very Positive,186,4,190
412720,8,Very Positive,417,66,483
412730,0,8 user reviews,0,8,8
412740,6,Mostly Positive,1651,421,2072
412760,0,3 user reviews,3,0,3
412770,8,Very Positive,187,44,231
412790,6,Mostly Positive,86,29,115
412830,9,Overwhelmingly Positive,1919,84,2003
412870,0,1 user reviews,1,0,1
412880,5,Mixed,840,529,1369
412900,0,1 user reviews,1,0,1
412930,7,Positive,11,1,12
412940,0,2 user reviews,1,1,2
412960,0,1 user reviews,0,1,1
412970,0,5 user reviews,2,3,5
413030,5,Mixed,37,22,59
413040,0,1 user reviews,1,0,1
413060,0,3 user reviews,2,1,3
413110,5,Mixed,44,40,84
413150,9,Overwhelmingly Positive,124540,1518,126058
413160,8,Very Positive,59,4,63
413170,0,3 user reviews,1,2,3
413210,0,4 user reviews,4,0,4
413220,7,Positive,10,1,11
413230,7,Positive,13,0,13
413240,6,Mostly Positive,8,3,11
413260,0,5 user reviews,5,0,5
413290,5,Mixed,34,17,51
413330,0,4 user reviews,3,1,4
413350,0,1 user reviews,0,1,1
413360,5,Mixed,133,82,215
413370,8,Very Positive,234,32,266
413380,0,9 user reviews,2,7,9
413390,4,Mostly Negative,5,8,13
413410,9,Overwhelmingly Positive,7116,194,7310
413420,9,Overwhelmingly Positive,5362,145,5507
413470,0,2 user reviews,1,1,2
413480,7,Positive,9,2,11
413490,0,3 user reviews,1,2,3
413500,7,Positive,9,1,10
413510,6,Mostly Positive,7,3,10
413540,7,Positive,10,0,10
413580,7,Positive,10,1,11
413600,5,Mixed,7,5,12
413610,7,Positive,13,3,16
413680,6,Mostly Positive,40,17,57
413700,0,9 user reviews,9,0,9
413710,5,Mixed,392,276,668
413740,5,Mixed,9,7,16
413750,0,1 user reviews,1,0,1
413760,0,2 user reviews,1,1,2
413790,0,4 user reviews,4,0,4
413830,5,Mixed,6,5,11
413850,7,Positive,12,0,12
413851,0,2 user reviews,2,0,2
413852,0,1 user reviews,1,0,1
413853,0,1 user reviews,1,0,1
413854,0,1 user reviews,1,0,1
413855,0,1 user reviews,1,0,1
413856,0,1 user reviews,1,0,1
413857,0,1 user reviews,0,1,1
413858,0,1 user reviews,1,0,1
413859,0,2 user reviews,2,0,2
413870,7,Positive,43,5,48
413900,0,2 user reviews,2,0,2
413910,0,2 user reviews,2,0,2
413930,0,2 user reviews,2,0,2
413940,0,3 user reviews,3,0,3
413950,0,2 user reviews,2,0,2
413990,0,8 user reviews,8,0,8
413991,7,Positive,10,0,10
414010,0,1 user reviews,1,0,1
414060,0,8 user reviews,3,5,8
414080,5,Mixed,67,50,117
414090,0,5 user reviews,2,3,5
414100,0,8 user reviews,7,1,8
414110,0,5 user reviews,5,0,5
414120,8,Very Positive,130,17,147
414130,5,Mixed,118,91,209
414140,0,3 user reviews,1,2,3
414150,8,Very Positive,65,9,74
414160,0,8 user reviews,7,1,8
414180,0,4 user reviews,4,0,4
414190,6,Mostly Positive,208,65,273
414210,0,1 user reviews,1,0,1
414230,0,1 user reviews,1,0,1
414231,0,3 user reviews,1,2,3
414232,0,3 user reviews,2,1,3
414235,0,2 user reviews,0,2,2
414237,0,1 user reviews,1,0,1
414260,5,Mixed,14,8,22
414310,0,4 user reviews,4,0,4
414330,4,Mostly Negative,8,14,22
414340,8,Very Positive,15175,1355,16530
414360,0,3 user reviews,3,0,3
414370,7,Positive,13,1,14
414470,6,Mostly Positive,14,6,20
414490,7,Positive,18,0,18
414500,0,3 user reviews,0,3,3
414510,8,Very Positive,213,42,255
414530,0,2 user reviews,1,1,2
414550,5,Mixed,42,23,65
414580,0,8 user reviews,4,4,8
414600,0,1 user reviews,1,0,1
414601,0,4 user reviews,4,0,4
414610,0,1 user reviews,1,0,1
414620,0,1 user reviews,1,0,1
414640,0,1 user reviews,1,0,1
414651,4,Mostly Negative,5,10,15
414660,8,Very Positive,89,16,105
414670,0,7 user reviews,7,0,7
414671,0,3 user reviews,3,0,3
414672,0,7 user reviews,7,0,7
414673,0,3 user reviews,3,0,3
414674,0,2 user reviews,2,0,2
414675,0,4 user reviews,4,0,4
414680,0,1 user reviews,1,0,1
414700,8,Very Positive,3396,706,4102
414720,8,Very Positive,272,46,318
414730,0,5 user reviews,4,1,5
414740,5,Mixed,489,438,927
414750,0,3 user reviews,2,1,3
414760,0,9 user reviews,8,1,9
414770,0,3 user reviews,1,2,3
414780,0,5 user reviews,5,0,5
414790,0,3 user reviews,3,0,3
414810,0,6 user reviews,5,1,6
414830,0,3 user reviews,2,1,3
414850,0,2 user reviews,2,0,2
414860,0,4 user reviews,2,2,4
414870,8,Very Positive,649,89,738
414880,0,2 user reviews,2,0,2
414920,6,Mostly Positive,92,29,121
414950,5,Mixed,77,35,112
415000,7,Positive,31,0,31
415010,5,Mixed,19,22,41
415030,6,Mostly Positive,158,57,215
415040,0,2 user reviews,2,0,2
415080,3,Negative,4,30,34
415090,7,Positive,15,1,16
415140,0,9 user reviews,8,1,9
415150,7,Positive,37,9,46
415170,8,Very Positive,182,9,191
415180,7,Positive,37,2,39
415200,8,Very Positive,2817,293,3110
415240,8,Very Positive,60,12,72
415270,7,Positive,16,3,19
415300,6,Mostly Positive,121,43,164
415320,0,1 user reviews,1,0,1
415330,0,3 user reviews,2,1,3
415340,0,2 user reviews,2,0,2
415350,8,Very Positive,89,19,108
415390,0,7 user reviews,6,1,7
415400,6,Mostly Positive,44,15,59
415420,8,Very Positive,316,45,361
415431,0,2 user reviews,2,0,2
415480,8,Very Positive,286,51,337
415530,0,3 user reviews,3,0,3
415570,0,2 user reviews,1,1,2
415590,5,Mixed,452,204,656
415600,8,Very Positive,58,11,69
415610,6,Mostly Positive,35,9,44
415670,8,Very Positive,54,3,57
415680,8,Very Positive,159,5,164
415700,7,Positive,28,4,32
415710,7,Positive,20,0,20
415740,6,Mostly Positive,176,57,233
415800,7,Positive,36,3,39
415830,7,Positive,41,7,48
415840,4,Mostly Negative,15,23,38
415850,8,Very Positive,143,31,174
415860,0,9 user reviews,4,5,9
415880,8,Very Positive,326,62,388
415900,0,3 user reviews,2,1,3
415910,7,Positive,41,7,48
415920,8,Very Positive,136,4,140
415950,5,Mixed,68,49,117
415960,7,Positive,20,4,24
415980,0,3 user reviews,2,1,3
415990,7,Positive,15,3,18
416000,8,Very Positive,137,7,144
416020,4,Mostly Negative,13,26,39
416030,0,9 user reviews,8,1,9
416040,5,Mixed,7,8,15
416060,5,Mixed,46,30,76
416080,5,Mixed,57,39,96
416090,0,2 user reviews,1,1,2
416110,8,Very Positive,50,5,55
416120,0,6 user reviews,4,2,6
416130,5,Mixed,11,6,17
416160,0,1 user reviews,0,1,1
416170,3,Negative,0,11,11
416180,7,Positive,18,3,21
416190,6,Mostly Positive,56,17,73
416200,5,Mixed,5,5,10
416210,5,Mixed,374,162,536
416220,0,6 user reviews,1,5,6
416240,8,Very Positive,62,5,67
416250,7,Positive,16,3,19
416260,0,7 user reviews,2,5,7
416290,0,7 user reviews,2,5,7
416310,5,Mixed,7,5,12
416320,0,8 user reviews,6,2,8
416330,0,7 user reviews,4,3,7
416340,7,Positive,10,2,12
416350,0,4 user reviews,1,3,4
416360,8,Very Positive,66,1,67
416370,5,Mixed,7,7,14
416380,6,Mostly Positive,53,19,72
416390,0,4 user reviews,3,1,4
416400,5,Mixed,6,4,10
416420,7,Positive,13,3,16
416421,5,Mixed,6,6,12
416422,7,Positive,17,0,17
416424,4,Mostly Negative,51,105,156
416430,0,3 user reviews,0,3,3
416450,0,3 user reviews,2,1,3
416480,5,Mixed,19,27,46
416520,0,1 user reviews,1,0,1
416530,7,Positive,21,2,23
416550,8,Very Positive,72,4,76
416560,0,4 user reviews,3,1,4
416590,6,Mostly Positive,547,139,686
416600,8,Very Positive,581,51,632
416610,0,8 user reviews,0,8,8
416630,5,Mixed,17,25,42
416640,8,Very Positive,85,21,106
416670,0,1 user reviews,1,0,1
416680,8,Very Positive,617,46,663
416690,0,3 user reviews,3,0,3
416700,0,2 user reviews,1,1,2
416710,0,1 user reviews,1,0,1
416720,0,6 user reviews,4,2,6
416750,0,2 user reviews,2,0,2
416760,5,Mixed,19,14,33
416770,8,Very Positive,436,35,471
416790,8,Very Positive,160,18,178
416800,5,Mixed,13,6,19
416830,7,Positive,31,4,35
416840,0,1 user reviews,0,1,1
416850,5,Mixed,6,4,10
416870,8,Very Positive,71,7,78
416900,0,5 user reviews,5,0,5
416920,0,5 user reviews,5,0,5
416940,7,Positive,10,1,11
417060,0,8 user reviews,4,4,8
417080,0,2 user reviews,2,0,2
417110,8,Very Positive,69,12,81
417150,7,Positive,33,7,40
417160,0,6 user reviews,5,1,6
417200,6,Mostly Positive,19,8,27
417260,0,5 user reviews,5,0,5
417290,8,Very Positive,1262,131,1393
417300,0,6 user reviews,3,3,6
417310,5,Mixed,13,7,20
417350,0,3 user reviews,0,3,3
417380,6,Mostly Positive,22,7,29
417390,0,2 user reviews,1,1,2
417400,6,Mostly Positive,8,3,11
417410,7,Positive,10,0,10
417430,5,Mixed,21,21,42
417461,8,Very Positive,186,34,220
417462,5,Mixed,70,77,147
417463,8,Very Positive,81,8,89
417464,8,Very Positive,147,20,167
417465,8,Very Positive,98,8,106
417480,0,2 user reviews,0,2,2
417540,0,6 user reviews,4,2,6
417560,0,8 user reviews,7,1,8
417570,0,1 user reviews,1,0,1
417580,7,Positive,16,1,17
417590,0,9 user reviews,8,1,9
417610,0,4 user reviews,4,0,4
417620,0,1 user reviews,1,0,1
417650,0,1 user reviews,1,0,1
417670,0,1 user reviews,1,0,1
417680,0,2 user reviews,1,1,2
417700,0,1 user reviews,1,0,1
417720,0,1 user reviews,1,0,1
417730,0,7 user reviews,5,2,7
417740,0,6 user reviews,5,1,6
417750,6,Mostly Positive,186,78,264
417790,0,4 user reviews,4,0,4
417840,0,6 user reviews,0,6,6
417850,0,2 user reviews,1,1,2
417860,8,Very Positive,200,35,235
417880,6,Mostly Positive,526,212,738
417890,0,7 user reviews,7,0,7
417900,0,8 user reviews,7,1,8
417910,5,Mixed,46,39,85
417920,4,Mostly Negative,3,7,10
417980,7,Positive,17,2,19
417990,8,Very Positive,216,47,263
418030,6,Mostly Positive,2873,1119,3992
418040,8,Very Positive,214,26,240
418050,0,9 user reviews,7,2,9
418060,6,Mostly Positive,26,11,37
418070,8,Very Positive,1261,106,1367
418120,8,Very Positive,137,34,171
418140,0,1 user reviews,1,0,1
418150,6,Mostly Positive,67,21,88
418160,0,9 user reviews,8,1,9
418170,0,2 user reviews,0,2,2
418180,5,Mixed,407,200,607
418190,8,Very Positive,312,25,337
418240,9,Overwhelmingly Positive,4863,220,5083
418250,5,Mixed,117,69,186
418260,5,Mixed,6,4,10
418270,5,Mixed,17,8,25
418280,5,Mixed,6,9,15
418290,0,2 user reviews,1,1,2
418300,8,Very Positive,122,26,148
418320,0,4 user reviews,4,0,4
418340,8,Very Positive,4694,1122,5816
418360,7,Positive,21,2,23
418370,8,Very Positive,7709,611,8320
418380,7,Positive,21,3,24
418440,8,Very Positive,98,9,107
418460,8,Very Positive,15494,2281,17775
418520,8,Very Positive,57,1,58
418530,8,Very Positive,2869,324,3193
418580,0,1 user reviews,1,0,1
418610,5,Mixed,20,21,41
418620,8,Very Positive,191,35,226
418640,0,8 user reviews,4,4,8
418650,9,Overwhelmingly Positive,1906,85,1991
418670,6,Mostly Positive,43,11,54
418750,7,Positive,11,0,11
418760,0,2 user reviews,1,1,2
418770,0,1 user reviews,1,0,1
418780,0,1 user reviews,1,0,1
418790,0,2 user reviews,2,0,2
418800,0,5 user reviews,4,1,5
418810,5,Mixed,24,36,60
418820,0,9 user reviews,9,0,9
418890,7,Positive,43,1,44
418900,0,5 user reviews,5,0,5
418910,5,Mixed,58,60,118
418940,5,Mixed,8,4,12
418950,8,Very Positive,174,39,213
418960,0,3 user reviews,0,3,3
418990,5,Mixed,45,31,76
419020,6,Mostly Positive,13,4,17
419070,8,Very Positive,113,5,118
419080,5,Mixed,9,9,18
419090,5,Mixed,7,5,12
419110,0,9 user reviews,9,0,9
419130,7,Positive,21,4,25
419170,0,2 user reviews,1,1,2
419180,0,1 user reviews,1,0,1
419190,0,1 user reviews,0,1,1
419200,0,1 user reviews,0,1,1
419220,7,Positive,19,0,19
419230,0,5 user reviews,0,5,5
419240,5,Mixed,5,6,11
419250,0,2 user reviews,1,1,2
419290,0,1 user reviews,1,0,1
419300,0,4 user reviews,4,0,4
419310,0,2 user reviews,2,0,2
419340,7,Positive,32,1,33
419360,7,Positive,13,0,13
419450,0,3 user reviews,0,3,3
419460,8,Very Positive,716,90,806
419480,6,Mostly Positive,1218,369,1587
419500,0,8 user reviews,6,2,8
419570,0,4 user reviews,2,2,4
419580,0,9 user reviews,8,1,9
419590,0,9 user reviews,7,2,9
419600,0,6 user reviews,3,3,6
419610,0,1 user reviews,1,0,1
419620,0,1 user reviews,1,0,1
419640,0,2 user reviews,1,1,2
419650,7,Positive,15,0,15
419660,0,7 user reviews,7,0,7
419700,5,Mixed,10,5,15
419710,0,8 user reviews,8,0,8
419810,7,Positive,28,2,30
419890,0,1 user reviews,0,1,1
419951,0,3 user reviews,3,0,3
419980,0,2 user reviews,2,0,2
419990,7,Positive,20,1,21
420000,6,Mostly Positive,321,106,427
420020,0,4 user reviews,4,0,4
420030,7,Positive,13,1,14
420060,6,Mostly Positive,127,44,171
420070,5,Mixed,31,18,49
420100,8,Very Positive,50,11,61
420110,9,Overwhelmingly Positive,2179,64,2243
420160,0,6 user reviews,3,3,6
420170,0,6 user reviews,5,1,6
420180,6,Mostly Positive,49,15,64
420210,0,8 user reviews,5,3,8
420250,0,1 user reviews,1,0,1
420270,4,Mostly Negative,12,25,37
420290,8,Very Positive,6859,1121,7980
420300,0,2 user reviews,0,2,2
420310,0,2 user reviews,1,1,2
420330,0,7 user reviews,3,4,7
420360,0,9 user reviews,9,0,9
420370,0,4 user reviews,3,1,4
420380,7,Positive,14,3,17
420390,0,2 user reviews,1,1,2
420440,8,Very Positive,623,104,727
420490,5,Mixed,31,20,51
420500,5,Mixed,7,4,11
420520,8,Very Positive,219,31,250
420530,9,Overwhelmingly Positive,9432,186,9618
420550,5,Mixed,44,23,67
420570,7,Positive,15,1,16
420610,5,Mixed,197,147,344
420630,5,Mixed,8,4,12
420640,6,Mostly Positive,16,5,21
420660,8,Very Positive,70,8,78
420670,3,Negative,2,10,12
420680,8,Very Positive,121,13,134
420740,8,Very Positive,709,56,765
420770,6,Mostly Positive,58,17,75
420780,0,1 user reviews,1,0,1
420781,0,5 user reviews,5,0,5
420790,6,Mostly Positive,11,4,15
420810,0,1 user reviews,1,0,1
420821,0,5 user reviews,5,0,5
420823,0,1 user reviews,0,1,1
420840,8,Very Positive,147,8,155
420850,5,Mixed,26,13,39
420880,0,2 user reviews,0,2,2
420900,0,5 user reviews,5,0,5
420920,5,Mixed,14,12,26
420930,8,Very Positive,499,88,587
420950,6,Mostly Positive,52,16,68
420970,0,5 user reviews,5,0,5
420980,8,Very Positive,147,12,159
421020,6,Mostly Positive,1923,544,2467
421040,8,Very Positive,1067,211,1278
421050,8,Very Positive,476,116,592
421060,5,Mixed,12,10,22
421120,9,Overwhelmingly Positive,713,37,750
421140,0,5 user reviews,4,1,5
421163,0,6 user reviews,4,2,6
421164,0,1 user reviews,0,1,1
421166,0,5 user reviews,4,1,5
421170,6,Mostly Positive,573,172,745
421180,0,3 user reviews,1,2,3
421210,0,3 user reviews,2,1,3
421220,0,1 user reviews,1,0,1
421240,0,1 user reviews,1,0,1
421260,8,Very Positive,58,4,62
421290,0,2 user reviews,2,0,2
421300,0,1 user reviews,1,0,1
421340,0,1 user reviews,1,0,1
421350,0,1 user reviews,1,0,1
421370,0,7 user reviews,7,0,7
421380,0,1 user reviews,1,0,1
421390,0,1 user reviews,1,0,1
421420,0,1 user reviews,0,1,1
421430,0,3 user reviews,3,0,3
421450,0,3 user reviews,3,0,3
421460,0,2 user reviews,2,0,2
421470,0,5 user reviews,5,0,5
421480,0,3 user reviews,3,0,3
421490,0,3 user reviews,3,0,3
421500,0,1 user reviews,0,1,1
421520,0,1 user reviews,1,0,1
421530,0,3 user reviews,3,0,3
421560,0,8 user reviews,7,1,8
421580,0,1 user reviews,1,0,1
421600,5,Mixed,30,19,49
421610,7,Positive,21,4,25
421620,0,6 user reviews,3,3,6
421630,8,Very Positive,128,4,132
421650,5,Mixed,113,137,250
421660,8,Very Positive,152,7,159
421670,7,Positive,20,0,20
421700,8,Very Positive,202,25,227
421710,7,Positive,9,1,10
421740,8,Very Positive,180,42,222
421760,0,4 user reviews,3,1,4
421770,0,6 user reviews,5,1,6
421771,0,2 user reviews,2,0,2
421790,5,Mixed,9,7,16
421800,0,6 user reviews,6,0,6
421810,5,Mixed,92,45,137
421860,0,1 user reviews,1,0,1
421870,0,9 user reviews,7,2,9
421880,5,Mixed,11,10,21
421890,5,Mixed,6,9,15
421900,5,Mixed,18,16,34
421910,7,Positive,18,3,21
421940,0,5 user reviews,5,0,5
421950,0,3 user reviews,3,0,3
422010,0,2 user reviews,2,0,2
422020,5,Mixed,18,8,26
422030,0,6 user reviews,3,3,6
422100,3,Negative,1,16,17
422110,8,Very Positive,103,5,108
422120,0,1 user reviews,1,0,1
422130,5,Mixed,21,28,49
422140,4,Mostly Negative,5,9,14
422180,0,4 user reviews,4,0,4
422181,0,3 user reviews,3,0,3
422182,0,2 user reviews,2,0,2
422190,0,1 user reviews,1,0,1
422210,0,8 user reviews,1,7,8
422220,7,Positive,33,2,35
422250,5,Mixed,16,24,40
422270,4,Mostly Negative,5,15,20
422300,6,Mostly Positive,15,4,19
422400,8,Very Positive,228,20,248
422420,2,Very Negative,40,262,302
422473,0,9 user reviews,7,2,9
422500,6,Mostly Positive,27,9,36
422510,8,Very Positive,226,13,239
422530,0,1 user reviews,1,0,1
422540,0,9 user reviews,5,4,9
422550,0,1 user reviews,1,0,1
422580,0,6 user reviews,5,1,6
422610,6,Mostly Positive,18,7,25
422640,4,Mostly Negative,13,22,35
422650,5,Mixed,8,9,17
422670,0,3 user reviews,3,0,3
422690,0,1 user reviews,0,1,1
422691,0,1 user reviews,1,0,1
422760,8,Very Positive,53,13,66
422810,6,Mostly Positive,665,249,914
422860,8,Very Positive,140,18,158
422900,8,Very Positive,569,51,620
422910,8,Very Positive,251,6,257
422920,8,Very Positive,104,12,116
422940,5,Mixed,46,38,84
422970,9,Overwhelmingly Positive,3470,127,3597
422980,0,9 user reviews,5,4,9
423010,7,Positive,14,1,15
423120,8,Very Positive,184,30,214
423180,0,2 user reviews,0,2,2
423220,0,5 user reviews,5,0,5
423230,8,Very Positive,3338,251,3589
423270,0,8 user reviews,4,4,8
423320,8,Very Positive,64,14,78
423363,6,Mostly Positive,9,3,12
423364,0,5 user reviews,3,2,5
423365,0,6 user reviews,6,0,6
423366,0,4 user reviews,4,0,4
423367,0,6 user reviews,4,2,6
423368,0,3 user reviews,2,1,3
423369,0,5 user reviews,4,1,5
423440,7,Positive,37,1,38
423490,6,Mostly Positive,157,41,198
423550,6,Mostly Positive,26,11,37
423580,8,Very Positive,1205,226,1431
423590,8,Very Positive,154,33,187
423600,7,Positive,9,2,11
423610,6,Mostly Positive,32,13,45
423620,5,Mixed,139,63,202
423630,8,Very Positive,75,1,76
423650,5,Mixed,24,17,41
423700,4,Mostly Negative,7,23,30
423710,5,Mixed,40,52,92
423720,0,2 user reviews,1,1,2
423730,0,4 user reviews,3,1,4
423740,5,Mixed,11,7,18
423750,6,Mostly Positive,14,6,20
423760,0,3 user reviews,1,2,3
423770,6,Mostly Positive,58,18,76
423780,0,2 user reviews,1,1,2
423800,5,Mixed,24,13,37
423810,5,Mixed,40,26,66
423840,0,9 user reviews,3,6,9
423850,0,7 user reviews,6,1,7
423851,5,Mixed,7,4,11
423852,0,9 user reviews,8,1,9
423853,0,7 user reviews,7,0,7
423870,7,Positive,13,2,15
423880,7,Positive,27,3,30
423890,5,Mixed,11,8,19
423900,5,Mixed,12,6,18
423950,5,Mixed,83,54,137
424000,3,Negative,1,12,13
424010,0,9 user reviews,7,2,9
424020,7,Positive,10,0,10
424030,8,Very Positive,2569,467,3036
424040,7,Positive,12,2,14
424060,4,Mostly Negative,3,7,10
424100,0,4 user reviews,4,0,4
424120,0,2 user reviews,2,0,2
424170,6,Mostly Positive,18,7,25
424200,7,Positive,17,0,17
424250,6,Mostly Positive,212,72,284
424260,5,Mixed,6,9,15
424280,8,Very Positive,102,3,105
424320,0,6 user reviews,5,1,6
424370,5,Mixed,13303,10076,23379
424580,0,1 user reviews,1,0,1
424590,5,Mixed,57,73,130
424640,7,Positive,9,2,11
424750,0,4 user reviews,4,0,4
424760,5,Mixed,13,12,25
424830,0,2 user reviews,1,1,2
424840,8,Very Positive,5162,544,5706
424850,0,5 user reviews,1,4,5
424860,0,2 user reviews,1,1,2
424870,0,8 user reviews,6,2,8
424880,0,2 user reviews,1,1,2
425010,0,3 user reviews,2,1,3
425030,0,1 user reviews,0,1,1
425040,7,Positive,10,0,10
425070,7,Positive,32,6,38
425110,4,Mostly Negative,23,49,72
425120,7,Positive,35,0,35
425130,0,6 user reviews,4,2,6
425140,0,3 user reviews,3,0,3
425141,0,1 user reviews,1,0,1
425150,5,Mixed,7,9,16
425160,7,Positive,18,2,20
425170,0,1 user reviews,1,0,1
425180,0,2 user reviews,0,2,2
425190,0,1 user reviews,0,1,1
425210,6,Mostly Positive,348,94,442
425220,6,Mostly Positive,326,93,419
425230,0,4 user reviews,3,1,4
425240,5,Mixed,19,14,33
425260,0,6 user reviews,4,2,6
425270,0,3 user reviews,3,0,3
425300,0,6 user reviews,0,6,6
425310,4,Mostly Negative,4,8,12
425330,7,Positive,10,0,10
425340,8,Very Positive,52,5,57
425360,7,Positive,46,0,46
425400,0,2 user reviews,2,0,2
425410,7,Positive,16,1,17
425440,6,Mostly Positive,8,3,11
425450,6,Mostly Positive,8,3,11
425460,5,Mixed,16,7,23
425500,0,1 user reviews,1,0,1
425530,0,2 user reviews,2,0,2
425540,5,Mixed,24,12,36
425541,0,1 user reviews,1,0,1
425542,0,3 user reviews,3,0,3
425544,0,2 user reviews,2,0,2
425550,0,1 user reviews,0,1,1
425560,0,1 user reviews,1,0,1
425580,9,Overwhelmingly Positive,4998,120,5118
425600,8,Very Positive,58,8,66
425650,8,Very Positive,103,7,110
425670,8,Very Positive,204,37,241
425720,8,Very Positive,220,41,261
425750,0,1 user reviews,1,0,1
425760,0,3 user reviews,2,1,3
425770,8,Very Positive,107,1,108
425780,0,3 user reviews,0,3,3
425790,0,2 user reviews,0,2,2
425791,0,7 user reviews,2,5,7
425820,7,Positive,37,8,45
425840,8,Very Positive,181,40,221
425860,0,4 user reviews,3,1,4
425870,0,2 user reviews,0,2,2
425900,0,8 user reviews,6,2,8
425960,6,Mostly Positive,14,4,18
425970,0,1 user reviews,1,0,1
425980,0,8 user reviews,7,1,8
425981,0,2 user reviews,1,1,2
425990,0,2 user reviews,2,0,2
426000,8,Very Positive,2467,405,2872
426010,4,Mostly Negative,11,24,35
426040,5,Mixed,7,4,11
426050,7,Positive,15,0,15
426060,0,1 user reviews,0,1,1
426080,0,1 user reviews,0,1,1
426100,4,Mostly Negative,18,44,62
426170,5,Mixed,12,7,19
426190,6,Mostly Positive,32,13,45
426210,5,Mixed,7,8,15
426240,7,Positive,10,1,11
426290,7,Positive,30,7,37
426310,5,Mixed,107,46,153
426321,5,Mixed,109,76,185
426330,8,Very Positive,117,12,129
426350,0,1 user reviews,1,0,1
426360,0,2 user reviews,2,0,2
426380,0,1 user reviews,1,0,1
426400,0,3 user reviews,3,0,3
426420,7,Positive,20,2,22
426430,0,1 user reviews,1,0,1
426440,7,Positive,11,1,12
426460,0,4 user reviews,4,0,4
426470,0,2 user reviews,2,0,2
426480,0,1 user reviews,1,0,1
426490,0,1 user reviews,1,0,1
426500,0,1 user reviews,1,0,1
426510,0,1 user reviews,1,0,1
426520,0,1 user reviews,1,0,1
426540,0,1 user reviews,1,0,1
426560,0,1 user reviews,1,0,1
426590,3,Negative,6,33,39
426630,6,Mostly Positive,166,60,226
426690,8,Very Positive,68,3,71
426730,8,Very Positive,51,1,52
426790,8,Very Positive,754,82,836
426820,0,2 user reviews,2,0,2
426860,5,Mixed,22,17,39
426920,0,2 user reviews,2,0,2
426921,0,1 user reviews,1,0,1
426922,0,1 user reviews,1,0,1
426923,0,1 user reviews,1,0,1
426924,0,1 user reviews,1,0,1
426925,0,2 user reviews,2,0,2
426926,0,1 user reviews,1,0,1
426927,0,1 user reviews,1,0,1
426928,0,2 user reviews,2,0,2
426929,0,1 user reviews,1,0,1
426930,6,Mostly Positive,22,8,30
426951,0,7 user reviews,6,1,7
426952,0,5 user reviews,5,0,5
426990,0,1 user reviews,1,0,1
426991,0,1 user reviews,1,0,1
426992,0,1 user reviews,1,0,1
426993,0,1 user reviews,1,0,1
426994,0,1 user reviews,1,0,1
426995,0,1 user reviews,1,0,1
426996,0,1 user reviews,1,0,1
426997,0,1 user reviews,1,0,1
426998,0,1 user reviews,1,0,1
426999,0,1 user reviews,1,0,1
427000,0,1 user reviews,1,0,1
427001,0,1 user reviews,1,0,1
427002,0,1 user reviews,1,0,1
427003,0,1 user reviews,1,0,1
427004,0,2 user reviews,2,0,2
427005,0,5 user reviews,5,0,5
427006,0,1 user reviews,1,0,1
427007,0,2 user reviews,2,0,2
427008,0,1 user reviews,1,0,1
427030,8,Very Positive,125,20,145
427040,0,5 user reviews,0,5,5
427050,0,6 user reviews,3,3,6
427100,5,Mixed,495,329,824
427190,8,Very Positive,1462,120,1582
427240,8,Very Positive,290,40,330
427250,6,Mostly Positive,801,203,1004
427270,5,Mixed,63,36,99
427290,6,Mostly Positive,3440,1208,4648
427300,0,3 user reviews,3,0,3
427310,0,3 user reviews,3,0,3
427320,0,2 user reviews,1,1,2
427350,0,1 user reviews,1,0,1
427380,0,3 user reviews,3,0,3
427400,0,1 user reviews,0,1,1
427470,6,Mostly Positive,192,65,257
427480,5,Mixed,17,15,32
427490,8,Very Positive,327,67,394
427510,6,Mostly Positive,183,47,230
427520,9,Overwhelmingly Positive,46522,520,47042
427550,6,Mostly Positive,21,9,30
427560,0,3 user reviews,0,3,3
427561,7,Positive,11,1,12
427570,5,Mixed,60,49,109
427610,0,8 user reviews,3,5,8
427640,6,Mostly Positive,11,4,15
427650,0,2 user reviews,2,0,2
427660,5,Mixed,68,31,99
427680,6,Mostly Positive,37,10,47
427700,8,Very Positive,90,4,94
427720,0,9 user reviews,8,1,9
427730,6,Mostly Positive,6069,2083,8152
427750,0,2 user reviews,2,0,2
427760,8,Very Positive,418,65,483
427770,0,7 user reviews,7,0,7
427780,5,Mixed,8,10,18
427790,0,1 user reviews,1,0,1
427810,5,Mixed,122,56,178
427820,8,Very Positive,499,87,586
427830,0,1 user reviews,1,0,1
427860,5,Mixed,43,21,64
427880,5,Mixed,365,182,547
427890,7,Positive,14,2,16
427910,5,Mixed,89,44,133
427920,8,Very Positive,489,81,570
427930,5,Mixed,13,8,21
427950,5,Mixed,110,94,204
427970,0,4 user reviews,1,3,4
427980,8,Very Positive,116,27,143
428010,7,Positive,19,0,19
428020,0,7 user reviews,5,2,7
428040,7,Positive,22,2,24
428060,0,9 user reviews,9,0,9
428080,8,Very Positive,296,9,305
428100,7,Positive,41,6,47
428110,0,9 user reviews,6,3,9
428130,0,3 user reviews,3,0,3
428140,0,8 user reviews,8,0,8
428170,7,Positive,9,2,11
428180,5,Mixed,28,18,46
428190,4,Mostly Negative,23,65,88
428200,5,Mixed,18,8,26
428210,4,Mostly Negative,7,13,20
428220,6,Mostly Positive,38,13,51
428230,0,3 user reviews,2,1,3
428240,0,2 user reviews,2,0,2
428250,0,9 user reviews,3,6,9
428260,0,7 user reviews,3,4,7
428270,0,9 user reviews,5,4,9
428280,7,Positive,15,1,16
428310,0,1 user reviews,1,0,1
428311,0,2 user reviews,2,0,2
428312,0,2 user reviews,2,0,2
428340,8,Very Positive,89,11,100
428350,6,Mostly Positive,35,9,44
428370,6,Mostly Positive,501,150,651
428400,0,6 user reviews,6,0,6
428410,0,5 user reviews,3,2,5
428420,4,Mostly Negative,7,13,20
428440,5,Mixed,44,30,74
428460,7,Positive,36,6,42
428490,6,Mostly Positive,10,3,13
428500,0,2 user reviews,1,1,2
428501,0,2 user reviews,0,2,2
428510,5,Mixed,9,5,14
428520,0,6 user reviews,1,5,6
428530,0,8 user reviews,7,1,8
428540,6,Mostly Positive,42,11,53
428550,8,Very Positive,2860,188,3048
428590,0,3 user reviews,0,3,3
428600,0,2 user reviews,2,0,2
428601,0,3 user reviews,3,0,3
428602,0,6 user reviews,6,0,6
428603,0,1 user reviews,1,0,1
428604,0,1 user reviews,1,0,1
428605,0,1 user reviews,1,0,1
428610,5,Mixed,31,15,46
428630,4,Mostly Negative,22,48,70
428660,8,Very Positive,998,148,1146
428690,6,Mostly Positive,4128,1433,5561
428730,5,Mixed,51,24,75
428740,0,3 user reviews,1,2,3
428750,8,Very Positive,321,14,335
428760,0,6 user reviews,3,3,6
428780,0,2 user reviews,2,0,2
428800,4,Mostly Negative,16,37,53
428810,5,Mixed,6,5,11
428830,7,Positive,37,2,39
428860,8,Very Positive,102,18,120
428870,0,5 user reviews,4,1,5
428880,8,Very Positive,226,33,259
428890,0,1 user reviews,1,0,1
428900,8,Very Positive,241,49,290
428920,0,4 user reviews,3,1,4
428930,0,1 user reviews,1,0,1
428940,0,2 user reviews,0,2,2
428950,5,Mixed,38,44,82
428980,0,6 user reviews,2,4,6
429010,0,1 user reviews,1,0,1
429011,0,1 user reviews,1,0,1
429020,4,Mostly Negative,8,13,21
429040,0,9 user reviews,6,3,9
429050,8,Very Positive,2023,429,2452
429060,4,Mostly Negative,6,17,23
429110,0,2 user reviews,1,1,2
429120,0,6 user reviews,3,3,6
429160,0,2 user reviews,0,2,2
429180,4,Mostly Negative,4,11,15
429200,5,Mixed,10,5,15
429220,5,Mixed,12,8,20
429250,0,2 user reviews,2,0,2
429260,0,6 user reviews,6,0,6
429270,0,3 user reviews,3,0,3
429280,5,Mixed,10,5,15
429300,7,Positive,14,0,14
429330,8,Very Positive,77,8,85
429350,0,9 user reviews,8,1,9
429360,7,Positive,35,1,36
429390,5,Mixed,38,19,57
429430,0,3 user reviews,2,1,3
429450,0,9 user reviews,4,5,9
429460,0,1 user reviews,1,0,1
429470,8,Very Positive,393,25,418
429480,0,1 user reviews,0,1,1
429490,5,Mixed,65,34,99
429520,0,5 user reviews,4,1,5
429530,6,Mostly Positive,52,14,66
429570,6,Mostly Positive,1302,455,1757
429580,5,Mixed,39,21,60
429600,5,Mixed,32,14,46
429610,8,Very Positive,65,14,79
429620,5,Mixed,119,85,204
429630,0,1 user reviews,1,0,1
429660,8,Very Positive,3570,268,3838
429680,5,Mixed,5,6,11
429690,7,Positive,36,1,37
429700,5,Mixed,66,51,117
429711,0,2 user reviews,2,0,2
429720,8,Very Positive,489,39,528
429730,5,Mixed,6,8,14
429780,6,Mostly Positive,195,81,276
429790,6,Mostly Positive,39,14,53
429800,0,5 user reviews,5,0,5
429810,0,3 user reviews,3,0,3
429820,0,2 user reviews,2,0,2
429830,8,Very Positive,123,14,137
429872,0,1 user reviews,1,0,1
429900,0,1 user reviews,1,0,1
429901,0,1 user reviews,1,0,1
429908,0,1 user reviews,1,0,1
429940,7,Positive,13,2,15
429950,0,1 user reviews,0,1,1
429960,0,3 user reviews,2,1,3
430020,5,Mixed,58,45,103
430050,0,3 user reviews,3,0,3
430060,0,4 user reviews,3,1,4
430070,6,Mostly Positive,81,34,115
430080,5,Mixed,16,12,28
430090,0,1 user reviews,1,0,1
430091,0,1 user reviews,1,0,1
430092,0,1 user reviews,1,0,1
430093,0,1 user reviews,1,0,1
430094,4,Mostly Negative,7,11,18
430100,0,5 user reviews,4,1,5
430120,0,3 user reviews,3,0,3
430170,0,2 user reviews,0,2,2
430180,0,2 user reviews,2,0,2
430190,0,1 user reviews,1,0,1
430200,0,3 user reviews,3,0,3
430210,6,Mostly Positive,569,191,760
430230,0,8 user reviews,7,1,8
430240,0,7 user reviews,3,4,7
430260,5,Mixed,6,5,11
430261,0,7 user reviews,7,0,7
430280,0,2 user reviews,0,2,2
430290,7,Positive,17,2,19
430300,0,7 user reviews,5,2,7
430314,0,1 user reviews,1,0,1
430319,0,1 user reviews,1,0,1
430320,0,1 user reviews,1,0,1
430321,0,1 user reviews,1,0,1
430322,0,1 user reviews,0,1,1
430324,0,4 user reviews,4,0,4
430349,0,1 user reviews,0,1,1
430410,5,Mixed,31,15,46
430930,5,Mixed,10,5,15
430960,8,Very Positive,1177,62,1239
431030,0,1 user reviews,0,1,1
431120,8,Very Positive,100,18,118
431180,8,Very Positive,866,81,947
431190,0,5 user reviews,3,2,5
431191,0,4 user reviews,2,2,4
431200,7,Positive,11,1,12
431220,0,7 user reviews,7,0,7
431230,7,Positive,30,5,35
431240,8,Very Positive,15957,1784,17741
431250,6,Mostly Positive,99,25,124
431260,6,Mostly Positive,153,59,212
431280,7,Positive,21,1,22
431290,0,5 user reviews,3,2,5
431300,0,3 user reviews,2,1,3
431330,0,7 user reviews,2,5,7
431340,0,1 user reviews,1,0,1
431350,0,2 user reviews,2,0,2
431360,0,5 user reviews,2,3,5
431370,7,Positive,8,2,10
431390,6,Mostly Positive,13,4,17
431410,0,7 user reviews,4,3,7
431430,7,Positive,14,3,17
431450,6,Mostly Positive,118,42,160
431460,5,Mixed,20,11,31
431470,0,1 user reviews,0,1,1
431490,0,8 user reviews,8,0,8
431500,0,6 user reviews,5,1,6
431510,5,Mixed,8,4,12
431540,7,Positive,14,3,17
431570,0,5 user reviews,1,4,5
431590,8,Very Positive,98,12,110
431600,8,Very Positive,412,70,482
431610,0,3 user reviews,2,1,3
431620,7,Positive,31,0,31
431621,7,Positive,23,1,24
431630,7,Positive,12,3,15
431640,4,Mostly Negative,12,25,37
431650,5,Mixed,179,90,269
431680,5,Mixed,4,6,10
431700,8,Very Positive,93,4,97
431710,8,Very Positive,160,19,179
431730,9,Overwhelmingly Positive,2217,14,2231
431740,0,2 user reviews,1,1,2
431750,8,Very Positive,60,15,75
431770,8,Very Positive,87,7,94
431790,0,1 user reviews,0,1,1
431800,0,2 user reviews,1,1,2
431810,5,Mixed,42,25,67
431830,7,Positive,8,2,10
431840,6,Mostly Positive,40,15,55
431850,6,Mostly Positive,20,7,27
431860,0,5 user reviews,0,5,5
431870,5,Mixed,28,13,41
431910,8,Very Positive,59,14,73
431930,8,Very Positive,83,8,91
431940,8,Very Positive,68,14,82
431960,9,Overwhelmingly Positive,60662,973,61635
431980,0,1 user reviews,0,1,1
432010,8,Very Positive,432,105,537
432030,0,5 user reviews,4,1,5
432100,8,Very Positive,324,56,380
432110,5,Mixed,5,7,12
432130,7,Positive,18,4,22
432170,5,Mixed,9,7,16
432180,5,Mixed,8,7,15
432190,8,Very Positive,55,6,61
432210,0,6 user reviews,4,2,6
432220,0,2 user reviews,1,1,2
432230,0,5 user reviews,2,3,5
432240,5,Mixed,10,13,23
432250,6,Mostly Positive,43,17,60
432260,7,Positive,15,3,18
432270,0,4 user reviews,1,3,4
432280,0,9 user reviews,7,2,9
432330,5,Mixed,31,16,47
432350,9,Overwhelmingly Positive,1476,15,1491
432370,6,Mostly Positive,37,11,48
432380,7,Positive,20,2,22
432390,0,1 user reviews,1,0,1
432410,0,5 user reviews,1,4,5
432420,5,Mixed,5,5,10
432440,0,4 user reviews,3,1,4
432450,0,1 user reviews,1,0,1
432470,4,Mostly Negative,14,40,54
432480,0,2 user reviews,1,1,2
432490,5,Mixed,7,4,11
432500,4,Mostly Negative,15,25,40
432510,0,1 user reviews,1,0,1
432590,4,Mostly Negative,7,13,20
432610,0,3 user reviews,1,2,3
432620,0,3 user reviews,3,0,3
432640,0,9 user reviews,3,6,9
432660,0,1 user reviews,0,1,1
432670,0,1 user reviews,1,0,1
432720,5,Mixed,14,7,21
432760,0,3 user reviews,3,0,3
432770,0,9 user reviews,8,1,9
432780,5,Mixed,6,6,12
432790,0,1 user reviews,0,1,1
432870,6,Mostly Positive,25,7,32
432890,0,9 user reviews,8,1,9
432940,6,Mostly Positive,50,16,66
432950,7,Positive,13,3,16
432980,8,Very Positive,77,2,79
432990,0,3 user reviews,3,0,3
433000,8,Very Positive,218,14,232
433020,0,1 user reviews,1,0,1
433040,7,Positive,14,0,14
433080,4,Mostly Negative,204,334,538
433090,4,Mostly Negative,334,514,848
433091,6,Mostly Positive,201,60,261
433100,6,Mostly Positive,404,154,558
433110,5,Mixed,6,4,10
433120,0,6 user reviews,2,4,6
433130,0,6 user reviews,1,5,6
433170,6,Mostly Positive,351,94,445
433190,5,Mixed,47,25,72
433241,6,Mostly Positive,15,6,21
433242,5,Mixed,9,5,14
433270,8,Very Positive,104,2,106
433280,6,Mostly Positive,203,64,267
433290,7,Positive,45,2,47
433300,5,Mixed,198,162,360
433320,5,Mixed,106,142,248
433340,9,Overwhelmingly Positive,25501,666,26167
433350,5,Mixed,9,8,17
433360,0,8 user reviews,4,4,8
433380,6,Mostly Positive,37,13,50
433400,6,Mostly Positive,16,6,22
433420,0,1 user reviews,0,1,1
433430,7,Positive,17,0,17
433450,5,Mixed,26,13,39
433480,0,4 user reviews,4,0,4
433490,7,Positive,11,1,12
433500,7,Positive,34,0,34
433520,7,Positive,15,1,16
433530,6,Mostly Positive,1209,326,1535
433550,9,Overwhelmingly Positive,886,44,930
433570,0,4 user reviews,1,3,4
433580,7,Positive,17,3,20
433590,7,Positive,14,3,17
433600,8,Very Positive,121,30,151
433630,6,Mostly Positive,28,9,37
433650,5,Mixed,6,9,15
433660,0,4 user reviews,4,0,4
433670,3,Negative,1,24,25
433700,7,Positive,22,3,25
433730,5,Mixed,193,151,344
433740,0,4 user reviews,1,3,4
433741,0,5 user reviews,2,3,5
433742,0,3 user reviews,0,3,3
433743,0,2 user reviews,1,1,2
433744,0,5 user reviews,1,4,5
433745,0,3 user reviews,1,2,3
433746,6,Mostly Positive,12,4,16
433747,0,5 user reviews,4,1,5
433750,5,Mixed,17,14,31
433780,0,2 user reviews,2,0,2
433790,0,8 user reviews,3,5,8
433800,4,Mostly Negative,6,11,17
433830,0,4 user reviews,2,2,4
433840,4,Mostly Negative,5,8,13
433850,5,Mixed,19772,19519,39291
433890,7,Positive,12,3,15
433900,5,Mixed,14,12,26
433910,8,Very Positive,587,102,689
433920,7,Positive,44,5,49
433930,4,Mostly Negative,5,8,13
433950,9,Overwhelmingly Positive,2836,74,2910
433960,0,4 user reviews,3,1,4
434000,8,Very Positive,238,30,268
434020,8,Very Positive,147,33,180
434030,6,Mostly Positive,714,208,922
434040,7,Positive,22,2,24
434041,7,Positive,14,1,15
434050,6,Mostly Positive,862,221,1083
434060,0,4 user reviews,3,1,4
434061,7,Positive,22,5,27
434062,7,Positive,9,2,11
434064,4,Mostly Negative,9,25,34
434065,7,Positive,15,2,17
434066,7,Positive,44,4,48
434067,6,Mostly Positive,23,9,32
434068,5,Mixed,24,15,39
434069,5,Mixed,9,11,20
434070,0,5 user reviews,3,2,5
434090,4,Mostly Negative,4,14,18
434120,0,2 user reviews,1,1,2
434130,0,4 user reviews,4,0,4
434140,0,2 user reviews,1,1,2
434150,5,Mixed,7,10,17
434160,6,Mostly Positive,21,9,30
434170,9,Overwhelmingly Positive,1902,57,1959
434190,6,Mostly Positive,19,7,26
434210,8,Very Positive,112,8,120
434220,7,Positive,15,1,16
434230,0,8 user reviews,7,1,8
434240,0,1 user reviews,1,0,1
434250,6,Mostly Positive,250,67,317
434260,8,Very Positive,980,207,1187
434270,0,5 user reviews,2,3,5
434290,5,Mixed,64,28,92
434300,0,2 user reviews,2,0,2
434310,6,Mostly Positive,11,3,14
434340,0,1 user reviews,1,0,1
434350,0,7 user reviews,7,0,7
434360,4,Mostly Negative,12,21,33
434370,8,Very Positive,120,5,125
434390,0,4 user reviews,4,0,4
434400,0,2 user reviews,2,0,2
434410,8,Very Positive,94,4,98
434420,5,Mixed,284,153,437
434430,0,5 user reviews,4,1,5
434460,8,Very Positive,600,67,667
434470,0,5 user reviews,4,1,5
434480,0,1 user reviews,0,1,1
434490,0,6 user reviews,6,0,6
434500,0,8 user reviews,2,6,8
434510,0,8 user reviews,8,0,8
434520,0,4 user reviews,3,1,4
434530,7,Positive,14,1,15
434540,0,1 user reviews,0,1,1
434570,9,Overwhelmingly Positive,8755,396,9151
434600,0,9 user reviews,7,2,9
434610,4,Mostly Negative,12,21,33
434620,6,Mostly Positive,77,31,108
434631,0,1 user reviews,1,0,1
434640,0,1 user reviews,1,0,1
434650,6,Mostly Positive,835,223,1058
434660,7,Positive,44,1,45
434680,5,Mixed,19,10,29
434700,0,4 user reviews,2,2,4
434730,6,Mostly Positive,787,236,1023
434740,6,Mostly Positive,55,15,70
434750,7,Positive,19,0,19
434780,4,Mostly Negative,5,11,16
434790,0,5 user reviews,1,4,5
434800,0,6 user reviews,1,5,6
434820,7,Positive,17,3,20
434860,0,4 user reviews,3,1,4
434870,0,3 user reviews,2,1,3
434880,5,Mixed,35,20,55
434890,6,Mostly Positive,11,4,15
434900,7,Positive,18,0,18
434901,6,Mostly Positive,15,5,20
434910,7,Positive,17,3,20
434920,6,Mostly Positive,14,6,20
434930,4,Mostly Negative,4,7,11
434940,0,3 user reviews,1,2,3
434941,0,4 user reviews,1,3,4
434942,0,3 user reviews,1,2,3
434943,0,5 user reviews,2,3,5
434944,0,6 user reviews,4,2,6
434960,0,1 user reviews,0,1,1
434970,0,2 user reviews,1,1,2
434980,7,Positive,9,1,10
435000,6,Mostly Positive,23,6,29
435010,7,Positive,8,2,10
435020,6,Mostly Positive,66,28,94
435030,7,Positive,32,2,34
435040,7,Positive,13,2,15
435050,0,3 user reviews,1,2,3
435070,0,9 user reviews,4,5,9
435080,0,1 user reviews,1,0,1
435100,5,Mixed,36,16,52
435111,7,Positive,33,8,41
435120,8,Very Positive,771,72,843
435140,0,6 user reviews,6,0,6
435150,9,Overwhelmingly Positive,45093,1991,47084
435190,0,7 user reviews,4,3,7
435200,0,2 user reviews,1,1,2
435210,7,Positive,9,1,10
435230,5,Mixed,4,6,10
435250,6,Mostly Positive,23,8,31
435260,6,Mostly Positive,13,4,17
435300,8,Very Positive,422,28,450
435360,7,Positive,38,2,40
435400,9,Overwhelmingly Positive,2050,66,2116
435420,5,Mixed,13,10,23
435440,0,2 user reviews,2,0,2
435460,7,Positive,39,2,41
435480,5,Mixed,67,39,106
435490,8,Very Positive,180,16,196
435530,6,Mostly Positive,1068,322,1390
435570,0,3 user reviews,2,1,3
435600,0,4 user reviews,2,2,4
435730,0,3 user reviews,3,0,3
435780,0,2 user reviews,0,2,2
435790,7,Positive,38,3,41
435800,7,Positive,30,3,33
435840,7,Positive,34,1,35
435881,8,Very Positive,1271,231,1502
435890,0,1 user reviews,0,1,1
435910,7,Positive,40,3,43
435970,7,Positive,30,0,30
436000,6,Mostly Positive,39,13,52
436030,5,Mixed,34,22,56
436040,5,Mixed,5,5,10
436050,0,9 user reviews,5,4,9
436060,0,6 user reviews,5,1,6
436070,7,Positive,20,2,22
436080,8,Very Positive,52,9,61
436081,7,Positive,37,6,43
436082,8,Very Positive,45,8,53
436090,7,Positive,24,0,24
436110,7,Positive,12,3,15
436120,4,Mostly Negative,74,113,187
436121,4,Mostly Negative,9,22,31
436140,7,Positive,10,2,12
436150,6,Mostly Positive,29,11,40
436160,0,4 user reviews,2,2,4
436180,5,Mixed,26,21,47
436220,8,Very Positive,112,8,120
436230,5,Mixed,106,49,155
436240,5,Mixed,9,5,14
436250,0,1 user reviews,1,0,1
436260,4,Mostly Negative,5,8,13
436270,5,Mixed,12,7,19
436280,5,Mixed,8,6,14
436290,5,Mixed,135,62,197
436320,8,Very Positive,1313,246,1559
436340,0,2 user reviews,2,0,2
436350,0,6 user reviews,5,1,6
436360,0,4 user reviews,3,1,4
436390,8,Very Positive,116,11,127
436400,7,Positive,22,4,26
436410,0,6 user reviews,1,5,6
436420,0,1 user reviews,1,0,1
436430,0,4 user reviews,4,0,4
436470,7,Positive,13,1,14
436480,5,Mixed,10,6,16
436490,6,Mostly Positive,103,31,134
436500,6,Mostly Positive,295,84,379
436510,0,7 user reviews,5,2,7
436520,5,Mixed,665,600,1265
436530,6,Mostly Positive,32,11,43
436550,0,9 user reviews,7,2,9
436560,5,Mixed,287,258,545
436571,0,5 user reviews,5,0,5
436572,4,Mostly Negative,4,8,12
436573,0,1 user reviews,1,0,1
436574,0,1 user reviews,1,0,1
436575,0,1 user reviews,1,0,1
436579,0,1 user reviews,1,0,1
436580,0,1 user reviews,1,0,1
436588,0,1 user reviews,0,1,1
436593,0,1 user reviews,1,0,1
436594,0,2 user reviews,1,1,2
436597,0,1 user reviews,1,0,1
436598,0,2 user reviews,2,0,2
436603,0,1 user reviews,1,0,1
436604,0,1 user reviews,1,0,1
436605,0,2 user reviews,2,0,2
436606,0,1 user reviews,1,0,1
436612,0,1 user reviews,1,0,1
436617,0,2 user reviews,1,1,2
436622,0,1 user reviews,1,0,1
436627,0,1 user reviews,0,1,1
436630,0,2 user reviews,2,0,2
436632,0,1 user reviews,1,0,1
436633,0,1 user reviews,1,0,1
436636,0,1 user reviews,0,1,1
436640,0,1 user reviews,1,0,1
436641,0,1 user reviews,1,0,1
436643,0,2 user reviews,1,1,2
436644,0,2 user reviews,2,0,2
436652,0,1 user reviews,1,0,1
436658,0,3 user reviews,3,0,3
436665,0,1 user reviews,1,0,1
436670,9,Overwhelmingly Positive,565,29,594
436680,0,1 user reviews,0,1,1
436690,6,Mostly Positive,12,5,17
436790,0,2 user reviews,2,0,2
436820,7,Positive,20,0,20
436850,0,1 user reviews,1,0,1
436860,5,Mixed,13,14,27
436870,5,Mixed,7,4,11
436890,0,1 user reviews,1,0,1
436940,7,Positive,41,4,45
436950,0,2 user reviews,1,1,2
437000,6,Mostly Positive,49,15,64
437020,7,Positive,40,3,43
437030,6,Mostly Positive,9,3,12
437060,7,Positive,9,1,10
437070,8,Very Positive,49,7,56
437080,5,Mixed,25,12,37
437090,0,2 user reviews,1,1,2
437100,7,Positive,16,2,18
437110,0,2 user reviews,1,1,2
437140,4,Mostly Negative,3,8,11
437160,8,Very Positive,136,8,144
437170,0,7 user reviews,5,2,7
437180,0,3 user reviews,3,0,3
437210,0,9 user reviews,6,3,9
437220,5,Mixed,4984,3549,8533
437230,6,Mostly Positive,10,4,14
437231,5,Mixed,9,5,14
437233,5,Mixed,11,12,23
437240,0,3 user reviews,3,0,3
437250,8,Very Positive,217,42,259
437340,0,2 user reviews,2,0,2
437360,0,4 user reviews,4,0,4
437380,0,5 user reviews,5,0,5
437390,7,Positive,9,2,11
437420,8,Very Positive,60,10,70
437430,0,3 user reviews,3,0,3
437520,7,Positive,38,1,39
437530,5,Mixed,35,17,52
437550,7,Positive,32,7,39
437560,0,3 user reviews,3,0,3
437570,8,Very Positive,353,50,403
437590,0,9 user reviews,8,1,9
437610,7,Positive,36,3,39
437630,8,Very Positive,205,46,251
437660,0,2 user reviews,1,1,2
437690,7,Positive,24,5,29
437700,5,Mixed,154,113,267
437701,6,Mostly Positive,46,13,59
437702,6,Mostly Positive,29,12,41
437710,0,3 user reviews,3,0,3
437720,0,1 user reviews,1,0,1
437730,6,Mostly Positive,18,5,23
437740,4,Mostly Negative,5,11,16
437750,0,7 user reviews,6,1,7
437790,0,1 user reviews,1,0,1
437870,5,Mixed,36,47,83
437880,0,7 user reviews,7,0,7
437900,0,9 user reviews,6,3,9
437920,8,Very Positive,737,121,858
437930,0,1 user reviews,1,0,1
438000,7,Positive,13,3,16
438010,4,Mostly Negative,8,20,28
438020,2,Very Negative,10,44,54
438030,4,Mostly Negative,34,65,99
438040,5,Mixed,37,16,53
438080,8,Very Positive,99,21,120
438090,0,3 user reviews,0,3,3
438100,8,Very Positive,100,17,117
438110,0,5 user reviews,2,3,5
438130,8,Very Positive,117,10,127
438140,8,Very Positive,46,9,55
438150,5,Mixed,18,11,29
438160,0,3 user reviews,3,0,3
438180,5,Mixed,78,36,114
438220,0,6 user reviews,4,2,6
438240,0,1 user reviews,1,0,1
438260,6,Mostly Positive,7,3,10
438270,8,Very Positive,1008,78,1086
438300,5,Mixed,10,6,16
438310,5,Mixed,10,9,19
438320,8,Very Positive,61,7,68
438340,5,Mixed,37,29,66
438350,7,Positive,17,2,19
438360,0,4 user reviews,2,2,4
438420,5,Mixed,92,48,140
438430,6,Mostly Positive,65,19,84
438440,0,3 user reviews,3,0,3
438450,7,Positive,27,0,27
438460,7,Positive,22,2,24
438480,8,Very Positive,243,59,302
438490,8,Very Positive,1243,196,1439
438550,0,2 user reviews,1,1,2
438560,5,Mixed,16,9,25
438600,0,4 user reviews,4,0,4
438640,6,Mostly Positive,956,278,1234
438650,5,Mixed,7,6,13
438660,0,8 user reviews,7,1,8
438680,6,Mostly Positive,10,3,13
438690,6,Mostly Positive,525,177,702
438710,0,6 user reviews,6,0,6
438720,0,1 user reviews,1,0,1
438730,5,Mixed,9,8,17
438740,6,Mostly Positive,9762,3676,13438
438770,0,2 user reviews,0,2,2
438780,0,2 user reviews,0,2,2
438790,0,6 user reviews,2,4,6
438800,0,4 user reviews,2,2,4
438801,0,3 user reviews,3,0,3
438802,0,3 user reviews,3,0,3
438820,6,Mostly Positive,11,4,15
438840,0,3 user reviews,1,2,3
438870,0,1 user reviews,1,0,1
438910,0,7 user reviews,2,5,7
438920,7,Positive,27,4,31
438940,7,Positive,11,1,12
438980,0,4 user reviews,4,0,4
439190,8,Very Positive,840,146,986
439241,5,Mixed,25,28,53
439250,8,Very Positive,106,6,112
439260,7,Positive,26,2,28
439310,6,Mostly Positive,61,25,86
439330,0,3 user reviews,3,0,3
439340,5,Mixed,319,149,468
439350,0,1 user reviews,1,0,1
439370,6,Mostly Positive,57,18,75
439420,0,6 user reviews,3,3,6
439440,6,Mostly Positive,12,4,16
439450,0,7 user reviews,7,0,7
439460,4,Mostly Negative,23,35,58
439480,7,Positive,33,0,33
439490,8,Very Positive,166,2,168
439500,0,1 user reviews,1,0,1
439501,0,2 user reviews,2,0,2
439510,0,1 user reviews,1,0,1
439530,5,Mixed,6,5,11
439540,7,Positive,11,0,11
439541,0,3 user reviews,2,1,3
439550,4,Mostly Negative,13,20,33
439560,0,3 user reviews,3,0,3
439580,0,1 user reviews,1,0,1
439610,0,2 user reviews,1,1,2
439630,0,6 user reviews,5,1,6
439640,0,4 user reviews,4,0,4
439650,8,Very Positive,84,10,94
439660,0,1 user reviews,1,0,1
439720,5,Mixed,46,29,75
439730,0,5 user reviews,4,1,5
439750,6,Mostly Positive,21,7,28
439770,6,Mostly Positive,33,10,43
439800,6,Mostly Positive,8,3,11
439880,7,Positive,9,1,10
439890,8,Very Positive,117,20,137
439900,0,2 user reviews,2,0,2
439910,6,Mostly Positive,66,18,84
439920,6,Mostly Positive,64,23,87
439930,4,Mostly Negative,8,19,27
439940,7,Positive,8,2,10
439950,4,Mostly Negative,18,29,47
439960,0,9 user reviews,5,4,9
440020,4,Mostly Negative,22,39,61
440030,0,2 user reviews,1,1,2
440040,0,2 user reviews,1,1,2
440050,0,2 user reviews,0,2,2
440090,0,9 user reviews,7,2,9
440100,0,3 user reviews,2,1,3
440130,7,Positive,15,1,16
440140,0,6 user reviews,4,2,6
440150,7,Positive,21,0,21
440160,7,Positive,26,5,31
440200,0,2 user reviews,2,0,2
440210,0,1 user reviews,0,1,1
440240,0,3 user reviews,3,0,3
440250,7,Positive,17,0,17
440280,7,Positive,12,2,14
440310,9,Overwhelmingly Positive,518,10,528
440340,5,Mixed,26,13,39
440370,0,1 user reviews,1,0,1
440380,0,2 user reviews,2,0,2
440400,5,Mixed,9,6,15
440410,6,Mostly Positive,7,3,10
440420,8,Very Positive,199,23,222
440450,5,Mixed,17,11,28
440470,0,4 user reviews,0,4,4
440520,5,Mixed,101,116,217
440540,9,Overwhelmingly Positive,529,23,552
440550,8,Very Positive,108,13,121
440630,8,Very Positive,486,78,564
440640,7,Positive,13,2,15
440650,8,Very Positive,2306,228,2534
440660,7,Positive,13,1,14
440690,6,Mostly Positive,12,4,16
440720,0,4 user reviews,1,3,4
440730,5,Mixed,198,142,340
440740,0,3 user reviews,2,1,3
440750,0,6 user reviews,5,1,6
440760,6,Mostly Positive,151,39,190
440770,0,6 user reviews,1,5,6
440790,0,3 user reviews,1,2,3
440800,0,5 user reviews,4,1,5
440810,4,Mostly Negative,5,13,18
440820,8,Very Positive,111,0,111
440860,0,2 user reviews,2,0,2
440870,5,Mixed,9,5,14
440880,8,Very Positive,273,23,296
440900,6,Mostly Positive,17253,4656,21909
440930,8,Very Positive,52,9,61
440950,5,Mixed,7,6,13
440960,7,Positive,41,7,48
440961,7,Positive,34,6,40
440962,7,Positive,34,2,36
441010,8,Very Positive,152,14,166
441050,8,Very Positive,249,18,267
441060,6,Mostly Positive,17,6,23
441080,0,1 user reviews,1,0,1
441100,0,6 user reviews,6,0,6
441110,7,Positive,14,0,14
441120,0,2 user reviews,2,0,2
441160,7,Positive,19,0,19
441170,0,3 user reviews,3,0,3
441180,0,3 user reviews,3,0,3
441190,0,2 user reviews,0,2,2
441230,7,Positive,20,4,24
441250,5,Mixed,16,17,33
441260,0,1 user reviews,1,0,1
441270,0,8 user reviews,7,1,8
441280,8,Very Positive,135,11,146
441300,0,1 user reviews,1,0,1
441340,6,Mostly Positive,584,228,812
441350,6,Mostly Positive,39,14,53
441380,5,Mixed,127,70,197
441440,5,Mixed,43,20,63
441450,5,Mixed,10,7,17
441480,0,4 user reviews,3,1,4
441510,0,6 user reviews,5,1,6
441540,8,Very Positive,72,0,72
441550,8,Very Positive,360,56,416
441600,8,Very Positive,336,56,392
441610,0,1 user reviews,1,0,1
441640,0,9 user reviews,1,8,9
441670,6,Mostly Positive,63,20,83
441680,5,Mixed,15,10,25
441700,8,Very Positive,48,9,57
441710,0,4 user reviews,4,0,4
441720,5,Mixed,9,12,21
441730,5,Mixed,13,16,29
441770,7,Positive,41,2,43
441782,0,3 user reviews,3,0,3
441790,4,Mostly Negative,171,352,523
441830,6,Mostly Positive,622,259,881
441850,0,1 user reviews,0,1,1
441870,6,Mostly Positive,871,355,1226
441920,5,Mixed,188,180,368
441940,0,7 user reviews,7,0,7
441950,0,1 user reviews,1,0,1
441960,0,1 user reviews,1,0,1
442000,3,Negative,1,16,17
442010,5,Mixed,324,169,493
442050,5,Mixed,21,20,41
442051,6,Mostly Positive,74,27,101
442052,6,Mostly Positive,50,14,64
442070,8,Very Positive,410,40,450
442080,6,Mostly Positive,315,121,436
442090,0,1 user reviews,1,0,1
442120,8,Very Positive,313,21,334
442140,0,8 user reviews,5,3,8
442180,0,3 user reviews,0,3,3
442190,0,5 user reviews,2,3,5
442210,8,Very Positive,70,6,76
442220,0,7 user reviews,5,2,7
442260,0,8 user reviews,7,1,8
442290,5,Mixed,23,12,35
442500,6,Mostly Positive,295,94,389
442660,5,Mixed,31,19,50
442710,0,4 user reviews,4,0,4
442760,0,2 user reviews,0,2,2
442770,0,9 user reviews,4,5,9
442780,6,Mostly Positive,857,282,1139
442810,0,3 user reviews,0,3,3
442830,0,2 user reviews,2,0,2
442840,0,1 user reviews,1,0,1
442890,5,Mixed,27,18,45
443000,8,Very Positive,51,12,63
443020,6,Mostly Positive,49,15,64
443070,0,4 user reviews,0,4,4
443080,5,Mixed,9,10,19
443110,0,1 user reviews,1,0,1
443250,5,Mixed,7,4,11
443260,5,Mixed,21,13,34
443300,0,1 user reviews,1,0,1
443330,6,Mostly Positive,47,19,66
443360,5,Mixed,6,7,13
443370,5,Mixed,14,11,25
443380,8,Very Positive,44,6,50
443390,0,3 user reviews,3,0,3
443400,0,3 user reviews,3,0,3
443420,6,Mostly Positive,35,11,46
443430,7,Positive,10,1,11
443450,5,Mixed,20,9,29
443460,7,Positive,14,2,16
443570,0,9 user reviews,6,3,9
443580,6,Mostly Positive,14,6,20
443620,6,Mostly Positive,15,4,19
443630,7,Positive,16,3,19
443650,6,Mostly Positive,42,16,58
443680,0,9 user reviews,6,3,9
443690,0,4 user reviews,4,0,4
443691,7,Positive,34,7,41
443700,6,Mostly Positive,9,3,12
443710,0,1 user reviews,0,1,1
443720,7,Positive,9,2,11
443730,8,Very Positive,77,13,90
443760,0,2 user reviews,2,0,2
443780,0,1 user reviews,0,1,1
443800,5,Mixed,29,16,45
443810,6,Mostly Positive,1626,592,2218
443830,5,Mixed,10,7,17
443850,5,Mixed,6,6,12
443860,8,Very Positive,85,12,97
443880,7,Positive,36,4,40
443890,7,Positive,28,4,32
443900,4,Mostly Negative,6,11,17
443910,0,1 user reviews,1,0,1
443970,5,Mixed,71,34,105
443980,5,Mixed,19,9,28
444000,8,Very Positive,79,8,87
444020,0,6 user reviews,3,3,6
444030,0,1 user reviews,0,1,1
444090,6,Mostly Positive,2752,809,3561
444130,6,Mostly Positive,38,15,53
444140,8,Very Positive,214,23,237
444160,5,Mixed,20,24,44
444170,7,Positive,38,2,40
444180,5,Mixed,32,15,47
444190,7,Positive,10,2,12
444200,6,Mostly Positive,122,51,173
444210,0,4 user reviews,0,4,4
444220,5,Mixed,50,42,92
444250,0,8 user reviews,6,2,8
444260,5,Mixed,63,49,112
444270,6,Mostly Positive,13,4,17
444280,7,Positive,30,5,35
444320,5,Mixed,12,16,28
444330,0,1 user reviews,1,0,1
444350,4,Mostly Negative,23,82,105
444360,0,1 user reviews,1,0,1
444390,0,2 user reviews,2,0,2
444410,5,Mixed,7,5,12
444420,3,Negative,2,12,14
444430,0,7 user reviews,5,2,7
444440,5,Mixed,6,9,15
444460,3,Negative,3,23,26
444470,0,4 user reviews,3,1,4
444480,5,Mixed,50,31,81
444490,6,Mostly Positive,119,46,165
444520,5,Mixed,7,6,13
444530,7,Positive,31,3,34
444550,7,Positive,8,2,10
444560,0,2 user reviews,1,1,2
444580,4,Mostly Negative,26,47,73
444590,8,Very Positive,194,41,235
444610,0,1 user reviews,1,0,1
444611,0,1 user reviews,1,0,1
444620,0,1 user reviews,1,0,1
444640,8,Very Positive,218,36,254
444650,5,Mixed,16,20,36
444670,8,Very Positive,58,8,66
444680,7,Positive,12,2,14
444690,5,Mixed,40,31,71
444710,7,Positive,17,0,17
444720,5,Mixed,85,60,145
444740,0,3 user reviews,1,2,3
444760,0,1 user reviews,1,0,1
444770,8,Very Positive,43,7,50
444800,8,Very Positive,119,13,132
444820,0,2 user reviews,2,0,2
444830,0,8 user reviews,6,2,8
444870,0,3 user reviews,2,1,3
444880,6,Mostly Positive,85,30,115
444890,0,2 user reviews,1,1,2
444930,8,Very Positive,55,7,62
444940,8,Very Positive,109,17,126
444950,0,2 user reviews,1,1,2
444970,6,Mostly Positive,68,23,91
444990,0,2 user reviews,0,2,2
445000,0,5 user reviews,4,1,5
445020,5,Mixed,111,58,169
445040,7,Positive,41,3,44
445050,0,2 user reviews,1,1,2
445070,6,Mostly Positive,12,5,17
445110,8,Very Positive,164,18,182
445130,5,Mixed,8,4,12
445140,5,Mixed,22,11,33
445170,7,Positive,10,0,10
445190,8,Very Positive,1077,219,1296
445210,5,Mixed,9,4,13
445220,8,Very Positive,3780,385,4165
445230,0,8 user reviews,5,3,8
445260,7,Positive,13,0,13
445261,0,5 user reviews,4,1,5
445310,5,Mixed,151,110,261
445320,0,1 user reviews,1,0,1
445321,0,2 user reviews,1,1,2
445340,0,3 user reviews,3,0,3
445341,0,1 user reviews,1,0,1
445350,0,8 user reviews,2,6,8
445380,0,2 user reviews,1,1,2
445420,7,Positive,38,7,45
445430,7,Positive,11,2,13
445550,0,2 user reviews,2,0,2
445600,5,Mixed,26,15,41
445670,5,Mixed,5,7,12
445680,0,9 user reviews,9,0,9
445690,6,Mostly Positive,76,24,100
445720,4,Mostly Negative,6,17,23
445750,8,Very Positive,51,9,60
445770,8,Very Positive,150,25,175
445800,8,Very Positive,83,15,98
445840,0,1 user reviews,1,0,1
445860,6,Mostly Positive,20,7,27
445870,0,9 user reviews,7,2,9
445890,0,8 user reviews,8,0,8
445920,0,2 user reviews,2,0,2
445950,7,Positive,9,1,10
445980,8,Very Positive,3291,272,3563
445990,5,Mixed,21,11,32
446000,6,Mostly Positive,107,33,140
446010,0,5 user reviews,2,3,5
446020,6,Mostly Positive,2191,631,2822
446040,7,Positive,40,9,49
446050,0,4 user reviews,1,3,4
446060,7,Positive,23,1,24
446070,7,Positive,9,1,10
446090,0,5 user reviews,5,0,5
446100,7,Positive,29,7,36
446110,0,1 user reviews,1,0,1
446120,6,Mostly Positive,170,45,215
446240,5,Mixed,10,7,17
446250,7,Positive,8,2,10
446270,0,1 user reviews,1,0,1
446310,8,Very Positive,83,5,88
446330,8,Very Positive,67,4,71
446360,0,1 user reviews,1,0,1
446380,8,Very Positive,126,22,148
446390,6,Mostly Positive,186,75,261
446430,0,1 user reviews,0,1,1
446440,0,1 user reviews,0,1,1
446450,0,5 user reviews,1,4,5
446460,0,5 user reviews,4,1,5
446470,0,6 user reviews,3,3,6
446480,0,6 user reviews,1,5,6
446490,4,Mostly Negative,3,7,10
446510,0,2 user reviews,2,0,2
446520,5,Mixed,6,4,10
446540,5,Mixed,31,24,55
446550,5,Mixed,30,16,46
446560,6,Mostly Positive,193,74,267
446570,0,4 user reviews,0,4,4
446590,5,Mixed,22,17,39
446600,8,Very Positive,55,11,66
446610,5,Mixed,15,11,26
446620,8,Very Positive,172,15,187
446640,8,Very Positive,123,7,130
446740,0,6 user reviews,5,1,6
446750,7,Positive,17,0,17
446760,7,Positive,14,2,16
446770,0,3 user reviews,3,0,3
446780,4,Mostly Negative,27,54,81
446790,5,Mixed,283,153,436
446800,6,Mostly Positive,2900,729,3629
446810,8,Very Positive,102,23,125
446830,7,Positive,39,4,43
446840,8,Very Positive,65,1,66
446850,7,Positive,15,1,16
446870,4,Mostly Negative,3,9,12
446890,0,1 user reviews,1,0,1
446900,0,2 user reviews,0,2,2
446910,7,Positive,44,1,45
446960,0,1 user reviews,1,0,1
446980,7,Positive,28,5,33
446990,7,Positive,41,8,49
447000,7,Positive,15,1,16
447020,8,Very Positive,5193,441,5634
447040,8,Very Positive,10257,2446,12703
447100,4,Mostly Negative,5,13,18
447120,8,Very Positive,280,65,345
447150,8,Very Positive,791,45,836
447170,5,Mixed,62,33,95
447180,5,Mixed,39,23,62
447190,8,Very Positive,76,15,91
447200,8,Very Positive,72,9,81
447210,7,Positive,33,3,36
447220,0,9 user reviews,9,0,9
447240,7,Positive,13,1,14
447250,0,1 user reviews,1,0,1
447270,0,2 user reviews,2,0,2
447290,8,Very Positive,403,90,493
447310,6,Mostly Positive,33,12,45
447400,0,6 user reviews,6,0,6
447410,7,Positive,12,0,12
447480,0,1 user reviews,1,0,1
447500,4,Mostly Negative,132,303,435
447510,8,Very Positive,82,3,85
447530,9,Overwhelmingly Positive,6987,201,7188
447540,0,2 user reviews,0,2,2
447570,0,6 user reviews,6,0,6
447690,6,Mostly Positive,22,7,29
447700,7,Positive,34,6,40
447780,8,Very Positive,102,19,121
447800,6,Mostly Positive,45,13,58
447820,8,Very Positive,7670,1203,8873
447850,4,Mostly Negative,3,8,11
447860,5,Mixed,9,7,16
447890,6,Mostly Positive,123,45,168
447920,0,7 user reviews,1,6,7
447930,0,2 user reviews,2,0,2
447940,0,5 user reviews,1,4,5
447950,7,Positive,20,2,22
447960,5,Mixed,15,10,25
447980,0,8 user reviews,8,0,8
447990,0,1 user reviews,1,0,1
448000,5,Mixed,27,32,59
448010,7,Positive,11,0,11
448020,4,Mostly Negative,17,28,45
448050,7,Positive,12,2,14
448060,4,Mostly Negative,5,13,18
448070,5,Mixed,31,44,75
448080,8,Very Positive,125,7,132
448090,0,8 user reviews,4,4,8
448110,0,6 user reviews,4,2,6
448140,0,3 user reviews,0,3,3
448150,5,Mixed,17,8,25
448160,7,Positive,35,4,39
448170,7,Positive,32,8,40
448180,0,5 user reviews,5,0,5
448182,0,8 user reviews,8,0,8
448183,0,2 user reviews,2,0,2
448184,4,Mostly Negative,20,31,51
448185,0,5 user reviews,4,1,5
448186,7,Positive,12,3,15
448188,7,Positive,13,3,16
448190,5,Mixed,23,16,39
448191,7,Positive,11,0,11
448192,5,Mixed,10,9,19
448194,0,6 user reviews,6,0,6
448195,0,6 user reviews,6,0,6
448198,6,Mostly Positive,10,3,13
448199,0,3 user reviews,3,0,3
448202,0,1 user reviews,1,0,1
448203,0,2 user reviews,1,1,2
448204,0,1 user reviews,1,0,1
448230,0,9 user reviews,4,5,9
448240,5,Mixed,153,122,275
448280,8,Very Positive,1270,149,1419
448290,8,Very Positive,211,40,251
448300,0,1 user reviews,0,1,1
448310,0,3 user reviews,1,2,3
448320,6,Mostly Positive,113,30,143
448370,8,Very Positive,625,39,664
448380,7,Positive,11,1,12
448400,8,Very Positive,56,11,67
448440,5,Mixed,36,35,71
448450,0,1 user reviews,1,0,1
448470,5,Mixed,17,14,31
448480,5,Mixed,5,5,10
448500,7,Positive,15,1,16
448510,8,Very Positive,3198,239,3437
448520,0,8 user reviews,8,0,8
448530,0,8 user reviews,7,1,8
448540,5,Mixed,15,14,29
448550,0,4 user reviews,3,1,4
448560,5,Mixed,22,24,46
448580,8,Very Positive,109,16,125
448610,5,Mixed,30,19,49
448620,4,Mostly Negative,7,16,23
448630,4,Mostly Negative,9,19,28
448640,7,Positive,16,4,20
448650,6,Mostly Positive,15,4,19
448670,5,Mixed,18,16,34
448690,0,9 user reviews,4,5,9
448710,0,2 user reviews,2,0,2
448720,6,Mostly Positive,7,3,10
448730,5,Mixed,6,4,10
448750,0,9 user reviews,5,4,9
448760,0,1 user reviews,1,0,1
448780,6,Mostly Positive,211,72,283
448790,0,7 user reviews,3,4,7
448800,7,Positive,24,4,28
448810,0,7 user reviews,6,1,7
448820,0,8 user reviews,5,3,8
448830,5,Mixed,16,9,25
448850,8,Very Positive,834,52,886
448880,0,3 user reviews,1,2,3
448910,8,Very Positive,58,11,69
448960,7,Positive,11,1,12
448990,0,2 user reviews,1,1,2
449020,0,4 user reviews,3,1,4
449040,6,Mostly Positive,19,5,24
449050,0,2 user reviews,1,1,2
449060,8,Very Positive,60,11,71
449070,0,7 user reviews,2,5,7
449090,6,Mostly Positive,26,11,37
449100,0,8 user reviews,6,2,8
449120,0,9 user reviews,5,4,9
449140,7,Positive,29,3,32
449150,0,5 user reviews,4,1,5
449160,0,5 user reviews,5,0,5
449170,7,Positive,29,1,30
449180,0,3 user reviews,3,0,3
449200,5,Mixed,10,15,25
449210,8,Very Positive,182,23,205
449220,7,Positive,22,3,25
449230,3,Negative,0,14,14
449240,0,5 user reviews,5,0,5
449250,8,Very Positive,144,9,153
449300,5,Mixed,102,83,185
449310,0,3 user reviews,2,1,3
449320,0,9 user reviews,6,3,9
449330,0,5 user reviews,3,2,5
449340,7,Positive,13,0,13
449350,5,Mixed,7,7,14
449360,7,Positive,17,0,17
449370,0,1 user reviews,1,0,1
449380,7,Positive,10,1,11
449390,0,5 user reviews,3,2,5
449391,0,4 user reviews,3,1,4
449392,0,2 user reviews,2,0,2
449393,5,Mixed,9,8,17
449394,0,2 user reviews,2,0,2
449400,0,2 user reviews,2,0,2
449450,6,Mostly Positive,7,3,10
449460,5,Mixed,35,21,56
449470,0,2 user reviews,2,0,2
449500,0,3 user reviews,0,3,3
449510,5,Mixed,26,15,41
449520,0,4 user reviews,2,2,4
449530,5,Mixed,73,37,110
449540,8,Very Positive,1414,175,1589
449550,8,Very Positive,80,3,83
449560,0,1 user reviews,1,0,1
449570,0,1 user reviews,1,0,1
449610,8,Very Positive,364,40,404
449610,8,Very Positive,364,40,404
449640,6,Mostly Positive,19,5,24
449670,5,Mixed,9,4,13
449671,0,6 user reviews,4,2,6
449680,8,Very Positive,140,33,173
449690,5,Mixed,13,9,22
449700,0,6 user reviews,6,0,6
449710,6,Mostly Positive,165,60,225
449720,7,Positive,8,2,10
449730,8,Very Positive,91,12,103
449760,6,Mostly Positive,21,9,30
449770,0,2 user reviews,2,0,2
449800,8,Very Positive,1409,321,1730
449820,5,Mixed,23,25,48
449930,0,1 user reviews,1,0,1
449940,5,Mixed,7,5,12
449950,0,3 user reviews,3,0,3
449960,8,Very Positive,3401,349,3750
449980,8,Very Positive,220,27,247
449981,5,Mixed,13,9,22
450010,6,Mostly Positive,7,3,10
450020,0,1 user reviews,0,1,1
450030,0,6 user reviews,1,5,6
450040,4,Mostly Negative,2,8,10
450050,5,Mixed,12,16,28
450060,5,Mixed,11,12,23
450080,0,8 user reviews,5,3,8
450100,0,2 user reviews,2,0,2
450110,7,Positive,10,2,12
450120,7,Positive,34,7,41
450130,0,6 user reviews,2,4,6
450140,8,Very Positive,51,1,52
450150,0,1 user reviews,1,0,1
450170,6,Mostly Positive,51,17,68
450190,5,Mixed,30,13,43
450220,7,Positive,19,1,20
450230,0,1 user reviews,1,0,1
450250,6,Mostly Positive,15,4,19
450260,0,3 user reviews,0,3,3
450290,5,Mixed,6,8,14
450310,0,1 user reviews,1,0,1
450390,8,Very Positive,94,2,96
450440,8,Very Positive,84,12,96
450480,0,3 user reviews,1,2,3
450500,8,Very Positive,193,17,210
450530,0,7 user reviews,1,6,7
450540,9,Overwhelmingly Positive,6655,226,6881
450550,8,Very Positive,109,7,116
450570,0,8 user reviews,1,7,8
450590,4,Mostly Negative,7,17,24
450600,5,Mixed,8,9,17
450630,0,9 user reviews,7,2,9
450650,0,7 user reviews,7,0,7
450660,8,Very Positive,251,30,281
450670,6,Mostly Positive,82,32,114
450700,6,Mostly Positive,89,31,120
450740,4,Mostly Negative,6,10,16
450750,0,6 user reviews,5,1,6
450760,0,6 user reviews,6,0,6
450790,6,Mostly Positive,111,30,141
450810,0,5 user reviews,5,0,5
450811,0,6 user reviews,5,1,6
450812,7,Positive,22,1,23
450820,5,Mixed,10,6,16
450850,4,Mostly Negative,6,10,16
450860,5,Mixed,51,34,85
450880,0,1 user reviews,1,0,1
450950,8,Very Positive,76,5,81
450960,6,Mostly Positive,10,3,13
451000,0,9 user reviews,8,1,9
451010,8,Very Positive,118,16,134
451020,8,Very Positive,1513,211,1724
451030,0,9 user reviews,9,0,9
451040,0,1 user reviews,1,0,1
451050,8,Very Positive,48,3,51
451060,0,2 user reviews,0,2,2
451080,6,Mostly Positive,17,7,24
451100,0,4 user reviews,4,0,4
451110,0,2 user reviews,0,2,2
451130,0,2 user reviews,1,1,2
451140,6,Mostly Positive,14,4,18
451160,0,3 user reviews,3,0,3
451180,0,6 user reviews,1,5,6
451200,0,8 user reviews,8,0,8
451210,0,4 user reviews,1,3,4
451230,0,1 user reviews,0,1,1
451280,0,2 user reviews,1,1,2
451290,0,9 user reviews,9,0,9
451310,6,Mostly Positive,16,6,22
451320,5,Mixed,25,14,39
451340,5,Mixed,2658,1328,3986
451350,0,6 user reviews,3,3,6
451370,0,4 user reviews,4,0,4
451400,5,Mixed,18,14,32
451410,0,3 user reviews,2,1,3
451430,0,1 user reviews,0,1,1
451442,0,2 user reviews,1,1,2
451443,0,1 user reviews,0,1,1
451450,0,7 user reviews,5,2,7
451480,0,3 user reviews,1,2,3
451490,0,4 user reviews,4,0,4
451500,0,1 user reviews,1,0,1
451520,8,Very Positive,665,114,779
451540,0,2 user reviews,2,0,2
451560,0,2 user reviews,0,2,2
451570,6,Mostly Positive,55,15,70
451600,8,Very Positive,100,7,107
451630,7,Positive,12,1,13
451640,7,Positive,35,4,39
451650,8,Very Positive,217,53,270
451660,5,Mixed,9,10,19
451670,3,Negative,2,16,18
451690,0,7 user reviews,4,3,7
451700,0,1 user reviews,1,0,1
451710,0,1 user reviews,1,0,1
451760,9,Overwhelmingly Positive,670,25,695
451780,6,Mostly Positive,150,62,212
451800,0,8 user reviews,5,3,8
451840,8,Very Positive,461,89,550
451870,0,9 user reviews,6,3,9
451880,6,Mostly Positive,78,24,102
451900,5,Mixed,10,8,18
451920,5,Mixed,35,21,56
451930,7,Positive,11,1,12
451940,0,1 user reviews,1,0,1
451950,0,7 user reviews,1,6,7
451960,0,2 user reviews,1,1,2
451980,0,9 user reviews,9,0,9
451990,6,Mostly Positive,67,20,87
452000,5,Mixed,6,7,13
452060,8,Very Positive,915,134,1049
452070,0,3 user reviews,0,3,3
452100,0,1 user reviews,1,0,1
452120,7,Positive,18,4,22
452180,0,2 user reviews,2,0,2
452230,0,2 user reviews,2,0,2
452240,0,7 user reviews,7,0,7
452250,0,1 user reviews,0,1,1
452251,0,1 user reviews,0,1,1
452270,0,2 user reviews,1,1,2
452280,0,1 user reviews,1,0,1
452320,6,Mostly Positive,9,3,12
452340,5,Mixed,8,12,20
452350,0,1 user reviews,1,0,1
452360,0,2 user reviews,1,1,2
452410,7,Positive,19,4,23
452420,8,Very Positive,70,16,86
452430,6,Mostly Positive,48,20,68
452440,8,Very Positive,128,10,138
452450,5,Mixed,11,15,26
452490,0,9 user reviews,6,3,9
452510,8,Very Positive,349,25,374
452520,0,8 user reviews,2,6,8
452521,6,Mostly Positive,8,3,11
452522,5,Mixed,6,7,13
452523,0,1 user reviews,1,0,1
452530,8,Very Positive,66,8,74
452540,8,Very Positive,218,33,251
452570,9,Overwhelmingly Positive,519,14,533
452620,0,1 user reviews,1,0,1
452640,0,1 user reviews,0,1,1
452650,0,6 user reviews,2,4,6
452660,0,1 user reviews,1,0,1
452670,0,2 user reviews,2,0,2
452700,0,1 user reviews,1,0,1
452710,0,2 user reviews,2,0,2
452740,0,2 user reviews,2,0,2
452760,0,3 user reviews,3,0,3
452770,0,9 user reviews,8,1,9
452771,0,8 user reviews,4,4,8
452860,8,Very Positive,88,7,95
452900,0,1 user reviews,1,0,1
452920,0,2 user reviews,2,0,2
452930,0,2 user reviews,1,1,2
452940,7,Positive,33,0,33
452950,0,9 user reviews,3,6,9
452960,6,Mostly Positive,39,11,50
452970,5,Mixed,48,27,75
452980,0,5 user reviews,3,2,5
452981,0,3 user reviews,3,0,3
452982,0,3 user reviews,3,0,3
453020,7,Positive,19,2,21
453030,0,4 user reviews,3,1,4
453090,8,Very Positive,2020,145,2165
453100,8,Very Positive,56,10,66
453130,6,Mostly Positive,7,3,10
453160,0,2 user reviews,2,0,2
453170,0,8 user reviews,6,2,8
453200,0,4 user reviews,3,1,4
453220,0,7 user reviews,5,2,7
453240,0,6 user reviews,3,3,6
453250,0,3 user reviews,3,0,3
453270,5,Mixed,40,23,63
453280,8,Very Positive,61,11,72
453290,6,Mostly Positive,130,36,166
453300,6,Mostly Positive,51,14,65
453310,8,Very Positive,126,31,157
453320,0,2 user reviews,2,0,2
453330,0,5 user reviews,4,1,5
453340,9,Overwhelmingly Positive,639,27,666
453350,0,8 user reviews,2,6,8
453360,5,Mixed,37,25,62
453380,7,Positive,12,1,13
453390,7,Positive,21,3,24
453400,7,Positive,33,2,35
453410,0,1 user reviews,0,1,1
453440,0,6 user reviews,5,1,6
453450,6,Mostly Positive,10,3,13
453460,0,3 user reviews,2,1,3
453480,8,Very Positive,159,39,198
453500,7,Positive,12,2,14
453510,0,6 user reviews,6,0,6
453590,0,1 user reviews,1,0,1
453620,7,Positive,10,2,12
453630,0,4 user reviews,2,2,4
453650,7,Positive,14,2,16
453660,0,9 user reviews,6,3,9
453670,3,Negative,4,24,28
453680,6,Mostly Positive,28,10,38
453690,8,Very Positive,169,38,207
453700,0,7 user reviews,6,1,7
453710,7,Positive,39,9,48
453720,6,Mostly Positive,51,19,70
453730,4,Mostly Negative,3,7,10
453740,7,Positive,10,2,12
453750,6,Mostly Positive,236,72,308
453770,6,Mostly Positive,8,3,11
453780,7,Positive,12,0,12
453790,8,Very Positive,91,8,99
453810,5,Mixed,9,7,16
453820,3,Negative,6,36,42
453830,0,5 user reviews,5,0,5
453850,5,Mixed,22,26,48
453870,6,Mostly Positive,17,7,24
453880,0,3 user reviews,2,1,3
453890,7,Positive,10,2,12
453910,7,Positive,14,3,17
453920,0,6 user reviews,6,0,6
453950,7,Positive,9,2,11
453960,5,Mixed,33,22,55
453980,0,6 user reviews,1,5,6
453990,7,Positive,37,1,38
454030,5,Mixed,17,10,27
454060,6,Mostly Positive,505,133,638
454070,5,Mixed,84,59,143
454080,5,Mixed,5,6,11
454100,5,Mixed,77,35,112
454130,5,Mixed,9,4,13
454140,8,Very Positive,128,13,141
454160,8,Very Positive,63,3,66
454170,0,4 user reviews,4,0,4
454180,5,Mixed,44,21,65
454190,8,Very Positive,61,6,67
454200,4,Mostly Negative,8,15,23
454220,6,Mostly Positive,43,17,60
454230,4,Mostly Negative,3,8,11
454240,0,2 user reviews,2,0,2
454250,8,Very Positive,187,38,225
454260,0,4 user reviews,2,2,4
454320,8,Very Positive,73,7,80
454330,0,6 user reviews,4,2,6
454350,5,Mixed,328,373,701
454370,0,6 user reviews,3,3,6
454380,8,Very Positive,63,1,64
454390,0,3 user reviews,3,0,3
454410,8,Very Positive,95,22,117
454420,0,1 user reviews,1,0,1
454430,0,1 user reviews,0,1,1
454450,0,4 user reviews,4,0,4
454460,5,Mixed,11,5,16
454480,0,1 user reviews,0,1,1
454510,8,Very Positive,67,8,75
454520,0,5 user reviews,2,3,5
454530,8,Very Positive,69,6,75
454540,0,5 user reviews,0,5,5
454550,5,Mixed,37,20,57
454560,4,Mostly Negative,7,11,18
454570,5,Mixed,13,10,23
454580,6,Mostly Positive,10,4,14
454600,0,4 user reviews,1,3,4
454610,5,Mixed,11,10,21
454630,0,8 user reviews,7,1,8
454650,8,Very Positive,6308,1264,7572
454660,0,1 user reviews,1,0,1
454670,0,2 user reviews,2,0,2
454680,4,Mostly Negative,4,7,11
454690,0,7 user reviews,5,2,7
454700,0,2 user reviews,0,2,2
454720,0,7 user reviews,4,3,7
454730,0,4 user reviews,0,4,4
454740,0,3 user reviews,3,0,3
454750,0,4 user reviews,4,0,4
454770,7,Positive,13,3,16
454780,0,2 user reviews,2,0,2
454790,7,Positive,20,1,21
454791,0,1 user reviews,1,0,1
454800,0,7 user reviews,4,3,7
454830,0,3 user reviews,3,0,3
454870,0,7 user reviews,5,2,7
454890,8,Very Positive,92,21,113
454900,7,Positive,30,4,34
454950,8,Very Positive,136,34,170
454960,0,4 user reviews,4,0,4
454970,0,4 user reviews,3,1,4
454980,0,1 user reviews,1,0,1
455000,0,1 user reviews,0,1,1
455040,8,Very Positive,307,72,379
455041,7,Positive,37,1,38
455050,0,4 user reviews,3,1,4
455080,0,6 user reviews,5,1,6
455100,7,Positive,15,2,17
455110,5,Mixed,6,5,11
455120,5,Mixed,220,162,382
455190,7,Positive,8,2,10
455200,4,Mostly Negative,4,7,11
455220,5,Mixed,11,5,16
455222,0,2 user reviews,1,1,2
455223,0,6 user reviews,5,1,6
455224,0,2 user reviews,2,0,2
455230,0,8 user reviews,7,1,8
455270,0,6 user reviews,4,2,6
455280,0,1 user reviews,1,0,1
455290,0,2 user reviews,2,0,2
455310,6,Mostly Positive,15,5,20
455320,0,1 user reviews,0,1,1
455340,5,Mixed,17,11,28
455370,0,7 user reviews,7,0,7
455400,8,Very Positive,396,22,418
455440,0,9 user reviews,6,3,9
455460,0,8 user reviews,5,3,8
455470,0,1 user reviews,1,0,1
455480,0,1 user reviews,0,1,1
455490,5,Mixed,29,15,44
455520,7,Positive,10,2,12
455530,0,4 user reviews,4,0,4
455570,8,Very Positive,47,8,55
455572,8,Very Positive,57,8,65
455574,0,5 user reviews,2,3,5
455576,0,3 user reviews,2,1,3
455578,0,1 user reviews,0,1,1
455580,6,Mostly Positive,7,3,10
455590,0,6 user reviews,5,1,6
455610,5,Mixed,12,11,23
455611,0,2 user reviews,1,1,2
455612,0,1 user reviews,0,1,1
455640,0,3 user reviews,2,1,3
455690,7,Positive,22,2,24
455700,5,Mixed,14,8,22
455710,5,Mixed,8,7,15
455720,0,5 user reviews,3,2,5
455740,0,1 user reviews,1,0,1
455750,0,1 user reviews,1,0,1
455770,0,7 user reviews,6,1,7
455810,0,8 user reviews,5,3,8
455820,8,Very Positive,444,55,499
455830,0,8 user reviews,6,2,8
455910,5,Mixed,428,189,617
455940,4,Mostly Negative,7,11,18
455960,5,Mixed,10,12,22
455970,0,8 user reviews,3,5,8
455980,8,Very Positive,676,143,819
455990,0,2 user reviews,2,0,2
456050,0,7 user reviews,6,1,7
456090,0,8 user reviews,1,7,8
456130,0,5 user reviews,4,1,5
456150,0,2 user reviews,0,2,2
456160,0,4 user reviews,2,2,4
456170,6,Mostly Positive,52,15,67
456180,5,Mixed,41,28,69
456200,0,3 user reviews,3,0,3
456210,0,5 user reviews,3,2,5
456220,4,Mostly Negative,7,14,21
456221,0,2 user reviews,0,2,2
456230,0,1 user reviews,1,0,1
456231,0,1 user reviews,0,1,1
456280,4,Mostly Negative,38,65,103
456390,0,6 user reviews,6,0,6
456420,0,6 user reviews,0,6,6
456430,8,Very Positive,138,17,155
456440,0,3 user reviews,2,1,3
456450,0,3 user reviews,0,3,3
456470,7,Positive,9,2,11
456480,0,5 user reviews,4,1,5
456510,0,2 user reviews,2,0,2
456540,6,Mostly Positive,66,25,91
456600,7,Positive,12,0,12
456630,8,Very Positive,152,38,190
456660,0,6 user reviews,3,3,6
456670,8,Very Positive,1230,210,1440
456690,0,1 user reviews,1,0,1
456730,0,2 user reviews,2,0,2
456740,0,4 user reviews,4,0,4
456750,9,Overwhelmingly Positive,2280,87,2367
456760,7,Positive,16,3,19
456780,5,Mixed,22,12,34
456800,0,7 user reviews,7,0,7
456810,5,Mixed,22,11,33
456820,0,4 user reviews,3,1,4
456830,7,Positive,12,1,13
456910,0,2 user reviews,2,0,2
456920,0,1 user reviews,1,0,1
456980,6,Mostly Positive,11,4,15
457010,6,Mostly Positive,101,37,138
457080,0,1 user reviews,1,0,1
457084,0,1 user reviews,0,1,1
457085,0,5 user reviews,2,3,5
457086,6,Mostly Positive,19,7,26
457087,0,8 user reviews,6,2,8
457090,0,5 user reviews,4,1,5
457120,0,7 user reviews,6,1,7
457130,7,Positive,30,6,36
457140,9,Overwhelmingly Positive,19653,822,20475
457160,7,Positive,27,3,30
457162,8,Very Positive,111,15,126
457180,0,1 user reviews,0,1,1
457190,8,Very Positive,58,2,60
457191,8,Very Positive,84,12,96
457192,8,Very Positive,156,26,182
457194,7,Positive,34,6,40
457195,8,Very Positive,131,15,146
457196,8,Very Positive,49,6,55
457197,8,Very Positive,224,21,245
457198,8,Very Positive,74,7,81
457199,8,Very Positive,58,6,64
457200,0,7 user reviews,3,4,7
457201,0,9 user reviews,6,3,9
457210,9,Overwhelmingly Positive,682,29,711
457220,0,1 user reviews,1,0,1
457230,0,1 user reviews,1,0,1
457320,8,Very Positive,326,30,356
457330,5,Mixed,50,34,84
457340,6,Mostly Positive,32,9,41
457370,7,Positive,15,2,17
457380,5,Mixed,35,17,52
457420,0,1 user reviews,1,0,1
457450,5,Mixed,4,6,10
457480,6,Mostly Positive,91,27,118
457490,8,Very Positive,49,9,58
457520,5,Mixed,37,16,53
457530,8,Very Positive,84,19,103
457550,7,Positive,26,3,29
457570,8,Very Positive,109,17,126
457580,6,Mostly Positive,103,35,138
457600,5,Mixed,67,34,101
457610,0,4 user reviews,1,3,4
457650,0,2 user reviews,1,1,2
457660,5,Mixed,10,5,15
457680,6,Mostly Positive,167,51,218
457690,5,Mixed,4,6,10
457710,4,Mostly Negative,29,102,131
457720,0,4 user reviews,3,1,4
457730,5,Mixed,109,79,188
457760,5,Mixed,359,155,514
457770,7,Positive,12,1,13
457810,5,Mixed,5,6,11
457820,5,Mixed,13,12,25
457840,7,Positive,21,2,23
457841,7,Positive,15,3,18
457842,7,Positive,31,4,35
457860,8,Very Positive,355,60,415
457870,0,3 user reviews,1,2,3
457890,8,Very Positive,57,5,62
457960,8,Very Positive,506,57,563
457980,0,6 user reviews,2,4,6
457990,0,1 user reviews,1,0,1
458000,6,Mostly Positive,248,96,344
458030,0,5 user reviews,4,1,5
458040,7,Positive,8,2,10
458060,4,Mostly Negative,5,17,22
458100,0,3 user reviews,1,2,3
458110,0,2 user reviews,1,1,2
458160,0,4 user reviews,4,0,4
458170,7,Positive,13,0,13
458190,0,6 user reviews,2,4,6
458200,0,2 user reviews,1,1,2
458230,0,2 user reviews,1,1,2
458250,0,1 user reviews,1,0,1
458260,0,2 user reviews,2,0,2
458270,0,1 user reviews,1,0,1
458280,0,1 user reviews,1,0,1
458290,0,8 user reviews,5,3,8
458300,0,1 user reviews,1,0,1
458310,0,1 user reviews,1,0,1
458320,0,1 user reviews,1,0,1
458330,7,Positive,33,8,41
458360,7,Positive,13,0,13
458370,5,Mixed,10,6,16
458380,7,Positive,31,4,35
458400,0,1 user reviews,1,0,1
458420,5,Mixed,11,6,17
458445,0,2 user reviews,2,0,2
458450,0,4 user reviews,1,3,4
458470,8,Very Positive,134,6,140
458480,8,Very Positive,62,7,69
458490,5,Mixed,9,6,15
458500,0,1 user reviews,0,1,1
458510,5,Mixed,7,4,11
458520,6,Mostly Positive,22,7,29
458530,0,4 user reviews,2,2,4
458540,7,Positive,16,1,17
458560,0,1 user reviews,0,1,1
458580,8,Very Positive,154,34,188
458590,0,1 user reviews,1,0,1
458600,4,Mostly Negative,9,14,23
458630,5,Mixed,46,30,76
458640,5,Mixed,14,7,21
458660,6,Mostly Positive,9,3,12
458680,7,Positive,28,3,31
458700,5,Mixed,8,4,12
458710,9,Overwhelmingly Positive,1053,54,1107
458730,8,Very Positive,276,56,332
458740,0,1 user reviews,1,0,1
458750,7,Positive,32,2,34
458760,7,Positive,12,0,12
458770,5,Mixed,77,62,139
458790,7,Positive,16,0,16
458820,0,2 user reviews,0,2,2
458830,5,Mixed,81,60,141
458840,5,Mixed,11,10,21
458841,0,6 user reviews,5,1,6
458860,7,Positive,17,0,17
458910,0,2 user reviews,2,0,2
458920,5,Mixed,79,70,149
458960,5,Mixed,9,8,17
458990,5,Mixed,8,10,18
459010,8,Very Positive,262,39,301
459020,5,Mixed,15,14,29
459040,0,6 user reviews,3,3,6
459070,0,1 user reviews,1,0,1
459080,5,Mixed,43,53,96
459090,8,Very Positive,173,16,189
459120,6,Mostly Positive,30,9,39
459130,6,Mostly Positive,14,5,19
459140,7,Positive,15,1,16
459150,7,Positive,12,1,13
459160,0,5 user reviews,4,1,5
459170,0,8 user reviews,2,6,8
459220,8,Very Positive,2417,257,2674
459240,0,3 user reviews,3,0,3
459260,5,Mixed,12,12,24
459280,6,Mostly Positive,8,3,11
459290,0,5 user reviews,4,1,5
459310,5,Mixed,65,39,104
459350,7,Positive,27,4,31
459360,0,7 user reviews,4,3,7
459361,0,4 user reviews,1,3,4
459362,0,2 user reviews,2,0,2
459370,7,Positive,13,2,15
459410,0,5 user reviews,2,3,5
459450,7,Positive,13,1,14
459470,5,Mixed,19,18,37
459480,0,1 user reviews,1,0,1
459490,0,2 user reviews,2,0,2
459500,0,8 user reviews,5,3,8
459520,7,Positive,9,1,10
459540,6,Mostly Positive,31,11,42
459550,6,Mostly Positive,50,18,68
459580,0,9 user reviews,9,0,9
459610,7,Positive,17,3,20
459630,0,6 user reviews,1,5,6
459640,5,Mixed,8,4,12
459680,6,Mostly Positive,28,10,38
459730,0,2 user reviews,2,0,2
459750,0,6 user reviews,6,0,6
459760,0,7 user reviews,4,3,7
459780,0,4 user reviews,4,0,4
459790,0,6 user reviews,6,0,6
459820,8,Very Positive,206,37,243
459830,6,Mostly Positive,17,5,22
459850,0,2 user reviews,2,0,2
459851,0,4 user reviews,4,0,4
459852,0,3 user reviews,3,0,3
459853,0,5 user reviews,4,1,5
459870,0,5 user reviews,3,2,5
459880,5,Mixed,6,4,10
459910,7,Positive,11,0,11
459940,5,Mixed,105,49,154
460010,0,3 user reviews,3,0,3
460030,0,2 user reviews,2,0,2
460060,5,Mixed,17,8,25
460070,0,1 user reviews,0,1,1
460120,8,Very Positive,1234,79,1313
460140,7,Positive,17,0,17
460150,5,Mixed,15,9,24
460160,8,Very Positive,136,14,150
460190,0,7 user reviews,7,0,7
460210,0,4 user reviews,4,0,4
460220,8,Very Positive,50,4,54
460230,6,Mostly Positive,48,15,63
460240,0,2 user reviews,1,1,2
460250,7,Positive,19,1,20
460260,0,1 user reviews,1,0,1
460340,6,Mostly Positive,61,18,79
460390,7,Positive,36,2,38
460420,7,Positive,23,0,23
460430,8,Very Positive,536,44,580
460440,0,1 user reviews,1,0,1
460470,7,Positive,9,1,10
460510,0,2 user reviews,1,1,2
460540,0,1 user reviews,1,0,1
460560,0,8 user reviews,8,0,8
460580,5,Mixed,6,6,12
460590,0,1 user reviews,1,0,1
460630,7,Positive,31,0,31
460640,5,Mixed,22,21,43
460650,5,Mixed,11,10,21
460700,8,Very Positive,225,52,277
460710,0,2 user reviews,2,0,2
460750,7,Positive,19,4,23
460760,0,1 user reviews,1,0,1
460780,8,Very Positive,61,4,65
460790,8,Very Positive,4094,425,4519
460810,8,Very Positive,1888,220,2108
460830,0,1 user reviews,1,0,1
460850,0,8 user reviews,8,0,8
460870,8,Very Positive,159,30,189
460890,7,Positive,8,2,10
460910,6,Mostly Positive,11,3,14
460920,6,Mostly Positive,3974,1055,5029
460930,6,Mostly Positive,11491,3325,14816
460940,5,Mixed,11,9,20
460950,9,Overwhelmingly Positive,10153,198,10351
460960,8,Very Positive,128,8,136
460970,7,Positive,12,3,15
460990,5,Mixed,16,8,24
461010,8,Very Positive,50,12,62
461030,5,Mixed,9,4,13
461040,7,Positive,14,2,16
461050,0,1 user reviews,1,0,1
461130,0,3 user reviews,3,0,3
461160,7,Positive,9,1,10
461170,8,Very Positive,131,17,148
461180,0,2 user reviews,2,0,2
461200,0,2 user reviews,2,0,2
461210,5,Mixed,24,18,42
461220,8,Very Positive,71,8,79
461230,8,Very Positive,58,11,69
461240,7,Positive,12,2,14
461241,7,Positive,9,1,10
461242,8,Very Positive,94,8,102
461243,0,6 user reviews,5,1,6
461244,8,Very Positive,263,15,278
461245,7,Positive,9,1,10
461246,7,Positive,10,1,11
461247,7,Positive,18,0,18
461248,7,Positive,30,2,32
461249,8,Very Positive,113,4,117
461250,0,4 user reviews,4,0,4
461280,0,3 user reviews,3,0,3
461320,0,3 user reviews,2,1,3
461340,7,Positive,15,2,17
461350,6,Mostly Positive,7,3,10
461360,7,Positive,13,3,16
461370,0,4 user reviews,2,2,4
461380,5,Mixed,11,11,22
461390,0,9 user reviews,3,6,9
461400,5,Mixed,8,12,20
461410,7,Positive,42,7,49
461430,5,Mixed,1134,580,1714
461480,7,Positive,12,1,13
461490,5,Mixed,19,17,36
461500,7,Positive,29,7,36
461510,5,Mixed,9,5,14
461520,4,Mostly Negative,10,40,50
461560,8,Very Positive,101,7,108
461580,0,2 user reviews,1,1,2
461590,0,4 user reviews,3,1,4
461600,0,1 user reviews,1,0,1
461620,8,Very Positive,377,60,437
461640,8,Very Positive,337,53,390
461650,5,Mixed,10,5,15
461680,4,Mostly Negative,14,26,40
461700,8,Very Positive,240,16,256
461710,7,Positive,19,2,21
461730,6,Mostly Positive,55,19,74
461740,7,Positive,28,0,28
461750,0,1 user reviews,1,0,1
461760,0,9 user reviews,4,5,9
461780,4,Mostly Negative,20,53,73
461800,8,Very Positive,127,22,149
461810,7,Positive,22,3,25
461820,0,2 user reviews,1,1,2
461830,0,2 user reviews,1,1,2
461840,8,Very Positive,746,52,798
461850,0,4 user reviews,2,2,4
461860,5,Mixed,6,5,11
461870,5,Mixed,574,639,1213
461880,4,Mostly Negative,5,16,21
461890,5,Mixed,68,36,104
461900,5,Mixed,28,14,42
461940,4,Mostly Negative,4,10,14
461950,6,Mostly Positive,453,171,624
461990,0,2 user reviews,0,2,2
462000,8,Very Positive,70,10,80
462050,5,Mixed,5,5,10
462070,0,8 user reviews,3,5,8
462081,0,4 user reviews,4,0,4
462083,0,1 user reviews,1,0,1
462087,0,1 user reviews,1,0,1
462100,8,Very Positive,137,26,163
462110,0,7 user reviews,3,4,7
462130,0,5 user reviews,5,0,5
462140,0,4 user reviews,3,1,4
462170,0,5 user reviews,5,0,5
462211,0,3 user reviews,1,2,3
462212,0,1 user reviews,1,0,1
462220,7,Positive,9,2,11
462240,6,Mostly Positive,10,4,14
462250,0,1 user reviews,1,0,1
462260,6,Mostly Positive,28,9,37
462261,7,Positive,31,6,37
462280,0,5 user reviews,4,1,5
462290,5,Mixed,10,8,18
462390,0,6 user reviews,6,0,6
462391,0,4 user reviews,4,0,4
462400,0,1 user reviews,0,1,1
462440,4,Mostly Negative,73,120,193
462460,0,8 user reviews,6,2,8
462480,7,Positive,31,4,35
462520,7,Positive,13,2,15
462530,0,1 user reviews,0,1,1
462550,0,1 user reviews,1,0,1
462570,0,8 user reviews,6,2,8
462580,0,3 user reviews,1,2,3
462590,7,Positive,12,0,12
462600,0,6 user reviews,5,1,6
462605,0,2 user reviews,2,0,2
462610,5,Mixed,7,4,11
462611,0,4 user reviews,4,0,4
462620,7,Positive,30,2,32
462630,0,2 user reviews,2,0,2
462640,5,Mixed,10,5,15
462670,0,3 user reviews,3,0,3
462680,6,Mostly Positive,144,41,185
462700,5,Mixed,24,16,40
462730,5,Mixed,17,10,27
462740,0,1 user reviews,1,0,1
462770,8,Very Positive,3427,381,3808
462780,8,Very Positive,1875,311,2186
462830,4,Mostly Negative,11,29,40
462860,6,Mostly Positive,19,8,27
462880,0,5 user reviews,5,0,5
462910,0,3 user reviews,3,0,3
462920,5,Mixed,16,20,36
462930,5,Mixed,81,42,123
462940,6,Mostly Positive,77,23,100
462950,5,Mixed,7,7,14
462960,5,Mixed,92,41,133
462990,8,Very Positive,166,13,179
463000,0,1 user reviews,0,1,1
463010,0,5 user reviews,2,3,5
463020,7,Positive,12,0,12
463030,5,Mixed,92,54,146
463060,0,3 user reviews,2,1,3
463070,7,Positive,27,1,28
463090,0,1 user reviews,1,0,1
463100,0,4 user reviews,0,4,4
463110,6,Mostly Positive,93,34,127
463150,6,Mostly Positive,183,47,230
463160,6,Mostly Positive,62,20,82
463170,5,Mixed,56,43,99
463180,0,8 user reviews,5,3,8
463200,0,1 user reviews,1,0,1
463210,8,Very Positive,230,50,280
463220,6,Mostly Positive,111,39,150
463240,0,6 user reviews,6,0,6
463250,0,2 user reviews,1,1,2
463270,8,Very Positive,557,68,625
463290,8,Very Positive,88,7,95
463320,5,Mixed,9,13,22
463350,6,Mostly Positive,153,63,216
463360,0,1 user reviews,1,0,1
463390,7,Positive,13,2,15
463400,7,Positive,13,3,16
463430,0,6 user reviews,2,4,6
463440,0,1 user reviews,0,1,1
463450,0,4 user reviews,4,0,4
463460,5,Mixed,9,6,15
463470,6,Mostly Positive,7,3,10
463480,0,5 user reviews,4,1,5
463510,0,8 user reviews,4,4,8
463530,9,Overwhelmingly Positive,2323,107,2430
463590,7,Positive,11,1,12
463630,0,1 user reviews,1,0,1
463640,6,Mostly Positive,10,3,13
463650,0,6 user reviews,6,0,6
463670,0,9 user reviews,5,4,9
463700,8,Very Positive,73,11,84
463710,4,Mostly Negative,3,8,11
463720,8,Very Positive,161,26,187
463740,8,Very Positive,248,8,256
463750,7,Positive,19,0,19
463760,6,Mostly Positive,21,7,28
463790,5,Mixed,8,5,13
463791,7,Positive,41,6,47
463794,0,4 user reviews,4,0,4
463795,6,Mostly Positive,46,19,65
463796,0,9 user reviews,7,2,9
463797,6,Mostly Positive,7,3,10
463798,0,9 user reviews,5,4,9
463799,7,Positive,11,2,13
463800,8,Very Positive,50,10,60
463810,0,3 user reviews,3,0,3
463830,0,2 user reviews,0,2,2
463850,6,Mostly Positive,92,28,120
463860,5,Mixed,24,28,52
463870,5,Mixed,7,4,11
463880,5,Mixed,10,7,17
463920,0,4 user reviews,1,3,4
463930,8,Very Positive,169,6,175
463980,8,Very Positive,143,27,170
464000,6,Mostly Positive,24,8,32
464020,0,5 user reviews,2,3,5
464050,0,3 user reviews,2,1,3
464060,8,Very Positive,2667,254,2921
464070,0,3 user reviews,2,1,3
464080,6,Mostly Positive,30,9,39
464100,5,Mixed,55,28,83
464110,0,5 user reviews,5,0,5
464120,0,9 user reviews,8,1,9
464150,6,Mostly Positive,157,44,201
464160,0,1 user reviews,1,0,1
464170,5,Mixed,20,16,36
464190,0,1 user reviews,1,0,1
464200,0,4 user reviews,2,2,4
464201,0,5 user reviews,4,1,5
464202,0,7 user reviews,5,2,7
464204,0,3 user reviews,1,2,3
464205,0,3 user reviews,1,2,3
464206,0,2 user reviews,1,1,2
464210,0,2 user reviews,2,0,2
464220,0,3 user reviews,3,0,3
464230,6,Mostly Positive,16,6,22
464240,5,Mixed,11,5,16
464260,7,Positive,19,3,22
464300,0,3 user reviews,2,1,3
464340,5,Mixed,231,292,523
464350,8,Very Positive,713,88,801
464360,9,Overwhelmingly Positive,748,38,786
464380,3,Negative,2,10,12
464400,7,Positive,22,1,23
464410,6,Mostly Positive,7,3,10
464420,0,9 user reviews,7,2,9
464430,0,9 user reviews,9,0,9
464440,5,Mixed,15,10,25
464450,8,Very Positive,181,9,190
464470,5,Mixed,72,87,159
464490,7,Positive,29,1,30
464500,7,Positive,27,1,28
464510,0,1 user reviews,1,0,1
464511,0,1 user reviews,1,0,1
464512,0,1 user reviews,1,0,1
464513,0,1 user reviews,1,0,1
464520,0,1 user reviews,1,0,1
464522,0,1 user reviews,1,0,1
464523,0,1 user reviews,1,0,1
464524,0,1 user reviews,1,0,1
464530,5,Mixed,9,5,14
464540,0,3 user reviews,1,2,3
464590,6,Mostly Positive,10,3,13
464591,0,7 user reviews,7,0,7
464610,0,5 user reviews,5,0,5
464620,8,Very Positive,349,25,374
464630,0,5 user reviews,0,5,5
464650,7,Positive,24,4,28
464660,0,3 user reviews,3,0,3
464670,0,8 user reviews,6,2,8
464680,0,1 user reviews,0,1,1
464690,3,Negative,5,23,28
464700,0,5 user reviews,2,3,5
464720,0,2 user reviews,2,0,2
464730,0,1 user reviews,1,0,1
464740,0,2 user reviews,2,0,2
464760,4,Mostly Negative,7,11,18
464780,7,Positive,17,2,19
464800,0,1 user reviews,0,1,1
464820,0,6 user reviews,0,6,6
464840,7,Positive,32,5,37
464850,5,Mixed,146,96,242
464880,6,Mostly Positive,314,90,404
464890,5,Mixed,16,8,24
464900,7,Positive,28,0,28
464920,8,Very Positive,4723,977,5700
464940,0,2 user reviews,2,0,2
464950,0,3 user reviews,3,0,3
464960,7,Positive,40,2,42
465000,5,Mixed,22,11,33
465010,0,2 user reviews,1,1,2
465020,8,Very Positive,99,8,107
465040,0,1 user reviews,1,0,1
465050,0,2 user reviews,2,0,2
465060,0,5 user reviews,5,0,5
465070,7,Positive,10,0,10
465090,0,1 user reviews,0,1,1
465100,8,Very Positive,128,17,145
465130,7,Positive,17,3,20
465150,7,Positive,21,4,25
465170,5,Mixed,30,19,49
465180,7,Positive,17,1,18
465190,0,7 user reviews,3,4,7
465200,8,Very Positive,178,8,186
465220,0,7 user reviews,7,0,7
465230,0,1 user reviews,1,0,1
465240,8,Very Positive,601,113,714
465250,5,Mixed,13,6,19
465280,6,Mostly Positive,61,19,80
465292,0,1 user reviews,1,0,1
465310,7,Positive,18,3,21
465360,7,Positive,29,7,36
465440,0,1 user reviews,1,0,1
465450,6,Mostly Positive,16,6,22
465480,8,Very Positive,50,0,50
465490,8,Very Positive,557,88,645
465510,4,Mostly Negative,6,15,21
465520,7,Positive,38,3,41
465540,5,Mixed,6,8,14
465600,0,5 user reviews,4,1,5
465650,8,Very Positive,374,28,402
465660,5,Mixed,33,28,61
465670,0,3 user reviews,3,0,3
465691,0,1 user reviews,1,0,1
465720,5,Mixed,29,14,43
465730,0,1 user reviews,1,0,1
465750,0,7 user reviews,6,1,7
465760,5,Mixed,33,24,57
465780,8,Very Positive,327,74,401
465840,7,Positive,20,5,25
465860,0,3 user reviews,2,1,3
465870,5,Mixed,8,5,13
465890,7,Positive,11,0,11
465900,7,Positive,9,1,10
465920,0,4 user reviews,4,0,4
465930,5,Mixed,13,8,21
465960,0,4 user reviews,2,2,4
465970,0,2 user reviews,2,0,2
465980,7,Positive,35,1,36
465990,0,6 user reviews,4,2,6
466000,7,Positive,20,0,20
466010,0,6 user reviews,6,0,6
466020,0,8 user reviews,8,0,8
466030,0,7 user reviews,7,0,7
466040,0,1 user reviews,1,0,1
466050,0,7 user reviews,7,0,7
466060,0,8 user reviews,8,0,8
466070,0,1 user reviews,1,0,1
466080,0,2 user reviews,2,0,2
466100,0,7 user reviews,5,2,7
466110,8,Very Positive,332,25,357
466130,8,Very Positive,110,21,131
466160,7,Positive,13,0,13
466170,5,Mixed,9,4,13
466200,0,2 user reviews,2,0,2
466210,0,8 user reviews,3,5,8
466220,5,Mixed,96,71,167
466240,5,Mixed,491,233,724
466270,7,Positive,16,3,19
466280,0,3 user reviews,2,1,3
466290,0,3 user reviews,3,0,3
466300,8,Very Positive,1081,69,1150
466350,5,Mixed,24,20,44
466380,0,1 user reviews,1,0,1
466390,0,7 user reviews,7,0,7
466420,5,Mixed,9,7,16
466430,8,Very Positive,52,1,53
466490,4,Mostly Negative,10,19,29
466500,5,Mixed,429,326,755
466520,6,Mostly Positive,14,6,20
466540,6,Mostly Positive,9,3,12
466541,0,5 user reviews,4,1,5
466542,7,Positive,10,2,12
466543,5,Mixed,6,8,14
466544,7,Positive,18,3,21
466545,7,Positive,15,3,18
466546,5,Mixed,12,15,27
466547,6,Mostly Positive,7,3,10
466548,7,Positive,9,2,11
466549,5,Mixed,9,6,15
466550,6,Mostly Positive,9,3,12
466551,0,6 user reviews,4,2,6
466560,8,Very Positive,9228,1507,10735
466580,0,2 user reviews,1,1,2
466630,9,Overwhelmingly Positive,657,18,675
466660,8,Very Positive,54,12,66
466710,7,Positive,13,0,13
466730,5,Mixed,15,14,29
466740,6,Mostly Positive,115,42,157
466770,0,5 user reviews,5,0,5
466780,5,Mixed,6,8,14
466800,8,Very Positive,111,27,138
466810,7,Positive,19,1,20
466820,7,Positive,14,0,14
466840,5,Mixed,50,39,89
466860,5,Mixed,13,6,19
466870,8,Very Positive,104,17,121
466890,3,Negative,5,27,32
466900,0,2 user reviews,2,0,2
466910,6,Mostly Positive,25,7,32
466920,6,Mostly Positive,24,9,33
466940,5,Mixed,107,83,190
466980,6,Mostly Positive,54,19,73
467000,5,Mixed,32,31,63
467010,4,Mostly Negative,8,16,24
467090,0,6 user reviews,5,1,6
467120,0,2 user reviews,2,0,2
467130,0,1 user reviews,1,0,1
467140,0,1 user reviews,1,0,1
467160,0,2 user reviews,2,0,2
467170,0,5 user reviews,4,1,5
467210,8,Very Positive,74,4,78
467220,0,6 user reviews,4,2,6
467230,0,5 user reviews,5,0,5
467260,0,1 user reviews,1,0,1
467270,6,Mostly Positive,28,9,37
467290,7,Positive,35,6,41
467300,0,6 user reviews,6,0,6
467310,0,4 user reviews,1,3,4
467320,8,Very Positive,47,11,58
467330,7,Positive,21,4,25
467350,0,4 user reviews,2,2,4
467360,7,Positive,23,4,27
467370,5,Mixed,13,13,26
467380,7,Positive,29,2,31
467390,5,Mixed,35,29,64
467400,6,Mostly Positive,22,6,28
467430,5,Mixed,13,6,19
467440,0,1 user reviews,1,0,1
467470,7,Positive,13,0,13
467480,0,9 user reviews,5,4,9
467490,7,Positive,20,2,22
467500,0,1 user reviews,1,0,1
467510,0,3 user reviews,3,0,3
467511,0,2 user reviews,2,0,2
467512,0,3 user reviews,2,1,3
467515,0,4 user reviews,1,3,4
467517,0,1 user reviews,1,0,1
467520,5,Mixed,111,133,244
467570,4,Mostly Negative,42,75,117
467600,0,2 user reviews,2,0,2
467620,0,3 user reviews,3,0,3
467650,0,1 user reviews,1,0,1
467660,6,Mostly Positive,297,88,385
467680,6,Mostly Positive,86,31,117
467710,7,Positive,8,2,10
467720,5,Mixed,15,8,23
467760,8,Very Positive,91,7,98
467770,0,3 user reviews,3,0,3
467780,7,Positive,25,0,25
467790,0,3 user reviews,2,1,3
467810,7,Positive,36,1,37
467820,8,Very Positive,202,20,222
467850,5,Mixed,58,27,85
467890,5,Mixed,14,10,24
467900,5,Mixed,31,22,53
467910,5,Mixed,15,9,24
467930,6,Mostly Positive,137,40,177
467940,0,7 user reviews,7,0,7
467950,6,Mostly Positive,30,12,42
467960,5,Mixed,98,79,177
467980,8,Very Positive,279,15,294
467990,5,Mixed,72,37,109
468000,5,Mixed,42,51,93
468050,8,Very Positive,75,4,79
468060,8,Very Positive,148,4,152
468070,5,Mixed,41,21,62
468080,0,2 user reviews,1,1,2
468100,6,Mostly Positive,37,12,49
468110,7,Positive,10,0,10
468130,0,3 user reviews,3,0,3
468150,0,5 user reviews,3,2,5
468160,5,Mixed,21,18,39
468170,7,Positive,13,3,16
468240,8,Very Positive,52,6,58
468250,6,Mostly Positive,77,28,105
468280,7,Positive,17,2,19
468310,7,Positive,17,4,21
468320,0,5 user reviews,2,3,5
468330,0,5 user reviews,4,1,5
468350,0,2 user reviews,1,1,2
468410,8,Very Positive,332,47,379
468460,0,8 user reviews,6,2,8
468490,5,Mixed,76,33,109
468510,5,Mixed,5,7,12
468530,7,Positive,28,6,34
468540,0,1 user reviews,1,0,1
468550,7,Positive,30,0,30
468560,5,Mixed,10,15,25
468570,5,Mixed,15,22,37
468580,0,1 user reviews,1,0,1
468600,0,1 user reviews,1,0,1
468650,0,1 user reviews,0,1,1
468670,7,Positive,18,4,22
468690,0,1 user reviews,0,1,1
468700,7,Positive,12,2,14
468720,0,2 user reviews,1,1,2
468721,0,3 user reviews,3,0,3
468723,7,Positive,17,2,19
468726,7,Positive,40,8,48
468727,0,6 user reviews,6,0,6
468729,0,1 user reviews,1,0,1
468730,6,Mostly Positive,8,3,11
468731,0,4 user reviews,4,0,4
468733,5,Mixed,14,9,23
468734,0,3 user reviews,2,1,3
468735,0,1 user reviews,1,0,1
468736,0,3 user reviews,2,1,3
468737,7,Positive,21,1,22
468740,7,Positive,18,3,21
468780,0,6 user reviews,6,0,6
468800,5,Mixed,22,12,34
468820,8,Very Positive,119,10,129
468900,0,3 user reviews,1,2,3
468920,8,Very Positive,897,133,1030
468930,5,Mixed,27,17,44
469550,0,5 user reviews,4,1,5
469560,5,Mixed,7,5,12
469600,6,Mostly Positive,939,263,1202
469610,6,Mostly Positive,813,280,1093
469650,0,1 user reviews,0,1,1
469660,7,Positive,45,1,46
469670,0,1 user reviews,1,0,1
469710,7,Positive,16,4,20
469720,8,Very Positive,206,36,242
469730,8,Very Positive,205,26,231
469740,0,1 user reviews,1,0,1
469780,0,1 user reviews,1,0,1
469790,8,Very Positive,191,3,194
469800,6,Mostly Positive,98,28,126
469820,8,Very Positive,2875,275,3150
469850,0,1 user reviews,1,0,1
469890,8,Very Positive,56,12,68
469900,5,Mixed,5,6,11
469920,6,Mostly Positive,389,114,503
469980,6,Mostly Positive,9,3,12
469990,0,8 user reviews,5,3,8
470000,0,2 user reviews,2,0,2
470011,0,2 user reviews,2,0,2
470012,0,1 user reviews,1,0,1
470020,0,1 user reviews,0,1,1
470030,0,1 user reviews,1,0,1
470040,5,Mixed,8,9,17
470060,6,Mostly Positive,31,9,40
470070,4,Mostly Negative,52,147,199
470090,7,Positive,13,2,15
470110,0,3 user reviews,3,0,3
470120,0,1 user reviews,1,0,1
470140,0,1 user reviews,1,0,1
470151,0,1 user reviews,0,1,1
470170,5,Mixed,8,8,16
470190,0,7 user reviews,7,0,7
470210,6,Mostly Positive,33,9,42
470220,6,Mostly Positive,8417,2995,11412
470240,0,3 user reviews,2,1,3
470250,0,9 user reviews,8,1,9
470260,6,Mostly Positive,713,212,925
470270,6,Mostly Positive,40,15,55
470280,4,Mostly Negative,4,15,19
470300,6,Mostly Positive,32,11,43
470310,8,Very Positive,999,57,1056
470440,7,Positive,11,0,11
470450,6,Mostly Positive,9,3,12
470470,7,Positive,23,0,23
470480,7,Positive,8,2,10
470490,5,Mixed,6,4,10
470580,7,Positive,12,1,13
470590,7,Positive,23,3,26
470610,0,1 user reviews,1,0,1
470670,0,1 user reviews,1,0,1
470690,7,Positive,19,0,19
470691,0,4 user reviews,3,1,4
470740,6,Mostly Positive,62,21,83
470750,5,Mixed,16,10,26
470760,0,6 user reviews,4,2,6
470780,8,Very Positive,51,1,52
470890,0,4 user reviews,0,4,4
471010,6,Mostly Positive,292,83,375
471160,5,Mixed,15,7,22
471170,6,Mostly Positive,19,6,25
471200,0,3 user reviews,3,0,3
471220,0,3 user reviews,2,1,3
471240,0,3 user reviews,3,0,3
471260,6,Mostly Positive,16,5,21
471270,0,7 user reviews,5,2,7
471310,0,1 user reviews,0,1,1
471330,8,Very Positive,143,35,178
471350,6,Mostly Positive,11,4,15
471380,5,Mixed,9,5,14
471390,0,3 user reviews,2,1,3
471400,0,4 user reviews,4,0,4
471550,6,Mostly Positive,596,156,752
471570,7,Positive,36,1,37
471580,0,2 user reviews,1,1,2
471630,0,2 user reviews,2,0,2
471640,0,7 user reviews,5,2,7
471650,5,Mixed,12,16,28
471660,8,Very Positive,300,42,342
471700,5,Mixed,13,6,19
471710,8,Very Positive,99,0,99
471730,0,9 user reviews,6,3,9
471740,0,1 user reviews,1,0,1
471741,0,5 user reviews,5,0,5
471770,0,6 user reviews,4,2,6
471810,8,Very Positive,110,9,119
471870,0,1 user reviews,1,0,1
471890,0,4 user reviews,4,0,4
471891,6,Mostly Positive,36,12,48
471894,0,1 user reviews,1,0,1
471895,0,1 user reviews,1,0,1
471899,6,Mostly Positive,18,6,24
471920,8,Very Positive,56,8,64
472060,0,3 user reviews,3,0,3
472070,7,Positive,18,2,20
472350,7,Positive,28,4,32
472420,8,Very Positive,60,12,72
472490,7,Positive,13,2,15
472671,0,1 user reviews,1,0,1
472680,5,Mixed,8,5,13
472690,0,7 user reviews,6,1,7
472720,0,4 user reviews,3,1,4
472740,0,3 user reviews,0,3,3
472770,0,7 user reviews,7,0,7
472810,0,3 user reviews,3,0,3
472811,0,3 user reviews,3,0,3
472830,0,2 user reviews,1,1,2
472840,0,6 user reviews,2,4,6
472860,0,5 user reviews,4,1,5
472870,8,Very Positive,190,0,190
473050,0,1 user reviews,0,1,1
473140,0,3 user reviews,0,3,3
473420,0,1 user reviews,1,0,1
473430,0,4 user reviews,3,1,4
473440,0,3 user reviews,2,1,3
473441,0,1 user reviews,1,0,1
473442,0,2 user reviews,2,0,2
473443,0,3 user reviews,3,0,3
473444,7,Positive,10,0,10
473445,0,1 user reviews,1,0,1
473446,0,3 user reviews,3,0,3
473447,0,4 user reviews,4,0,4
473450,6,Mostly Positive,62,21,83
473460,0,3 user reviews,3,0,3
473470,5,Mixed,39,24,63
473480,0,3 user reviews,2,1,3
473510,7,Positive,15,2,17
473520,5,Mixed,7,7,14
473530,7,Positive,25,2,27
473540,0,5 user reviews,1,4,5
473550,0,1 user reviews,0,1,1
473560,5,Mixed,58,55,113
473610,4,Mostly Negative,12,25,37
473670,5,Mixed,28,29,57
473690,6,Mostly Positive,4192,1749,5941
473720,7,Positive,11,0,11
473770,8,Very Positive,528,30,558
473780,0,8 user reviews,7,1,8
473810,4,Mostly Negative,6,16,22
473840,7,Positive,11,2,13
473850,6,Mostly Positive,93,39,132
473870,0,2 user reviews,2,0,2
473871,0,6 user reviews,6,0,6
473900,0,7 user reviews,0,7,7
473910,5,Mixed,89,54,143
473920,8,Very Positive,103,1,104
473950,8,Very Positive,280,11,291
473970,5,Mixed,49,32,81
474010,0,6 user reviews,1,5,6
474020,6,Mostly Positive,77,23,100
474050,0,5 user reviews,2,3,5
474210,8,Very Positive,390,46,436
474220,8,Very Positive,75,10,85
474230,0,7 user reviews,7,0,7
474240,0,8 user reviews,2,6,8
474620,7,Positive,9,1,10
474720,0,4 user reviews,3,1,4
474730,0,6 user reviews,4,2,6
474740,6,Mostly Positive,47,15,62
474750,8,Very Positive,1879,273,2152
474760,5,Mixed,12,9,21
474761,7,Positive,34,7,41
474762,5,Mixed,16,20,36
474763,8,Very Positive,64,16,80
474764,7,Positive,22,5,27
474765,7,Positive,21,5,26
474766,7,Positive,23,3,26
474780,0,6 user reviews,0,6,6
474800,0,1 user reviews,0,1,1
474801,5,Mixed,4,6,10
474803,0,1 user reviews,1,0,1
474810,0,4 user reviews,3,1,4
474830,6,Mostly Positive,12,4,16
474880,0,3 user reviews,2,1,3
474890,6,Mostly Positive,65,19,84
474910,5,Mixed,22,15,37
474930,0,1 user reviews,1,0,1
474960,8,Very Positive,2957,638,3595
474980,8,Very Positive,60,8,68
475010,0,1 user reviews,1,0,1
475050,0,5 user reviews,2,3,5
475080,0,4 user reviews,1,3,4
475090,4,Mostly Negative,6,14,20
475130,0,8 user reviews,6,2,8
475131,0,8 user reviews,8,0,8
475132,0,8 user reviews,6,2,8
475150,8,Very Positive,4084,429,4513
475180,4,Mostly Negative,49,166,215
475190,8,Very Positive,815,97,912
475210,0,3 user reviews,3,0,3
475220,0,5 user reviews,0,5,5
475230,0,3 user reviews,3,0,3
475240,6,Mostly Positive,124,32,156
475350,0,1 user reviews,1,0,1
475360,0,1 user reviews,1,0,1
475390,0,1 user reviews,1,0,1
475430,5,Mixed,168,96,264
475460,0,1 user reviews,1,0,1
475490,6,Mostly Positive,290,76,366
475520,6,Mostly Positive,7,3,10
475530,0,1 user reviews,1,0,1
475550,6,Mostly Positive,1474,372,1846
475620,0,7 user reviews,6,1,7
475630,5,Mixed,16,8,24
475960,7,Positive,16,1,17
476000,0,6 user reviews,6,0,6
476010,0,1 user reviews,1,0,1
476020,5,Mixed,26,15,41
476030,0,7 user reviews,2,5,7
476040,0,5 user reviews,4,1,5
476240,8,Very Positive,282,14,296
476351,0,1 user reviews,1,0,1
476352,0,2 user reviews,2,0,2
476353,0,2 user reviews,1,1,2
476370,0,2 user reviews,1,1,2
476410,7,Positive,31,0,31
476420,5,Mixed,76,36,112
476430,0,9 user reviews,9,0,9
476450,6,Mostly Positive,18,7,25
476460,7,Positive,11,0,11
476470,0,1 user reviews,1,0,1
476480,5,Mixed,20,19,39
476490,8,Very Positive,76,7,83
476510,7,Positive,12,3,15
476530,8,Very Positive,291,29,320
476600,5,Mixed,4773,3801,8574
476620,6,Mostly Positive,949,324,1273
476650,8,Very Positive,150,31,181
476670,0,3 user reviews,2,1,3
476700,6,Mostly Positive,228,71,299
476710,0,8 user reviews,1,7,8
476860,0,1 user reviews,0,1,1
476861,0,2 user reviews,2,0,2
476862,0,7 user reviews,5,2,7
476863,0,3 user reviews,3,0,3
476864,7,Positive,19,0,19
476865,0,4 user reviews,4,0,4
476866,0,2 user reviews,2,0,2
476867,7,Positive,12,0,12
476868,7,Positive,19,0,19
476869,7,Positive,16,1,17
476870,0,9 user reviews,9,0,9
476871,7,Positive,14,2,16
476920,5,Mixed,28,31,59
476940,0,1 user reviews,1,0,1
477000,0,1 user reviews,0,1,1
477010,0,2 user reviews,1,1,2
477020,0,8 user reviews,8,0,8
477030,0,6 user reviews,5,1,6
477050,0,3 user reviews,3,0,3
477130,0,4 user reviews,4,0,4
477140,0,2 user reviews,1,1,2
477160,8,Very Positive,13942,776,14718
477170,5,Mixed,16,8,24
477180,4,Mostly Negative,3,7,10
477190,0,3 user reviews,3,0,3
477200,0,8 user reviews,8,0,8
477270,8,Very Positive,401,93,494
477290,6,Mostly Positive,9,3,12
477310,7,Positive,38,1,39
477720,0,7 user reviews,5,2,7
477730,6,Mostly Positive,311,116,427
477740,9,Overwhelmingly Positive,1215,56,1271
477750,5,Mixed,11,9,20
477770,8,Very Positive,529,115,644
477790,0,6 user reviews,5,1,6
477800,0,1 user reviews,0,1,1
477820,0,5 user reviews,5,0,5
477870,8,Very Positive,288,71,359
477881,0,4 user reviews,3,1,4
477890,0,3 user reviews,2,1,3
477900,7,Positive,31,4,35
477910,0,2 user reviews,2,0,2
477940,0,7 user reviews,2,5,7
477941,0,1 user reviews,1,0,1
477942,0,1 user reviews,0,1,1
477950,0,8 user reviews,7,1,8
478000,0,1 user reviews,0,1,1
478010,0,7 user reviews,3,4,7
478020,0,2 user reviews,2,0,2
478030,0,3 user reviews,3,0,3
478032,0,1 user reviews,1,0,1
478033,0,4 user reviews,4,0,4
478034,0,1 user reviews,1,0,1
478040,0,2 user reviews,2,0,2
478049,0,3 user reviews,3,0,3
478053,0,1 user reviews,1,0,1
478057,0,1 user reviews,1,0,1
478210,4,Mostly Negative,7,13,20
478950,5,Mixed,42,20,62
478960,0,1 user reviews,1,0,1
478980,0,7 user reviews,6,1,7
479000,7,Positive,24,6,30
479010,6,Mostly Positive,90,27,117
479020,5,Mixed,36,19,55
479040,5,Mixed,10,7,17
479060,0,9 user reviews,7,2,9
479061,0,4 user reviews,3,1,4
479100,5,Mixed,38,40,78
479110,0,9 user reviews,8,1,9
479130,5,Mixed,65,28,93
479140,7,Positive,13,2,15
479150,0,1 user reviews,1,0,1
479170,0,1 user reviews,0,1,1
479180,0,5 user reviews,0,5,5
479200,0,2 user reviews,1,1,2
479230,0,4 user reviews,3,1,4
479270,0,2 user reviews,1,1,2
479310,0,2 user reviews,2,0,2
479330,5,Mixed,11,5,16
479990,5,Mixed,34,16,50
480410,0,6 user reviews,5,1,6
480430,6,Mostly Positive,207,55,262
480450,8,Very Positive,85,3,88
480480,8,Very Positive,48,12,60
480490,8,Very Positive,10291,1135,11426
480500,5,Mixed,8,4,12
480520,0,8 user reviews,6,2,8
480530,5,Mixed,29,16,45
480540,0,6 user reviews,5,1,6
480550,0,5 user reviews,5,0,5
480580,0,6 user reviews,4,2,6
480590,0,3 user reviews,3,0,3
480591,0,1 user reviews,1,0,1
480592,0,1 user reviews,1,0,1
480593,0,1 user reviews,1,0,1
480594,0,1 user reviews,1,0,1
480595,0,1 user reviews,1,0,1
480630,5,Mixed,315,453,768
480631,4,Mostly Negative,420,645,1065
480640,5,Mixed,210,124,334
480650,8,Very Positive,1293,267,1560
480690,7,Positive,31,3,34
480710,0,1 user reviews,0,1,1
480720,0,2 user reviews,1,1,2
480770,0,1 user reviews,1,0,1
480780,4,Mostly Negative,6,17,23
480900,5,Mixed,15,13,28
481080,7,Positive,11,1,12
481090,6,Mostly Positive,78,28,106
481110,5,Mixed,235,117,352
481120,0,1 user reviews,1,0,1
481122,0,7 user reviews,6,1,7
481172,0,4 user reviews,4,0,4
481180,8,Very Positive,124,29,153
481190,5,Mixed,100,98,198
481360,0,8 user reviews,6,2,8
481420,5,Mixed,22,14,36
481490,0,3 user reviews,3,0,3
481510,8,Very Positive,6460,418,6878
481600,5,Mixed,11,5,16
481870,5,Mixed,84,42,126
481950,0,4 user reviews,4,0,4
482210,0,5 user reviews,4,1,5
482221,0,2 user reviews,2,0,2
482222,0,3 user reviews,3,0,3
482300,5,Mixed,150,76,226
482330,5,Mixed,16,11,27
482390,0,2 user reviews,2,0,2
482410,0,1 user reviews,1,0,1
482420,6,Mostly Positive,11,4,15
482450,8,Very Positive,201,21,222
482460,0,5 user reviews,3,2,5
482890,3,Negative,5,22,27
482920,5,Mixed,8,4,12
482990,7,Positive,45,3,48
483420,8,Very Positive,211,25,236
483450,5,Mixed,15,22,37
483490,0,4 user reviews,4,0,4
483680,0,1 user reviews,1,0,1
483770,5,Mixed,53,67,120
483790,0,4 user reviews,4,0,4
483810,0,1 user reviews,1,0,1
483820,0,1 user reviews,1,0,1
483840,8,Very Positive,185,43,228
483850,5,Mixed,9,4,13
483941,0,1 user reviews,1,0,1
483950,8,Very Positive,84,11,95
483960,5,Mixed,92,56,148
483970,8,Very Positive,42,8,50
483980,9,Overwhelmingly Positive,942,29,971
484350,6,Mostly Positive,104,38,142
484390,0,8 user reviews,8,0,8
484810,0,1 user reviews,1,0,1
484830,6,Mostly Positive,8,3,11
484840,0,8 user reviews,7,1,8
484860,5,Mixed,8,4,12
484870,8,Very Positive,357,43,400
484890,0,7 user reviews,5,2,7
484900,6,Mostly Positive,474,159,633
484930,7,Positive,12,3,15
484950,5,Mixed,86,48,134
484970,0,4 user reviews,4,0,4
484990,0,1 user reviews,1,0,1
485000,5,Mixed,7,4,11
485030,6,Mostly Positive,100,28,128
485040,8,Very Positive,118,20,138
485080,5,Mixed,13,7,20
485110,7,Positive,11,2,13
485120,7,Positive,34,2,36
485141,0,1 user reviews,0,1,1
485144,0,1 user reviews,1,0,1
485145,0,1 user reviews,1,0,1
485150,0,5 user reviews,2,3,5
485160,0,9 user reviews,7,2,9
485230,0,2 user reviews,1,1,2
485240,5,Mixed,14,12,26
485260,0,4 user reviews,3,1,4
485270,0,8 user reviews,1,7,8
485280,7,Positive,42,0,42
485290,0,9 user reviews,9,0,9
485310,5,Mixed,11,13,24
485330,4,Mostly Negative,15,31,46
485340,6,Mostly Positive,10,3,13
485350,5,Mixed,56,25,81
485360,8,Very Positive,43,9,52
485370,5,Mixed,79,37,116
485380,8,Very Positive,986,227,1213
485390,0,2 user reviews,0,2,2
485430,0,4 user reviews,2,2,4
485440,4,Mostly Negative,17,30,47
485450,5,Mixed,71,47,118
485460,8,Very Positive,527,129,656
485490,8,Very Positive,52,12,64
485500,5,Mixed,9,7,16
485510,8,Very Positive,3890,943,4833
485560,0,4 user reviews,4,0,4
485570,0,4 user reviews,4,0,4
485590,0,3 user reviews,2,1,3
485600,7,Positive,26,5,31
485610,7,Positive,30,5,35
485620,6,Mostly Positive,22,7,29
485630,5,Mixed,8,10,18
485640,5,Mixed,11,5,16
485650,0,5 user reviews,2,3,5
485660,0,9 user reviews,3,6,9
485670,5,Mixed,35,47,82
485680,7,Positive,18,1,19
485690,5,Mixed,122,62,184
485730,6,Mostly Positive,43,15,58
485740,5,Mixed,15,8,23
485750,5,Mixed,8,6,14
485790,0,3 user reviews,1,2,3
485800,0,2 user reviews,1,1,2
485820,5,Mixed,19,21,40
485830,5,Mixed,6,7,13
485860,5,Mixed,46,37,83
485870,8,Very Positive,99,19,118
485880,7,Positive,37,2,39
485890,5,Mixed,192,186,378
485900,8,Very Positive,119,22,141
485920,5,Mixed,8,6,14
485950,4,Mostly Negative,16,46,62
485970,7,Positive,9,1,10
485980,8,Very Positive,699,135,834
485990,0,1 user reviews,1,0,1
486002,0,1 user reviews,1,0,1
486003,0,3 user reviews,3,0,3
486004,0,2 user reviews,1,1,2
486005,0,2 user reviews,1,1,2
486006,0,5 user reviews,4,1,5
486007,0,1 user reviews,1,0,1
486020,0,4 user reviews,2,2,4
486040,0,2 user reviews,2,0,2
486100,0,5 user reviews,1,4,5
486110,0,1 user reviews,1,0,1
486120,0,3 user reviews,1,2,3
486130,0,5 user reviews,2,3,5
486140,0,3 user reviews,2,1,3
486150,4,Mostly Negative,6,10,16
486170,0,6 user reviews,1,5,6
486180,0,3 user reviews,3,0,3
486190,0,3 user reviews,3,0,3
486220,0,2 user reviews,2,0,2
486230,6,Mostly Positive,7,3,10
486290,7,Positive,21,0,21
486300,4,Mostly Negative,3,8,11
486310,8,Very Positive,1684,180,1864
486320,0,1 user reviews,1,0,1
486350,0,2 user reviews,2,0,2
486360,0,7 user reviews,6,1,7
486370,7,Positive,20,4,24
486380,8,Very Positive,75,2,77
486440,7,Positive,19,4,23
486470,5,Mixed,8,8,16
486480,0,8 user reviews,0,8,8
486490,0,9 user reviews,6,3,9
486500,0,2 user reviews,0,2,2
486510,8,Very Positive,147,26,173
486540,5,Mixed,25,12,37
486550,0,2 user reviews,0,2,2
486570,5,Mixed,118,59,177
486571,5,Mixed,9,5,14
486630,0,5 user reviews,4,1,5
486640,0,5 user reviews,2,3,5
486650,6,Mostly Positive,172,44,216
486660,0,4 user reviews,4,0,4
486670,0,4 user reviews,2,2,4
486690,0,7 user reviews,4,3,7
486720,8,Very Positive,309,38,347
486760,0,1 user reviews,0,1,1
486770,0,1 user reviews,1,0,1
486780,8,Very Positive,349,72,421
486810,7,Positive,24,5,29
486850,5,Mixed,5,5,10
486860,8,Very Positive,259,38,297
486880,4,Mostly Negative,2,8,10
486890,0,1 user reviews,1,0,1
486940,0,4 user reviews,4,0,4
486970,5,Mixed,10,15,25
486990,0,5 user reviews,2,3,5
487000,8,Very Positive,399,87,486
487010,0,1 user reviews,1,0,1
487020,7,Positive,13,1,14
487030,6,Mostly Positive,10,4,14
487040,6,Mostly Positive,10,4,14
487050,0,1 user reviews,1,0,1
487120,5,Mixed,1749,950,2699
487130,0,1 user reviews,1,0,1
487150,0,5 user reviews,3,2,5
487160,7,Positive,39,3,42
487180,5,Mixed,11,5,16
487210,6,Mostly Positive,95,27,122
487220,6,Mostly Positive,113,44,157
487240,7,Positive,10,0,10
487250,0,7 user reviews,5,2,7
487270,4,Mostly Negative,2,8,10
487280,8,Very Positive,56,7,63
487300,0,2 user reviews,2,0,2
487320,0,6 user reviews,3,3,6
487330,5,Mixed,13,7,20
487350,7,Positive,10,0,10
487370,5,Mixed,12,6,18
487380,0,8 user reviews,6,2,8
487420,0,5 user reviews,3,2,5
487430,8,Very Positive,169,12,181
487460,0,2 user reviews,2,0,2
487480,0,1 user reviews,1,0,1
487530,5,Mixed,5,7,12
487570,0,5 user reviews,4,1,5
487580,0,9 user reviews,5,4,9
487590,0,8 user reviews,7,1,8
487600,0,7 user reviews,6,1,7
487630,5,Mixed,5,7,12
487700,8,Very Positive,184,11,195
487720,5,Mixed,341,447,788
487730,0,4 user reviews,4,0,4
487770,6,Mostly Positive,26,7,33
487990,0,1 user reviews,1,0,1
488010,0,2 user reviews,1,1,2
488020,0,2 user reviews,1,1,2
488040,6,Mostly Positive,47,14,61
488050,0,4 user reviews,3,1,4
488060,8,Very Positive,137,29,166
488070,0,7 user reviews,3,4,7
488080,0,1 user reviews,1,0,1
488150,5,Mixed,16,8,24
488210,5,Mixed,19,17,36
488220,0,2 user reviews,2,0,2
488250,0,1 user reviews,1,0,1
488260,0,1 user reviews,1,0,1
488280,8,Very Positive,88,17,105
488300,6,Mostly Positive,143,38,181
488310,9,Overwhelmingly Positive,1142,59,1201
488330,0,1 user reviews,0,1,1
488340,7,Positive,26,3,29
488350,4,Mostly Negative,13,34,47
488360,5,Mixed,10,14,24
488370,0,1 user reviews,1,0,1
488390,0,3 user reviews,3,0,3
488440,0,4 user reviews,2,2,4
488460,0,2 user reviews,2,0,2
488470,7,Positive,16,1,17
488480,0,2 user reviews,2,0,2
488500,0,1 user reviews,1,0,1
488520,0,5 user reviews,5,0,5
488550,8,Very Positive,283,27,310
488560,0,1 user reviews,1,0,1
488580,6,Mostly Positive,21,6,27
488590,7,Positive,20,2,22
488650,0,2 user reviews,2,0,2
488660,8,Very Positive,118,26,144
488690,7,Positive,16,4,20
488700,0,1 user reviews,1,0,1
488730,6,Mostly Positive,72,27,99
488750,0,1 user reviews,1,0,1
488760,8,Very Positive,88,14,102
488770,6,Mostly Positive,126,35,161
488790,6,Mostly Positive,5339,1678,7017
488810,0,7 user reviews,6,1,7
488811,0,6 user reviews,5,1,6
488812,0,5 user reviews,4,1,5
488820,0,3 user reviews,3,0,3
488821,0,2 user reviews,0,2,2
488822,0,2 user reviews,1,1,2
488823,0,2 user reviews,2,0,2
488824,0,2 user reviews,1,1,2
488890,7,Positive,13,3,16
488910,0,3 user reviews,2,1,3
488920,6,Mostly Positive,181,49,230
488950,5,Mixed,55,29,84
488960,7,Positive,11,1,12
488996,0,1 user reviews,1,0,1
489000,0,2 user reviews,0,2,2
489020,5,Mixed,48,39,87
489040,0,8 user reviews,8,0,8
489050,0,6 user reviews,2,4,6
489070,4,Mostly Negative,4,8,12
489080,0,2 user reviews,1,1,2
489100,0,8 user reviews,7,1,8
489110,7,Positive,34,0,34
489120,0,5 user reviews,5,0,5
489140,8,Very Positive,300,37,337
489160,0,4 user reviews,3,1,4
489170,5,Mixed,28,15,43
489180,5,Mixed,45,21,66
489220,5,Mixed,6,4,10
489240,0,7 user reviews,0,7,7
489260,5,Mixed,26,19,45
489360,6,Mostly Positive,281,97,378
489370,5,Mixed,68,40,108
489380,8,Very Positive,355,32,387
489400,0,8 user reviews,6,2,8
489440,6,Mostly Positive,23,6,29
489460,6,Mostly Positive,200,82,282
489470,4,Mostly Negative,11,20,31
489490,0,2 user reviews,1,1,2
489520,8,Very Positive,433,94,527
489530,0,2 user reviews,1,1,2
489560,0,1 user reviews,1,0,1
489570,5,Mixed,20,17,37
489580,6,Mostly Positive,12,5,17
489590,0,2 user reviews,2,0,2
489600,6,Mostly Positive,251,99,350
489610,8,Very Positive,123,18,141
489630,8,Very Positive,1348,332,1680
489660,6,Mostly Positive,30,10,40
489700,0,3 user reviews,1,2,3
489720,7,Positive,16,2,18
489730,0,1 user reviews,1,0,1
489740,0,8 user reviews,6,2,8
489750,0,6 user reviews,2,4,6
489760,7,Positive,24,2,26
489780,0,1 user reviews,1,0,1
489810,0,5 user reviews,5,0,5
489830,8,Very Positive,29179,1905,31084
489890,5,Mixed,9,6,15
489900,0,2 user reviews,1,1,2
489910,0,5 user reviews,5,0,5
489930,8,Very Positive,48,12,60
489940,5,Mixed,5648,3399,9047
490040,0,9 user reviews,8,1,9
490060,5,Mixed,20,15,35
490080,5,Mixed,15,21,36
490090,6,Mostly Positive,19,8,27
490100,7,Positive,30,0,30
490130,0,1 user reviews,1,0,1
490160,7,Positive,32,1,33
490170,7,Positive,16,1,17
490180,0,5 user reviews,5,0,5
490190,0,1 user reviews,1,0,1
490191,0,1 user reviews,1,0,1
490220,8,Very Positive,86,8,94
490230,7,Positive,21,1,22
490250,7,Positive,18,4,22
490260,7,Positive,16,0,16
490270,7,Positive,33,1,34
490280,8,Very Positive,149,24,173
490300,0,4 user reviews,3,1,4
490310,0,5 user reviews,5,0,5
490320,0,8 user reviews,8,0,8
490330,5,Mixed,17,9,26
490370,8,Very Positive,136,24,160
490380,3,Negative,4,20,24
490390,5,Mixed,7,4,11
490430,0,1 user reviews,1,0,1
490450,6,Mostly Positive,117,45,162
490490,8,Very Positive,135,16,151
490510,0,7 user reviews,7,0,7
490650,5,Mixed,719,621,1340
490690,7,Positive,11,2,13
490820,8,Very Positive,66,16,82
490850,0,2 user reviews,2,0,2
490860,7,Positive,27,3,30
490870,0,7 user reviews,5,2,7
490880,6,Mostly Positive,12,5,17
490890,6,Mostly Positive,24,8,32
490910,0,3 user reviews,2,1,3
490920,8,Very Positive,488,36,524
490930,6,Mostly Positive,90,25,115
490950,8,Very Positive,56,6,62
490980,6,Mostly Positive,31,10,41
490990,4,Mostly Negative,13,28,41
491000,6,Mostly Positive,93,30,123
491010,6,Mostly Positive,12,5,17
491020,0,2 user reviews,1,1,2
491040,8,Very Positive,401,21,422
491060,7,Positive,13,3,16
491070,0,3 user reviews,2,1,3
491090,5,Mixed,65,45,110
491100,0,1 user reviews,1,0,1
491110,0,5 user reviews,5,0,5
491130,7,Positive,14,2,16
491160,5,Mixed,20,10,30
491180,0,8 user reviews,5,3,8
491210,7,Positive,13,3,16
491220,6,Mostly Positive,7,3,10
491240,7,Positive,12,0,12
491260,5,Mixed,35,21,56
491280,4,Mostly Negative,50,85,135
491290,0,3 user reviews,2,1,3
491330,8,Very Positive,88,5,93
491340,0,1 user reviews,1,0,1
491350,7,Positive,24,2,26
491390,0,8 user reviews,8,0,8
491400,0,4 user reviews,3,1,4
491403,0,1 user reviews,1,0,1
491410,0,1 user reviews,0,1,1
491420,0,4 user reviews,3,1,4
491440,0,9 user reviews,7,2,9
491470,5,Mixed,22,10,32
491490,5,Mixed,10,5,15
491491,0,7 user reviews,6,1,7
491492,0,8 user reviews,6,2,8
491493,0,2 user reviews,2,0,2
491494,6,Mostly Positive,8,3,11
491495,5,Mixed,15,9,24
491496,0,4 user reviews,1,3,4
491498,0,8 user reviews,7,1,8
491499,0,4 user reviews,2,2,4
491510,5,Mixed,10,6,16
491520,4,Mostly Negative,19,30,49
491530,6,Mostly Positive,229,94,323
491560,5,Mixed,9,7,16
491580,5,Mixed,6,4,10
491620,7,Positive,26,6,32
491650,5,Mixed,13,12,25
491660,0,6 user reviews,5,1,6
491670,6,Mostly Positive,18,7,25
491690,0,3 user reviews,3,0,3
491700,0,9 user reviews,5,4,9
491710,0,8 user reviews,1,7,8
491720,0,8 user reviews,8,0,8
491740,0,2 user reviews,1,1,2
491770,4,Mostly Negative,16,36,52
491780,0,1 user reviews,1,0,1
491790,0,1 user reviews,0,1,1
491800,0,6 user reviews,1,5,6
491830,7,Positive,10,1,11
491950,8,Very Positive,3496,324,3820
492070,0,1 user reviews,1,0,1
492080,5,Mixed,18,8,26
492090,6,Mostly Positive,12,5,17
492140,6,Mostly Positive,32,9,41
492150,5,Mixed,98,44,142
492160,0,6 user reviews,2,4,6
492170,0,9 user reviews,4,5,9
492180,7,Positive,18,2,20
492200,0,3 user reviews,3,0,3
492220,5,Mixed,47,24,71
492230,5,Mixed,165,89,254
492270,5,Mixed,28,18,46
492280,5,Mixed,8,5,13
492290,6,Mostly Positive,96,28,124
492330,0,1 user reviews,0,1,1
492340,8,Very Positive,57,10,67
492370,6,Mostly Positive,44,14,58
492390,0,1 user reviews,1,0,1
492391,0,1 user reviews,0,1,1
492400,0,3 user reviews,2,1,3
492410,6,Mostly Positive,12,4,16
492430,5,Mixed,17,13,30
492470,7,Positive,12,2,14
492480,0,5 user reviews,5,0,5
492490,4,Mostly Negative,9,17,26
492500,6,Mostly Positive,103,30,133
492510,7,Positive,16,4,20
492530,7,Positive,38,8,46
492560,0,1 user reviews,1,0,1
492580,0,1 user reviews,0,1,1
492581,0,2 user reviews,1,1,2
492600,0,4 user reviews,1,3,4
492610,0,9 user reviews,3,6,9
492630,8,Very Positive,209,33,242
492640,0,3 user reviews,3,0,3
492670,0,5 user reviews,5,0,5
492680,7,Positive,29,7,36
492690,7,Positive,10,0,10
492700,0,7 user reviews,7,0,7
492710,6,Mostly Positive,53,18,71
492720,8,Very Positive,4447,674,5121
492740,8,Very Positive,73,16,89
492750,0,6 user reviews,5,1,6
492760,8,Very Positive,59,9,68
492800,0,5 user reviews,3,2,5
492820,0,4 user reviews,4,0,4
492821,0,3 user reviews,3,0,3
492822,0,4 user reviews,4,0,4
492830,0,3 user reviews,1,2,3
492850,6,Mostly Positive,7,3,10
492860,0,1 user reviews,1,0,1
492870,5,Mixed,17,9,26
492890,0,5 user reviews,4,1,5
492891,0,3 user reviews,2,1,3
492892,0,2 user reviews,2,0,2
492940,0,1 user reviews,1,0,1
492943,0,1 user reviews,1,0,1
492945,0,1 user reviews,1,0,1
492946,0,1 user reviews,1,0,1
492950,0,1 user reviews,0,1,1
492952,0,1 user reviews,1,0,1
492954,0,2 user reviews,2,0,2
492958,0,2 user reviews,2,0,2
492962,0,1 user reviews,1,0,1
492963,0,2 user reviews,2,0,2
492968,0,5 user reviews,3,2,5
492971,4,Mostly Negative,4,8,12
492973,0,2 user reviews,1,1,2
492977,0,1 user reviews,1,0,1
492981,0,5 user reviews,5,0,5
492983,0,1 user reviews,1,0,1
492985,0,3 user reviews,3,0,3
492986,0,1 user reviews,1,0,1
492987,0,2 user reviews,1,1,2
493000,0,6 user reviews,2,4,6
493040,0,5 user reviews,4,1,5
493060,8,Very Positive,90,15,105
493070,0,8 user reviews,8,0,8
493080,8,Very Positive,135,14,149
493100,7,Positive,22,4,26
493110,0,9 user reviews,8,1,9
493150,0,3 user reviews,3,0,3
493180,7,Positive,18,3,21
493190,8,Very Positive,89,1,90
493200,8,Very Positive,1005,129,1134
493220,6,Mostly Positive,28,11,39
493230,0,3 user reviews,3,0,3
493240,0,2 user reviews,2,0,2
493290,6,Mostly Positive,12,4,16
493300,0,1 user reviews,1,0,1
493310,7,Positive,22,4,26
493320,6,Mostly Positive,13,4,17
493330,0,2 user reviews,2,0,2
493340,8,Very Positive,15412,1926,17338
493370,5,Mixed,10,8,18
493380,0,8 user reviews,6,2,8
493410,6,Mostly Positive,13,5,18
493420,0,3 user reviews,2,1,3
493430,0,6 user reviews,6,0,6
493450,5,Mixed,22,13,35
493490,5,Mixed,974,487,1461
493500,0,5 user reviews,0,5,5
493520,8,Very Positive,7274,929,8203
493530,6,Mostly Positive,90,36,126
493540,8,Very Positive,104,18,122
493580,5,Mixed,27,36,63
493610,0,7 user reviews,3,4,7
493620,6,Mostly Positive,7,3,10
493650,4,Mostly Negative,15,38,53
493670,0,3 user reviews,3,0,3
493700,7,Positive,9,1,10
493710,5,Mixed,12,6,18
493720,6,Mostly Positive,173,48,221
493770,0,3 user reviews,1,2,3
493780,0,1 user reviews,0,1,1
493790,5,Mixed,14,8,22
493810,0,1 user reviews,1,0,1
493820,0,1 user reviews,0,1,1
493840,5,Mixed,450,313,763
493880,4,Mostly Negative,4,12,16
493900,8,Very Positive,3510,247,3757
493920,0,1 user reviews,1,0,1
493950,7,Positive,38,0,38
493980,0,3 user reviews,3,0,3
494000,0,4 user reviews,2,2,4
494020,0,1 user reviews,0,1,1
494040,0,3 user reviews,2,1,3
494050,5,Mixed,10,10,20
494080,0,4 user reviews,3,1,4
494090,0,9 user reviews,4,5,9
494100,7,Positive,48,1,49
494120,0,2 user reviews,1,1,2
494140,0,8 user reviews,3,5,8
494150,9,Overwhelmingly Positive,1390,56,1446
494160,0,6 user reviews,5,1,6
494170,7,Positive,17,4,21
494220,0,1 user reviews,1,0,1
494230,8,Very Positive,171,14,185
494290,5,Mixed,6,4,10
494310,7,Positive,40,1,41
494320,5,Mixed,43,31,74
494350,4,Mostly Negative,7,11,18
494360,7,Positive,43,2,45
494370,6,Mostly Positive,15,4,19
494380,0,6 user reviews,1,5,6
494391,0,4 user reviews,4,0,4
494392,0,9 user reviews,5,4,9
494420,7,Positive,10,0,10
494430,8,Very Positive,423,71,494
494440,5,Mixed,15,21,36
494450,5,Mixed,24,26,50
494460,5,Mixed,17,21,38
494470,5,Mixed,23,24,47
494480,0,1 user reviews,1,0,1
494510,0,2 user reviews,1,1,2
494520,0,4 user reviews,4,0,4
494521,0,1 user reviews,0,1,1
494522,5,Mixed,7,4,11
494523,7,Positive,11,2,13
494524,0,9 user reviews,6,3,9
494525,0,9 user reviews,2,7,9
494526,0,4 user reviews,2,2,4
494527,0,1 user reviews,1,0,1
494529,4,Mostly Negative,6,18,24
494530,4,Mostly Negative,3,10,13
494550,0,1 user reviews,0,1,1
494570,0,1 user reviews,1,0,1
494580,5,Mixed,25,11,36
494600,7,Positive,34,6,40
494630,5,Mixed,69,49,118
494650,0,1 user reviews,1,0,1
494670,5,Mixed,69,70,139
494680,7,Positive,41,3,44
494700,5,Mixed,11,5,16
494720,8,Very Positive,152,9,161
494740,7,Positive,25,4,29
494780,0,8 user reviews,5,3,8
494790,0,1 user reviews,1,0,1
494810,8,Very Positive,148,20,168
494830,5,Mixed,43,23,66
494840,6,Mostly Positive,2556,686,3242
494850,0,1 user reviews,0,1,1
494881,0,1 user reviews,1,0,1
494900,7,Positive,20,3,23
494960,8,Very Positive,59,10,69
494970,0,4 user reviews,3,1,4
494980,0,7 user reviews,4,3,7
494990,5,Mixed,6,9,15
495010,0,3 user reviews,2,1,3
495030,0,1 user reviews,1,0,1
495050,8,Very Positive,303,42,345
495090,5,Mixed,6,6,12
495110,8,Very Positive,154,14,168
495140,5,Mixed,360,164,524
495160,6,Mostly Positive,103,34,137
495200,0,3 user reviews,1,2,3
495230,0,3 user reviews,2,1,3
495280,8,Very Positive,520,48,568
495290,8,Very Positive,93,13,106
495300,5,Mixed,11,7,18
495320,5,Mixed,6,5,11
495350,5,Mixed,41,26,67
495360,0,2 user reviews,1,1,2
495370,7,Positive,8,2,10
495371,0,9 user reviews,4,5,9
495380,5,Mixed,10,8,18
495390,0,5 user reviews,3,2,5
495410,0,7 user reviews,7,0,7
495420,8,Very Positive,2820,578,3398
495480,5,Mixed,75,44,119
495510,0,3 user reviews,2,1,3
495520,0,1 user reviews,1,0,1
495540,0,1 user reviews,0,1,1
495550,0,2 user reviews,2,0,2
495560,5,Mixed,403,211,614
495570,6,Mostly Positive,14,6,20
495580,5,Mixed,48,41,89
495600,0,2 user reviews,2,0,2
495630,0,3 user reviews,3,0,3
495680,6,Mostly Positive,7,3,10
495700,7,Positive,30,4,34
495720,8,Very Positive,86,14,100
495730,0,1 user reviews,0,1,1
495760,6,Mostly Positive,9,3,12
495770,0,1 user reviews,0,1,1
495780,7,Positive,36,8,44
495820,0,5 user reviews,5,0,5
495830,7,Positive,8,2,10
495890,9,Overwhelmingly Positive,3619,165,3784
495900,6,Mostly Positive,23,6,29
495910,6,Mostly Positive,36,14,50
495920,7,Positive,9,2,11
495930,6,Mostly Positive,19,7,26
495950,3,Negative,4,17,21
495951,0,6 user reviews,3,3,6
495953,0,2 user reviews,1,1,2
495954,0,2 user reviews,1,1,2
495960,5,Mixed,10,9,19
495980,5,Mixed,32,18,50
495990,7,Positive,25,6,31
496000,0,4 user reviews,3,1,4
496030,0,9 user reviews,7,2,9
496040,6,Mostly Positive,34,9,43
496080,0,3 user reviews,2,1,3
496100,2,Very Negative,10,65,75
496101,4,Mostly Negative,10,20,30
496102,0,4 user reviews,4,0,4
496103,7,Positive,22,5,27
496104,0,4 user reviews,4,0,4
496120,7,Positive,25,2,27
496190,7,Positive,9,2,11
496230,0,5 user reviews,2,3,5
496240,6,Mostly Positive,3310,1079,4389
496250,8,Very Positive,135,23,158
496260,8,Very Positive,62,4,66
496290,5,Mixed,8,4,12
496300,8,Very Positive,2352,354,2706
496310,5,Mixed,6,6,12
496320,0,1 user reviews,1,0,1
496340,5,Mixed,41,25,66
496350,7,Positive,35,3,38
496360,0,3 user reviews,0,3,3
496380,0,4 user reviews,2,2,4
496390,0,7 user reviews,4,3,7
496400,5,Mixed,7,10,17
496430,0,3 user reviews,3,0,3
496431,6,Mostly Positive,7,3,10
496432,7,Positive,10,2,12
496435,0,2 user reviews,1,1,2
496438,0,3 user reviews,3,0,3
496439,0,2 user reviews,2,0,2
496440,0,2 user reviews,1,1,2
496450,6,Mostly Positive,33,9,42
496460,5,Mixed,1019,685,1704
496480,0,9 user reviews,6,3,9
496490,5,Mixed,32,28,60
496510,5,Mixed,15,7,22
496520,0,2 user reviews,0,2,2
496530,5,Mixed,6,6,12
496540,7,Positive,12,3,15
496550,5,Mixed,88,130,218
496580,7,Positive,33,1,34
496590,0,2 user reviews,1,1,2
496610,0,4 user reviews,2,2,4
496620,8,Very Positive,358,83,441
496630,7,Positive,42,5,47
496640,4,Mostly Negative,12,19,31
496650,4,Mostly Negative,8,19,27
496660,0,9 user reviews,4,5,9
496670,0,6 user reviews,3,3,6
496680,4,Mostly Negative,26,71,97
496690,0,3 user reviews,1,2,3
496710,0,1 user reviews,0,1,1
496730,5,Mixed,104,57,161
496740,6,Mostly Positive,43,12,55
496750,4,Mostly Negative,14,29,43
496760,7,Positive,43,4,47
496790,0,4 user reviews,3,1,4
496800,0,3 user reviews,3,0,3
496810,8,Very Positive,397,71,468
496820,0,4 user reviews,2,2,4
496850,0,4 user reviews,4,0,4
496890,6,Mostly Positive,244,62,306
496910,5,Mixed,7,8,15
496930,5,Mixed,13,7,20
496940,0,2 user reviews,2,0,2
496950,5,Mixed,6,6,12
496960,4,Mostly Negative,3,7,10
496971,0,1 user reviews,1,0,1
496972,0,3 user reviews,3,0,3
496980,0,9 user reviews,5,4,9
496990,0,8 user reviews,5,3,8
497000,0,5 user reviews,2,3,5
497010,0,1 user reviews,1,0,1
497020,5,Mixed,7,4,11
497040,6,Mostly Positive,8,3,11
497050,5,Mixed,11,11,22
497060,0,1 user reviews,1,0,1
497080,7,Positive,24,5,29
497100,5,Mixed,16,7,23
497150,6,Mostly Positive,12,5,17
497170,0,5 user reviews,5,0,5
497180,8,Very Positive,1005,187,1192
497190,0,4 user reviews,4,0,4
497240,0,3 user reviews,1,2,3
497260,0,6 user reviews,4,2,6
497270,6,Mostly Positive,10,4,14
497280,0,4 user reviews,2,2,4
497300,0,7 user reviews,3,4,7
497310,0,4 user reviews,3,1,4
497360,5,Mixed,11,10,21
497400,6,Mostly Positive,109,44,153
497420,7,Positive,18,4,22
497440,5,Mixed,35,45,80
497450,7,Positive,31,6,37
497460,7,Positive,41,4,45
497470,5,Mixed,15,17,32
497480,0,1 user reviews,1,0,1
497490,0,1 user reviews,1,0,1
497510,7,Positive,16,1,17
497520,0,1 user reviews,1,0,1
497521,0,1 user reviews,1,0,1
497560,0,8 user reviews,2,6,8
497580,5,Mixed,14,15,29
497590,0,1 user reviews,1,0,1
497610,0,1 user reviews,1,0,1
497611,0,4 user reviews,3,1,4
497620,0,5 user reviews,5,0,5
497621,0,1 user reviews,1,0,1
497630,0,1 user reviews,0,1,1
497640,7,Positive,14,3,17
497660,5,Mixed,7,4,11
497670,7,Positive,10,2,12
497680,6,Mostly Positive,22,9,31
497690,7,Positive,21,0,21
497700,7,Positive,32,8,40
497710,0,7 user reviews,5,2,7
497720,5,Mixed,11,12,23
497730,5,Mixed,47,21,68
497760,0,3 user reviews,2,1,3
497780,8,Very Positive,164,4,168
497790,0,6 user reviews,6,0,6
497800,8,Very Positive,130,4,134
497820,0,6 user reviews,6,0,6
497850,8,Very Positive,183,44,227
497860,0,1 user reviews,1,0,1
497880,0,5 user reviews,2,3,5
497900,0,2 user reviews,1,1,2
497940,0,3 user reviews,1,2,3
497970,7,Positive,22,2,24
497990,0,5 user reviews,4,1,5
498000,0,7 user reviews,5,2,7
498020,0,7 user reviews,7,0,7
498030,0,2 user reviews,1,1,2
498050,0,6 user reviews,1,5,6
498110,0,2 user reviews,2,0,2
498190,7,Positive,32,8,40
498210,0,7 user reviews,5,2,7
498220,0,1 user reviews,0,1,1
498230,0,1 user reviews,1,0,1
498240,6,Mostly Positive,3345,942,4287
498280,0,8 user reviews,2,6,8
498290,0,1 user reviews,1,0,1
498300,4,Mostly Negative,5,9,14
498310,7,Positive,31,1,32
498330,8,Very Positive,374,36,410
498340,5,Mixed,36,21,57
498360,0,2 user reviews,2,0,2
498370,0,2 user reviews,0,2,2
498380,0,6 user reviews,6,0,6
498390,0,2 user reviews,2,0,2
498400,0,2 user reviews,2,0,2
498450,0,4 user reviews,2,2,4
498460,0,4 user reviews,0,4,4
498470,7,Positive,44,0,44
498500,5,Mixed,64,29,93
498520,7,Positive,9,2,11
498540,0,5 user reviews,3,2,5
498550,4,Mostly Negative,4,7,11
498570,8,Very Positive,79,13,92
498580,5,Mixed,6,7,13
498590,0,1 user reviews,1,0,1
498600,0,1 user reviews,0,1,1
498620,0,4 user reviews,3,1,4
498630,0,9 user reviews,2,7,9
498660,8,Very Positive,53,10,63
498680,0,4 user reviews,1,3,4
498700,0,6 user reviews,4,2,6
498720,0,6 user reviews,4,2,6
498740,0,1 user reviews,1,0,1
498760,0,3 user reviews,3,0,3
498770,0,6 user reviews,6,0,6
498790,0,6 user reviews,3,3,6
498830,0,5 user reviews,5,0,5
498840,0,3 user reviews,1,2,3
498850,0,5 user reviews,4,1,5
498870,6,Mostly Positive,175,63,238
498940,0,8 user reviews,4,4,8
498980,6,Mostly Positive,15,6,21
498990,0,9 user reviews,8,1,9
499070,6,Mostly Positive,10,3,13
499100,7,Positive,27,6,33
499110,7,Positive,16,1,17
499120,7,Positive,15,2,17
499140,7,Positive,14,0,14
499210,4,Mostly Negative,5,10,15
499230,6,Mostly Positive,35,14,49
499250,0,1 user reviews,1,0,1
499330,5,Mixed,5,5,10
499340,7,Positive,19,1,20
499370,7,Positive,13,2,15
499400,7,Positive,35,7,42
499410,7,Positive,9,1,10
499420,0,7 user reviews,3,4,7
499440,9,Overwhelmingly Positive,1343,38,1381
499460,8,Very Positive,67,16,83
499510,0,6 user reviews,5,1,6
499520,8,Very Positive,2587,380,2967
499530,0,3 user reviews,0,3,3
499540,0,2 user reviews,1,1,2
499550,0,5 user reviews,4,1,5
499590,5,Mixed,14,8,22
499610,5,Mixed,9,10,19
499620,8,Very Positive,142,35,177
499660,8,Very Positive,851,200,1051
499760,6,Mostly Positive,16,5,21
499890,8,Very Positive,87,10,97
499900,0,3 user reviews,1,2,3
499910,8,Very Positive,68,4,72
499940,5,Mixed,8,6,14
500080,0,1 user reviews,1,0,1
500090,0,2 user reviews,2,0,2
500100,0,3 user reviews,3,0,3
500110,7,Positive,24,4,28
500120,0,3 user reviews,2,1,3
500140,0,5 user reviews,2,3,5
500160,0,1 user reviews,1,0,1
500170,4,Mostly Negative,6,16,22
500180,0,2 user reviews,2,0,2
500190,5,Mixed,24,13,37
500202,0,1 user reviews,0,1,1
500208,7,Positive,9,1,10
500210,0,4 user reviews,3,1,4
500211,6,Mostly Positive,20,8,28
500212,0,5 user reviews,4,1,5
500214,0,9 user reviews,6,3,9
500215,0,1 user reviews,0,1,1
500216,0,1 user reviews,1,0,1
500218,6,Mostly Positive,18,6,24
500220,0,4 user reviews,3,1,4
500230,5,Mixed,17,8,25
500232,5,Mixed,9,6,15
500233,7,Positive,12,2,14
500234,7,Positive,13,3,16
500235,0,7 user reviews,5,2,7
500236,0,3 user reviews,1,2,3
500237,7,Positive,10,1,11
500238,0,2 user reviews,2,0,2
500239,5,Mixed,11,7,18
500240,0,1 user reviews,0,1,1
500241,0,8 user reviews,7,1,8
500242,0,2 user reviews,0,2,2
500243,0,5 user reviews,3,2,5
500244,7,Positive,9,2,11
500245,0,1 user reviews,1,0,1
500246,0,1 user reviews,1,0,1
500247,6,Mostly Positive,10,3,13
500248,5,Mixed,8,4,12
500249,0,4 user reviews,3,1,4
500250,0,1 user reviews,1,0,1
500260,8,Very Positive,202,49,251
500270,5,Mixed,30,26,56
500271,6,Mostly Positive,22,7,29
500272,6,Mostly Positive,34,10,44
500290,6,Mostly Positive,17,5,22
500320,5,Mixed,15,9,24
500340,7,Positive,9,1,10
500350,0,5 user reviews,4,1,5
500360,0,1 user reviews,1,0,1
500370,0,8 user reviews,7,1,8
500390,0,2 user reviews,2,0,2
500391,0,2 user reviews,1,1,2
500392,0,3 user reviews,3,0,3
500400,0,1 user reviews,0,1,1
500420,6,Mostly Positive,24,8,32
500460,7,Positive,16,0,16
500461,0,1 user reviews,1,0,1
500470,7,Positive,26,2,28
500480,5,Mixed,21,10,31
500500,6,Mostly Positive,128,42,170
500540,0,6 user reviews,4,2,6
500550,0,7 user reviews,6,1,7
500570,0,2 user reviews,1,1,2
500580,7,Positive,46,2,48
500590,7,Positive,20,0,20
500620,7,Positive,14,3,17
500650,0,1 user reviews,1,0,1
500670,8,Very Positive,122,6,128
500680,0,6 user reviews,6,0,6
500690,7,Positive,21,1,22
500710,5,Mixed,76,74,150
500750,0,5 user reviews,3,2,5
500760,0,2 user reviews,1,1,2
500790,0,1 user reviews,1,0,1
500810,8,Very Positive,433,85,518
500870,5,Mixed,41,24,65
500880,0,8 user reviews,7,1,8
500920,0,2 user reviews,1,1,2
500940,0,8 user reviews,6,2,8
500980,0,5 user reviews,0,5,5
501020,5,Mixed,12,6,18
501030,6,Mostly Positive,13,4,17
501040,0,7 user reviews,7,0,7
501050,0,1 user reviews,1,0,1
501060,0,6 user reviews,0,6,6
501080,6,Mostly Positive,649,213,862
501090,6,Mostly Positive,26,7,33
501110,5,Mixed,46,23,69
501120,8,Very Positive,146,19,165
501170,0,2 user reviews,2,0,2
501171,0,1 user reviews,1,0,1
501180,5,Mixed,8,4,12
501190,5,Mixed,48,24,72
501210,8,Very Positive,144,25,169
501220,5,Mixed,17,12,29
501260,0,2 user reviews,2,0,2
501270,0,4 user reviews,3,1,4
501300,8,Very Positive,6443,421,6864
501310,0,4 user reviews,3,1,4
501320,5,Mixed,200,94,294
501350,6,Mostly Positive,51,17,68
501410,0,5 user reviews,4,1,5
501430,6,Mostly Positive,13,4,17
501440,0,9 user reviews,3,6,9
501450,0,6 user reviews,5,1,6
501460,0,1 user reviews,1,0,1
501480,6,Mostly Positive,10,3,13
501500,0,4 user reviews,4,0,4
501510,0,1 user reviews,1,0,1
501530,7,Positive,17,2,19
501570,0,2 user reviews,2,0,2
501580,0,3 user reviews,3,0,3
501590,8,Very Positive,1174,235,1409
501600,0,1 user reviews,0,1,1
501610,0,4 user reviews,3,1,4
501620,5,Mixed,7,5,12
501630,6,Mostly Positive,16,5,21
501640,0,6 user reviews,4,2,6
501670,0,5 user reviews,5,0,5
501671,0,4 user reviews,4,0,4
501740,0,9 user reviews,2,7,9
501750,0,6 user reviews,6,0,6
501760,5,Mixed,32,32,64
501790,8,Very Positive,223,27,250
501840,6,Mostly Positive,42,13,55
501860,5,Mixed,36,27,63
501930,6,Mostly Positive,16,5,21
501940,5,Mixed,11,9,20
501950,5,Mixed,18,8,26
501970,7,Positive,33,5,38
501990,8,Very Positive,58,11,69
502010,7,Positive,16,1,17
502090,4,Mostly Negative,3,8,11
502100,5,Mixed,11,5,16
502120,7,Positive,20,3,23
502140,5,Mixed,21,26,47
502150,7,Positive,9,1,10
502200,0,2 user reviews,1,1,2
502210,7,Positive,27,4,31
502230,8,Very Positive,74,6,80
502240,5,Mixed,18,23,41
502280,6,Mostly Positive,631,181,812
502300,5,Mixed,9,7,16
502320,5,Mixed,19,9,28
502340,6,Mostly Positive,9,3,12
502370,8,Very Positive,512,81,593
502380,0,4 user reviews,1,3,4
502400,5,Mixed,11,6,17
502410,5,Mixed,5,6,11
502420,5,Mixed,13,16,29
502430,0,9 user reviews,5,4,9
502440,0,6 user reviews,2,4,6
502450,0,4 user reviews,0,4,4
502460,0,3 user reviews,3,0,3
502480,0,5 user reviews,3,2,5
502490,7,Positive,18,4,22
502500,8,Very Positive,5279,948,6227
502520,8,Very Positive,2746,382,3128
502530,0,9 user reviews,7,2,9
502540,7,Positive,13,2,15
502550,5,Mixed,7,4,11
502560,0,2 user reviews,2,0,2
502570,7,Positive,44,2,46
502600,0,7 user reviews,4,3,7
502650,5,Mixed,13,7,20
502700,0,8 user reviews,7,1,8
502710,5,Mixed,87,38,125
502720,6,Mostly Positive,28,12,40
502740,8,Very Positive,128,14,142
502750,8,Very Positive,142,9,151
502770,6,Mostly Positive,204,58,262
502780,0,6 user reviews,5,1,6
502790,5,Mixed,6,5,11
502800,9,Overwhelmingly Positive,938,48,986
502810,0,4 user reviews,0,4,4
502820,6,Mostly Positive,420,173,593
502830,0,1 user reviews,1,0,1
502841,0,1 user reviews,1,0,1
502842,0,1 user reviews,1,0,1
502860,0,3 user reviews,3,0,3
502870,7,Positive,37,6,43
502880,4,Mostly Negative,4,16,20
502890,7,Positive,15,2,17
502891,0,8 user reviews,8,0,8
502910,0,6 user reviews,1,5,6
502920,0,6 user reviews,6,0,6
502940,8,Very Positive,271,36,307
502970,0,7 user reviews,6,1,7
502980,0,1 user reviews,1,0,1
502990,0,1 user reviews,0,1,1
503010,5,Mixed,8,9,17
503020,0,1 user reviews,1,0,1
503050,0,1 user reviews,1,0,1
503060,0,7 user reviews,7,0,7
503070,0,9 user reviews,8,1,9
503080,0,4 user reviews,3,1,4
503090,0,4 user reviews,1,3,4
503100,6,Mostly Positive,35,15,50
503110,0,3 user reviews,3,0,3
503130,0,6 user reviews,5,1,6
503140,0,6 user reviews,6,0,6
503150,7,Positive,12,1,13
503180,8,Very Positive,90,19,109
503210,6,Mostly Positive,43,16,59
503220,4,Mostly Negative,4,9,13
503240,5,Mixed,17,20,37
503280,7,Positive,23,4,27
503290,0,6 user reviews,4,2,6
503300,6,Mostly Positive,561,144,705
503320,0,6 user reviews,4,2,6
503340,7,Positive,34,6,40
503350,6,Mostly Positive,594,154,748
503370,5,Mixed,48,55,103
503380,0,2 user reviews,1,1,2
503390,5,Mixed,7,7,14
503400,8,Very Positive,298,15,313
503410,5,Mixed,8,4,12
503430,0,2 user reviews,2,0,2
503450,0,3 user reviews,1,2,3
503460,5,Mixed,11,8,19
503480,5,Mixed,16,11,27
503550,6,Mostly Positive,35,11,46
503560,8,Very Positive,2979,458,3437
503580,8,Very Positive,583,113,696
503620,6,Mostly Positive,410,129,539
503630,0,5 user reviews,5,0,5
503650,7,Positive,9,1,10
503680,0,4 user reviews,4,0,4
503690,0,4 user reviews,3,1,4
503700,0,2 user reviews,0,2,2
503710,5,Mixed,6,4,10
503720,0,9 user reviews,6,3,9
503730,0,3 user reviews,1,2,3
503750,0,1 user reviews,1,0,1
503770,8,Very Positive,265,42,307
503780,0,5 user reviews,2,3,5
503820,6,Mostly Positive,8,3,11
503830,5,Mixed,8,12,20
503860,7,Positive,23,0,23
503900,0,4 user reviews,1,3,4
503940,6,Mostly Positive,1813,470,2283
503950,6,Mostly Positive,13,4,17
503960,6,Mostly Positive,14,5,19
503980,0,6 user reviews,5,1,6
504000,7,Positive,37,5,42
504010,5,Mixed,10,5,15
504050,5,Mixed,519,241,760
504090,7,Positive,14,0,14
504100,5,Mixed,8,8,16
504110,5,Mixed,8,5,13
504130,6,Mostly Positive,241,74,315
504210,9,Overwhelmingly Positive,1251,61,1312
504230,9,Overwhelmingly Positive,11039,273,11312
504240,0,1 user reviews,0,1,1
504260,0,5 user reviews,3,2,5
504280,5,Mixed,7,6,13
504310,5,Mixed,22,15,37
504370,8,Very Positive,8524,1202,9726
504380,0,7 user reviews,6,1,7
504390,8,Very Positive,94,13,107
504400,6,Mostly Positive,40,11,51
504410,5,Mixed,15,9,24
504420,6,Mostly Positive,13,4,17
504430,6,Mostly Positive,11,3,14
504450,0,8 user reviews,3,5,8
504460,0,9 user reviews,8,1,9
504470,4,Mostly Negative,4,7,11
504490,0,7 user reviews,3,4,7
504500,0,4 user reviews,3,1,4
504550,0,5 user reviews,5,0,5
504560,5,Mixed,15,7,22
504570,0,1 user reviews,1,0,1
504580,0,4 user reviews,4,0,4
504620,0,3 user reviews,3,0,3
504630,0,2 user reviews,1,1,2
504640,0,4 user reviews,4,0,4
504650,6,Mostly Positive,50,16,66
504660,0,2 user reviews,1,1,2
504670,0,6 user reviews,4,2,6
504680,8,Very Positive,181,7,188
504690,7,Positive,18,3,21
504700,7,Positive,17,1,18
504710,5,Mixed,25,31,56
504720,5,Mixed,30,36,66
504750,0,7 user reviews,5,2,7
504770,8,Very Positive,435,35,470
504790,7,Positive,25,1,26
504800,7,Positive,39,8,47
504810,5,Mixed,10,6,16
504840,7,Positive,10,0,10
504850,0,6 user reviews,5,1,6
504880,6,Mostly Positive,15,4,19
504920,6,Mostly Positive,39,12,51
504930,0,1 user reviews,1,0,1
504980,5,Mixed,7,4,11
505015,0,1 user reviews,1,0,1
505020,0,6 user reviews,4,2,6
505040,8,Very Positive,885,49,934
505060,8,Very Positive,192,13,205
505070,7,Positive,19,3,22
505080,5,Mixed,24,13,37
505090,5,Mixed,18,20,38
505100,0,2 user reviews,2,0,2
505110,0,4 user reviews,4,0,4
505120,0,9 user reviews,5,4,9
505140,0,6 user reviews,3,3,6
505150,7,Positive,25,1,26
505170,6,Mostly Positive,629,193,822
505210,5,Mixed,49,22,71
505220,0,7 user reviews,4,3,7
505230,8,Very Positive,1611,133,1744
505270,0,4 user reviews,3,1,4
505290,0,2 user reviews,2,0,2
505330,6,Mostly Positive,44,17,61
505340,0,1 user reviews,1,0,1
505400,0,8 user reviews,8,0,8
505410,0,1 user reviews,0,1,1
505420,0,7 user reviews,1,6,7
505460,6,Mostly Positive,5328,1411,6739
505540,6,Mostly Positive,70,26,96
505550,5,Mixed,6,5,11
505560,0,4 user reviews,3,1,4
505610,0,4 user reviews,2,2,4
505630,8,Very Positive,257,39,296
505640,8,Very Positive,256,53,309
505660,7,Positive,14,0,14
505680,6,Mostly Positive,10,3,13
505700,8,Very Positive,138,5,143
505730,6,Mostly Positive,132,48,180
505740,6,Mostly Positive,77,29,106
505750,7,Positive,21,4,25
506030,0,5 user reviews,1,4,5
506040,6,Mostly Positive,13,4,17
506080,5,Mixed,6,4,10
506090,0,4 user reviews,2,2,4
506100,0,8 user reviews,4,4,8
506140,6,Mostly Positive,23,7,30
506150,7,Positive,10,1,11
506160,0,6 user reviews,3,3,6
506220,0,1 user reviews,1,0,1
506230,0,1 user reviews,1,0,1
506240,0,4 user reviews,3,1,4
506260,5,Mixed,12,8,20
506300,0,4 user reviews,4,0,4
506350,0,1 user reviews,1,0,1
506360,0,3 user reviews,2,1,3
506440,0,1 user reviews,1,0,1
506460,0,6 user reviews,6,0,6
506470,0,4 user reviews,3,1,4
506500,6,Mostly Positive,252,94,346
506510,8,Very Positive,107,7,114
506540,4,Mostly Negative,5,17,22
506550,6,Mostly Positive,14,4,18
506570,0,5 user reviews,2,3,5
506590,6,Mostly Positive,17,7,24
506610,8,Very Positive,3773,330,4103
506660,0,2 user reviews,0,2,2
506670,7,Positive,14,2,16
506700,0,5 user reviews,5,0,5
506730,5,Mixed,142,90,232
506750,5,Mixed,6,4,10
506760,5,Mixed,7,9,16
506770,0,5 user reviews,4,1,5
506780,7,Positive,14,0,14
506800,5,Mixed,28,41,69
506830,0,5 user reviews,4,1,5
506840,0,7 user reviews,3,4,7
506850,0,2 user reviews,2,0,2
506870,8,Very Positive,385,39,424
506900,6,Mostly Positive,198,74,272
506910,0,4 user reviews,4,0,4
506920,0,1 user reviews,1,0,1
506930,0,9 user reviews,4,5,9
506960,0,5 user reviews,2,3,5
506970,5,Mixed,797,527,1324
506971,8,Very Positive,801,127,928
507010,6,Mostly Positive,1099,373,1472
507020,0,2 user reviews,2,0,2
507030,7,Positive,8,2,10
507050,0,9 user reviews,2,7,9
507060,0,9 user reviews,8,1,9
507070,7,Positive,29,1,30
507080,7,Positive,16,2,18
507120,5,Mixed,19,9,28
507140,0,5 user reviews,4,1,5
507210,0,3 user reviews,1,2,3
507270,0,2 user reviews,1,1,2
507300,0,3 user reviews,1,2,3
507340,0,4 user reviews,2,2,4
507360,0,4 user reviews,1,3,4
507380,5,Mixed,6,6,12
507390,5,Mixed,67,63,130
507400,0,6 user reviews,5,1,6
507440,0,5 user reviews,1,4,5
507490,8,Very Positive,1075,229,1304
507510,5,Mixed,57,64,121
507520,8,Very Positive,43,10,53
507642,0,1 user reviews,0,1,1
507740,0,4 user reviews,4,0,4
507930,0,1 user reviews,0,1,1
508000,0,1 user reviews,1,0,1
508110,0,1 user reviews,0,1,1
508140,5,Mixed,127,65,192
508150,5,Mixed,30,14,44
508160,0,2 user reviews,2,0,2
508161,7,Positive,22,0,22
508162,0,5 user reviews,5,0,5
508163,0,5 user reviews,5,0,5
508165,0,2 user reviews,2,0,2
508170,6,Mostly Positive,77,20,97
508180,6,Mostly Positive,31,13,44
508190,5,Mixed,178,95,273
508200,0,8 user reviews,3,5,8
508230,5,Mixed,24,12,36
508260,7,Positive,36,8,44
508280,0,3 user reviews,3,0,3
508290,5,Mixed,20,26,46
508300,5,Mixed,32,27,59
508330,0,1 user reviews,1,0,1
508340,5,Mixed,7,5,12
508350,0,9 user reviews,6,3,9
508390,0,9 user reviews,8,1,9
508400,5,Mixed,25,36,61
508401,5,Mixed,25,23,48
508402,6,Mostly Positive,49,15,64
508403,7,Positive,40,8,48
508405,0,1 user reviews,1,0,1
508410,5,Mixed,15,8,23
508440,9,Overwhelmingly Positive,23177,494,23671
508450,5,Mixed,104,101,205
508520,0,4 user reviews,4,0,4
508530,7,Positive,25,0,25
508540,0,5 user reviews,2,3,5
508550,6,Mostly Positive,325,107,432
508560,0,2 user reviews,1,1,2
508580,6,Mostly Positive,16,5,21
508590,0,6 user reviews,0,6,6
508600,6,Mostly Positive,192,56,248
508610,0,3 user reviews,2,1,3
508630,0,1 user reviews,0,1,1
508650,0,6 user reviews,4,2,6
508660,3,Negative,0,11,11
508680,0,2 user reviews,1,1,2
508690,0,8 user reviews,3,5,8
508710,6,Mostly Positive,12,5,17
508730,0,7 user reviews,4,3,7
508740,5,Mixed,29,23,52
508760,0,7 user reviews,5,2,7
508770,0,1 user reviews,0,1,1
508771,0,2 user reviews,1,1,2
508772,0,1 user reviews,1,0,1
508790,8,Very Positive,59,3,62
508820,5,Mixed,9,4,13
508830,0,1 user reviews,1,0,1
508840,6,Mostly Positive,49,15,64
508890,0,1 user reviews,1,0,1
508900,9,Overwhelmingly Positive,727,24,751
508910,0,6 user reviews,5,1,6
508930,0,6 user reviews,2,4,6
508940,0,6 user reviews,5,1,6
508950,0,4 user reviews,3,1,4
508980,8,Very Positive,218,37,255
508990,8,Very Positive,78,4,82
509020,0,1 user reviews,1,0,1
509030,0,1 user reviews,1,0,1
509031,0,1 user reviews,1,0,1
509050,0,1 user reviews,1,0,1
509060,0,6 user reviews,6,0,6
509070,5,Mixed,11,6,17
509110,8,Very Positive,54,7,61
509120,0,2 user reviews,1,1,2
509130,7,Positive,14,3,17
509160,7,Positive,10,1,11
509170,0,2 user reviews,2,0,2
509190,0,3 user reviews,2,1,3
509210,5,Mixed,14,8,22
509220,8,Very Positive,585,58,643
509230,0,6 user reviews,4,2,6
509250,8,Very Positive,432,61,493
509260,5,Mixed,5,6,11
509290,6,Mostly Positive,17,7,24
509310,0,2 user reviews,2,0,2
509340,0,3 user reviews,3,0,3
509350,8,Very Positive,49,2,51
509360,5,Mixed,25,11,36
509390,0,8 user reviews,4,4,8
509400,0,5 user reviews,4,1,5
509420,0,6 user reviews,1,5,6
509430,7,Positive,13,0,13
509440,3,Negative,2,10,12
509450,0,6 user reviews,3,3,6
509500,0,2 user reviews,2,0,2
509520,0,1 user reviews,1,0,1
509522,0,1 user reviews,1,0,1
509540,6,Mostly Positive,50,15,65
509570,8,Very Positive,120,12,132
509580,6,Mostly Positive,390,141,531
509590,0,3 user reviews,3,0,3
509600,5,Mixed,19,9,28
509610,4,Mostly Negative,4,11,15
509620,0,3 user reviews,3,0,3
509630,0,3 user reviews,2,1,3
509631,0,3 user reviews,1,2,3
509632,0,3 user reviews,2,1,3
509637,0,7 user reviews,7,0,7
509642,0,5 user reviews,5,0,5
509643,0,1 user reviews,1,0,1
509645,0,2 user reviews,1,1,2
509647,0,6 user reviews,4,2,6
509648,0,1 user reviews,1,0,1
509649,0,4 user reviews,4,0,4
509654,0,3 user reviews,3,0,3
509660,0,1 user reviews,1,0,1
509662,0,2 user reviews,2,0,2
509664,0,2 user reviews,2,0,2
509665,0,1 user reviews,1,0,1
509675,0,1 user reviews,1,0,1
509677,0,1 user reviews,1,0,1
509680,0,2 user reviews,2,0,2
509681,0,1 user reviews,0,1,1
509683,0,1 user reviews,1,0,1
509686,0,1 user reviews,1,0,1
509687,0,1 user reviews,1,0,1
509688,0,2 user reviews,2,0,2
509689,0,1 user reviews,1,0,1
509692,0,2 user reviews,2,0,2
509694,0,1 user reviews,1,0,1
509699,0,2 user reviews,2,0,2
509709,0,1 user reviews,1,0,1
509710,0,3 user reviews,1,2,3
509713,0,2 user reviews,1,1,2
509714,0,4 user reviews,2,2,4
509715,0,1 user reviews,1,0,1
509716,0,1 user reviews,1,0,1
509717,0,2 user reviews,1,1,2
509718,0,1 user reviews,1,0,1
509724,0,4 user reviews,3,1,4
509737,0,1 user reviews,1,0,1
509739,0,1 user reviews,1,0,1
509743,0,1 user reviews,1,0,1
509770,5,Mixed,38,17,55
509780,7,Positive,13,1,14
509820,7,Positive,10,1,11
509830,0,1 user reviews,0,1,1
509840,6,Mostly Positive,44,13,57
509850,0,9 user reviews,7,2,9
509910,0,3 user reviews,2,1,3
509920,0,4 user reviews,2,2,4
509930,0,2 user reviews,0,2,2
509960,0,7 user reviews,3,4,7
509980,6,Mostly Positive,2202,732,2934
510040,7,Positive,21,1,22
510050,7,Positive,15,1,16
510060,7,Positive,20,0,20
510070,7,Positive,9,2,11
510080,0,9 user reviews,5,4,9
510090,0,1 user reviews,1,0,1
510110,0,4 user reviews,2,2,4
510120,4,Mostly Negative,3,10,13
510140,0,1 user reviews,1,0,1
510200,0,4 user reviews,2,2,4
510240,7,Positive,13,3,16
510250,7,Positive,17,1,18
510280,0,3 user reviews,3,0,3
510290,6,Mostly Positive,23,6,29
510320,7,Positive,10,2,12
510330,0,2 user reviews,0,2,2
510360,0,8 user reviews,3,5,8
510380,0,6 user reviews,1,5,6
510390,0,9 user reviews,5,4,9
510400,0,1 user reviews,1,0,1
510410,5,Mixed,10,5,15
510420,8,Very Positive,571,32,603
510430,0,6 user reviews,6,0,6
510490,8,Very Positive,236,57,293
510500,8,Very Positive,410,79,489
510510,5,Mixed,272,232,504
510520,8,Very Positive,69,8,77
510530,0,2 user reviews,2,0,2
510540,8,Very Positive,128,6,134
510550,0,8 user reviews,4,4,8
510570,5,Mixed,21,13,34
510590,7,Positive,41,7,48
510610,0,1 user reviews,1,0,1
510620,8,Very Positive,82,7,89
510630,0,8 user reviews,6,2,8
510650,6,Mostly Positive,39,13,52
510660,7,Positive,8,2,10
510680,0,9 user reviews,9,0,9
510700,0,7 user reviews,5,2,7
510730,0,1 user reviews,0,1,1
510740,7,Positive,16,3,19
510750,0,1 user reviews,0,1,1
510780,5,Mixed,5,5,10
510790,0,2 user reviews,1,1,2
510800,0,2 user reviews,2,0,2
510830,0,8 user reviews,8,0,8
510840,0,8 user reviews,6,2,8
510850,5,Mixed,27,16,43
510910,6,Mostly Positive,31,11,42
510930,6,Mostly Positive,65,17,82
510940,0,1 user reviews,0,1,1
510960,0,2 user reviews,2,0,2
510990,0,8 user reviews,7,1,8
511010,0,9 user reviews,5,4,9
511070,0,2 user reviews,2,0,2
511090,5,Mixed,8,4,12
511120,0,3 user reviews,2,1,3
511130,0,1 user reviews,1,0,1
511140,8,Very Positive,82,9,91
511160,6,Mostly Positive,12,5,17
511170,0,2 user reviews,1,1,2
511190,5,Mixed,8,4,12
511200,0,1 user reviews,1,0,1
511230,0,3 user reviews,2,1,3
511240,0,2 user reviews,2,0,2
511250,0,7 user reviews,7,0,7
511300,0,3 user reviews,3,0,3
511301,0,1 user reviews,1,0,1
511310,3,Negative,2,13,15
511320,7,Positive,9,2,11
511330,5,Mixed,6,8,14
511340,5,Mixed,21,15,36
511350,8,Very Positive,118,4,122
511370,7,Positive,18,1,19
511380,7,Positive,15,0,15
511390,0,3 user reviews,3,0,3
511430,5,Mixed,36,19,55
511450,0,2 user reviews,2,0,2
511460,0,8 user reviews,4,4,8
511470,9,Overwhelmingly Positive,1021,26,1047
511490,0,5 user reviews,3,2,5
511500,5,Mixed,16,8,24
511540,8,Very Positive,43,10,53
511560,5,Mixed,8,5,13
511570,7,Positive,37,5,42
511600,0,8 user reviews,5,3,8
511610,0,3 user reviews,2,1,3
511630,7,Positive,35,5,40
511660,5,Mixed,7,9,16
511670,0,4 user reviews,2,2,4
511680,8,Very Positive,555,44,599
511690,0,5 user reviews,4,1,5
511700,7,Positive,10,0,10
511720,5,Mixed,14,16,30
511740,8,Very Positive,698,94,792
511750,0,6 user reviews,5,1,6
511760,0,2 user reviews,1,1,2
511790,5,Mixed,13,10,23
511800,0,4 user reviews,4,0,4
511810,0,1 user reviews,0,1,1
511820,5,Mixed,6,5,11
511830,0,6 user reviews,2,4,6
511920,0,2 user reviews,2,0,2
511940,0,8 user reviews,7,1,8
511960,0,3 user reviews,2,1,3
512000,7,Positive,14,1,15
512010,0,9 user reviews,9,0,9
512020,5,Mixed,27,12,39
512032,4,Mostly Negative,91,281,372
512033,5,Mixed,141,186,327
512034,5,Mixed,200,115,315
512035,5,Mixed,103,95,198
512060,8,Very Positive,347,19,366
512070,0,1 user reviews,1,0,1
512080,6,Mostly Positive,82,30,112
512090,0,3 user reviews,1,2,3
512100,7,Positive,14,1,15
512110,6,Mostly Positive,8,3,11
512120,7,Positive,9,2,11
512150,7,Positive,23,0,23
512160,5,Mixed,31,18,49
512170,0,2 user reviews,1,1,2
512180,8,Very Positive,266,9,275
512220,8,Very Positive,308,36,344
512230,7,Positive,22,1,23
512240,7,Positive,31,2,33
512250,8,Very Positive,2049,202,2251
512260,7,Positive,26,4,30
512300,8,Very Positive,163,25,188
512310,0,2 user reviews,2,0,2
512313,0,2 user reviews,1,1,2
512314,0,1 user reviews,1,0,1
512340,5,Mixed,16,12,28
512350,5,Mixed,24,20,44
512370,0,3 user reviews,3,0,3
512400,0,6 user reviews,1,5,6
512410,0,9 user reviews,3,6,9
512420,7,Positive,8,2,10
512430,5,Mixed,12,11,23
512460,8,Very Positive,82,5,87
512470,6,Mostly Positive,28,9,37
512490,8,Very Positive,281,5,286
512540,6,Mostly Positive,1452,533,1985
512550,0,4 user reviews,2,2,4
512560,0,2 user reviews,0,2,2
512600,7,Positive,26,5,31
512610,0,6 user reviews,4,2,6
512620,0,4 user reviews,4,0,4
512621,5,Mixed,6,4,10
512622,0,3 user reviews,3,0,3
512640,5,Mixed,7,6,13
512670,0,1 user reviews,1,0,1
512680,0,6 user reviews,6,0,6
512700,0,1 user reviews,0,1,1
512740,7,Positive,18,3,21
512750,7,Positive,11,0,11
512770,0,5 user reviews,5,0,5
512790,8,Very Positive,1155,105,1260
512830,0,7 user reviews,4,3,7
512880,0,1 user reviews,1,0,1
512890,8,Very Positive,115,4,119
512900,9,Overwhelmingly Positive,4580,147,4727
512920,0,1 user reviews,0,1,1
512940,0,9 user reviews,4,5,9
512950,0,1 user reviews,1,0,1
513000,5,Mixed,19,24,43
513010,0,3 user reviews,3,0,3
513030,5,Mixed,13,6,19
513031,5,Mixed,7,5,12
513032,4,Mostly Negative,4,14,18
513033,5,Mixed,12,9,21
513034,5,Mixed,11,5,16
513050,0,7 user reviews,2,5,7
513060,0,6 user reviews,5,1,6
513090,0,1 user reviews,1,0,1
513093,0,4 user reviews,3,1,4
513095,0,3 user reviews,1,2,3
513096,0,1 user reviews,1,0,1
513106,0,1 user reviews,1,0,1
513107,0,1 user reviews,1,0,1
513108,0,1 user reviews,1,0,1
513110,0,7 user reviews,7,0,7
513111,0,1 user reviews,0,1,1
513114,0,2 user reviews,1,1,2
513116,0,2 user reviews,2,0,2
513117,0,2 user reviews,2,0,2
513119,0,2 user reviews,2,0,2
513140,0,5 user reviews,3,2,5
513150,0,2 user reviews,1,1,2
513170,0,4 user reviews,3,1,4
513190,6,Mostly Positive,21,7,28
513210,0,2 user reviews,1,1,2
513230,4,Mostly Negative,74,121,195
513240,0,6 user reviews,3,3,6
513250,0,9 user reviews,9,0,9
513260,0,1 user reviews,1,0,1
513270,5,Mixed,11,6,17
513290,5,Mixed,108,120,228
513300,0,9 user reviews,7,2,9
513320,5,Mixed,32,47,79
513330,5,Mixed,36,54,90
513340,7,Positive,16,2,18
513360,8,Very Positive,83,11,94
513370,3,Negative,3,21,24
513420,5,Mixed,12,13,25
513430,5,Mixed,11,6,17
513450,8,Very Positive,115,16,131
513460,5,Mixed,10,8,18
513480,8,Very Positive,58,8,66
513500,7,Positive,16,4,20
513510,8,Very Positive,1384,167,1551
513520,5,Mixed,8,4,12
513550,0,3 user reviews,3,0,3
513560,5,Mixed,21,19,40
513570,2,Very Negative,9,43,52
513580,0,6 user reviews,2,4,6
513590,4,Mostly Negative,9,18,27
513600,0,2 user reviews,2,0,2
513610,0,8 user reviews,6,2,8
513620,5,Mixed,15,22,37
513650,5,Mixed,71,38,109
513680,0,7 user reviews,4,3,7
513690,5,Mixed,31,21,52
513710,5,Mixed,11188,4824,16012
513720,6,Mostly Positive,14,6,20
513730,7,Positive,40,1,41
513740,4,Mostly Negative,4,12,16
513760,0,2 user reviews,2,0,2
513770,5,Mixed,4,6,10
513780,8,Very Positive,149,34,183
513790,5,Mixed,9,5,14
513800,7,Positive,26,0,26
513810,0,7 user reviews,2,5,7
513820,0,3 user reviews,2,1,3
513840,0,5 user reviews,5,0,5
513860,6,Mostly Positive,12,5,17
513880,5,Mixed,12,6,18
513890,8,Very Positive,141,13,154
513920,0,7 user reviews,6,1,7
513930,4,Mostly Negative,6,17,23
513960,0,3 user reviews,3,0,3
513980,6,Mostly Positive,13,4,17
513990,5,Mixed,17,11,28
514010,6,Mostly Positive,14,6,20
514050,0,7 user reviews,7,0,7
514080,5,Mixed,8,6,14
514090,8,Very Positive,53,6,59
514140,5,Mixed,8,5,13
514150,5,Mixed,13,9,22
514160,7,Positive,33,0,33
514170,5,Mixed,11,6,17
514180,7,Positive,16,4,20
514190,0,4 user reviews,4,0,4
514200,0,3 user reviews,2,1,3
514220,0,2 user reviews,2,0,2
514240,5,Mixed,31,40,71
514290,5,Mixed,30,38,68
514310,8,Very Positive,271,19,290
514330,7,Positive,18,4,22
514331,0,1 user reviews,1,0,1
514332,0,1 user reviews,0,1,1
514340,7,Positive,16,1,17
514350,0,8 user reviews,6,2,8
514360,0,1 user reviews,0,1,1
514370,0,8 user reviews,6,2,8
514390,0,2 user reviews,1,1,2
514400,5,Mixed,7,5,12
514410,4,Mostly Negative,9,24,33
514450,0,6 user reviews,5,1,6
514460,4,Mostly Negative,9,14,23
514470,0,2 user reviews,2,0,2
514480,0,8 user reviews,6,2,8
514490,0,5 user reviews,2,3,5
514500,6,Mostly Positive,237,96,333
514510,0,1 user reviews,0,1,1
514520,0,3 user reviews,2,1,3
514530,0,3 user reviews,2,1,3
514540,0,2 user reviews,2,0,2
514550,0,3 user reviews,1,2,3
514570,5,Mixed,5,6,11
514580,7,Positive,35,3,38
514620,0,9 user reviews,9,0,9
514630,0,2 user reviews,0,2,2
514640,0,5 user reviews,4,1,5
514650,0,9 user reviews,8,1,9
514660,6,Mostly Positive,24,9,33
514670,5,Mixed,25,17,42
514700,6,Mostly Positive,25,8,33
514720,0,4 user reviews,3,1,4
514730,0,3 user reviews,3,0,3
514740,0,2 user reviews,2,0,2
514750,7,Positive,12,1,13
514760,0,4 user reviews,4,0,4
514770,0,2 user reviews,2,0,2
514780,0,9 user reviews,3,6,9
514800,0,2 user reviews,1,1,2
514810,6,Mostly Positive,11,4,15
514820,0,1 user reviews,0,1,1
514830,6,Mostly Positive,14,6,20
514870,0,2 user reviews,2,0,2
514890,6,Mostly Positive,27,7,34
514900,6,Mostly Positive,1376,354,1730
514920,6,Mostly Positive,198,53,251
514930,0,2 user reviews,1,1,2
514970,4,Mostly Negative,9,14,23
514990,5,Mixed,47,24,71
515000,7,Positive,10,1,11
515010,0,9 user reviews,9,0,9
515020,7,Positive,14,0,14
515040,8,Very Positive,929,125,1054
515060,0,6 user reviews,5,1,6
515090,0,7 user reviews,4,3,7
515100,0,6 user reviews,2,4,6
515110,0,4 user reviews,4,0,4
515120,0,2 user reviews,1,1,2
515130,0,8 user reviews,8,0,8
515140,0,2 user reviews,1,1,2
515150,0,3 user reviews,2,1,3
515160,0,3 user reviews,3,0,3
515170,0,5 user reviews,0,5,5
515171,0,3 user reviews,1,2,3
515180,6,Mostly Positive,871,235,1106
515190,5,Mixed,42,25,67
515191,6,Mostly Positive,301,86,387
515200,0,3 user reviews,0,3,3
515220,8,Very Positive,955,164,1119
515240,0,1 user reviews,1,0,1
515260,6,Mostly Positive,59,19,78
515270,0,9 user reviews,8,1,9
515300,4,Mostly Negative,3,8,11
515470,5,Mixed,25,31,56
515570,8,Very Positive,83,8,91
515650,8,Very Positive,85,8,93
515680,0,5 user reviews,1,4,5
515690,5,Mixed,8,12,20
515700,0,2 user reviews,1,1,2
515710,8,Very Positive,80,17,97
515740,6,Mostly Positive,7,3,10
515900,0,2 user reviews,0,2,2
515910,5,Mixed,11,9,20
515980,5,Mixed,24,19,43
516000,0,1 user reviews,1,0,1
516030,5,Mixed,9,4,13
516040,5,Mixed,8,5,13
516050,0,1 user reviews,1,0,1
516110,8,Very Positive,342,29,371
516120,0,5 user reviews,5,0,5
516130,6,Mostly Positive,89,26,115
516250,0,9 user reviews,2,7,9
516287,0,1 user reviews,1,0,1
516330,0,1 user reviews,1,0,1
516331,0,2 user reviews,1,1,2
516370,0,2 user reviews,2,0,2
516410,0,2 user reviews,2,0,2
516430,7,Positive,29,5,34
516440,0,2 user reviews,2,0,2
516450,0,9 user reviews,8,1,9
516460,0,1 user reviews,0,1,1
516470,0,6 user reviews,3,3,6
516480,8,Very Positive,180,2,182
516500,7,Positive,12,2,14
516510,0,2 user reviews,2,0,2
516520,0,4 user reviews,4,0,4
516530,0,1 user reviews,0,1,1
516550,7,Positive,9,1,10
516560,0,6 user reviews,5,1,6
516570,7,Positive,11,0,11
516580,7,Positive,16,2,18
516590,6,Mostly Positive,61,20,81
516600,7,Positive,24,1,25
516610,0,4 user reviews,2,2,4
516640,0,3 user reviews,2,1,3
516650,5,Mixed,6,4,10
516680,0,4 user reviews,0,4,4
516710,0,1 user reviews,0,1,1
516740,0,1 user reviews,1,0,1
516750,8,Very Positive,10379,965,11344
516760,7,Positive,16,0,16
516770,0,2 user reviews,2,0,2
516790,0,8 user reviews,5,3,8
516810,0,3 user reviews,3,0,3
516820,7,Positive,28,2,30
516840,7,Positive,36,2,38
516870,0,2 user reviews,1,1,2
516890,0,7 user reviews,6,1,7
516900,0,3 user reviews,3,0,3
516910,0,1 user reviews,1,0,1
516920,0,6 user reviews,5,1,6
516940,6,Mostly Positive,24,7,31
516950,0,4 user reviews,2,2,4
516960,0,3 user reviews,3,0,3
517000,8,Very Positive,52,11,63
517010,0,5 user reviews,1,4,5
517020,5,Mixed,25,16,41
517030,0,3 user reviews,3,0,3
517060,0,9 user reviews,4,5,9
517100,6,Mostly Positive,8,3,11
517110,0,4 user reviews,0,4,4
517130,8,Very Positive,334,48,382
517140,0,8 user reviews,5,3,8
517160,8,Very Positive,303,67,370
517170,7,Positive,30,6,36
517190,0,1 user reviews,1,0,1
517210,7,Positive,10,2,12
517220,6,Mostly Positive,19,6,25
517240,0,7 user reviews,3,4,7
517270,0,4 user reviews,2,2,4
517280,0,4 user reviews,3,1,4
517300,0,5 user reviews,1,4,5
517320,0,1 user reviews,1,0,1
517330,6,Mostly Positive,47,13,60
517340,0,4 user reviews,2,2,4
517350,5,Mixed,16,7,23
517360,5,Mixed,24,13,37
517370,6,Mostly Positive,81,24,105
517400,0,8 user reviews,1,7,8
517450,0,1 user reviews,1,0,1
517460,5,Mixed,6,5,11
517470,7,Positive,10,1,11
517480,0,3 user reviews,0,3,3
517500,0,3 user reviews,0,3,3
517510,0,8 user reviews,7,1,8
517560,0,1 user reviews,1,0,1
517620,0,4 user reviews,4,0,4
517630,5,Mixed,3197,2433,5630
517660,0,3 user reviews,2,1,3
517670,8,Very Positive,65,12,77
517680,0,1 user reviews,1,0,1
517710,8,Very Positive,1622,236,1858
517720,6,Mostly Positive,135,57,192
517750,0,2 user reviews,1,1,2
517752,0,1 user reviews,1,0,1
517780,6,Mostly Positive,86,25,111
517790,8,Very Positive,400,35,435
517810,6,Mostly Positive,149,59,208
517831,5,Mixed,16,16,32
517910,7,Positive,20,2,22
517930,7,Positive,17,1,18
517960,0,6 user reviews,5,1,6
517970,0,7 user reviews,6,1,7
517990,0,8 user reviews,4,4,8
518000,0,4 user reviews,4,0,4
518030,8,Very Positive,943,180,1123
518040,8,Very Positive,50,3,53
518060,6,Mostly Positive,242,88,330
518110,5,Mixed,11,10,21
518120,0,1 user reviews,1,0,1
518130,0,8 user reviews,5,3,8
518140,0,4 user reviews,2,2,4
518150,8,Very Positive,422,91,513
518190,0,3 user reviews,2,1,3
518230,0,1 user reviews,0,1,1
518250,0,1 user reviews,1,0,1
518280,7,Positive,17,1,18
518320,0,9 user reviews,5,4,9
518360,0,4 user reviews,4,0,4
518370,0,1 user reviews,1,0,1
518440,8,Very Positive,53,1,54
518450,0,4 user reviews,3,1,4
518460,0,5 user reviews,3,2,5
518480,0,8 user reviews,8,0,8
518500,0,1 user reviews,1,0,1
518520,0,1 user reviews,1,0,1
518580,8,Very Positive,75,4,79
518610,0,8 user reviews,6,2,8
518620,5,Mixed,6,5,11
518650,7,Positive,18,1,19
518660,5,Mixed,7,9,16
518670,8,Very Positive,59,8,67
518680,0,1 user reviews,1,0,1
518690,5,Mixed,14,8,22
518710,0,4 user reviews,4,0,4
518720,6,Mostly Positive,101,36,137
518730,8,Very Positive,78,7,85
518740,0,1 user reviews,1,0,1
518790,8,Very Positive,13151,2394,15545
518800,0,5 user reviews,1,4,5
518910,6,Mostly Positive,183,48,231
518920,5,Mixed,148,83,231
519020,0,3 user reviews,2,1,3
519030,5,Mixed,22,13,35
519080,6,Mostly Positive,46,12,58
519110,0,3 user reviews,3,0,3
519140,6,Mostly Positive,15,4,19
519160,5,Mixed,6,5,11
519170,0,1 user reviews,0,1,1
519180,3,Negative,2,20,22
519190,5,Mixed,1789,1224,3013
519200,0,9 user reviews,8,1,9
519240,0,2 user reviews,2,0,2
519280,0,1 user reviews,1,0,1
519300,0,2 user reviews,0,2,2
519490,0,6 user reviews,2,4,6
519540,0,4 user reviews,4,0,4
519550,0,1 user reviews,0,1,1
519560,0,3 user reviews,1,2,3
519860,9,Overwhelmingly Positive,7384,128,7512
519870,0,4 user reviews,3,1,4
519890,0,2 user reviews,1,1,2
519940,6,Mostly Positive,10,3,13
519980,5,Mixed,7,4,11
519990,0,6 user reviews,2,4,6
520010,8,Very Positive,748,56,804
520040,0,5 user reviews,3,2,5
520080,0,2 user reviews,1,1,2
520120,0,8 user reviews,5,3,8
520150,7,Positive,17,3,20
520210,4,Mostly Negative,3,7,10
520230,0,2 user reviews,2,0,2
520250,5,Mixed,13,8,21
520270,6,Mostly Positive,30,12,42
520290,7,Positive,19,4,23
520300,0,3 user reviews,3,0,3
520310,0,1 user reviews,0,1,1
520320,0,1 user reviews,1,0,1
520350,0,9 user reviews,5,4,9
520360,0,2 user reviews,2,0,2
520370,0,5 user reviews,4,1,5
520380,5,Mixed,14,12,26
520430,0,1 user reviews,1,0,1
520440,8,Very Positive,1612,85,1697
520470,6,Mostly Positive,24,8,32
520480,0,4 user reviews,4,0,4
520500,0,6 user reviews,4,2,6
520510,0,3 user reviews,2,1,3
520520,0,6 user reviews,2,4,6
520530,5,Mixed,14,20,34
520540,0,5 user reviews,5,0,5
520550,8,Very Positive,64,13,77
520600,8,Very Positive,105,17,122
520610,6,Mostly Positive,22,9,31
520620,0,2 user reviews,2,0,2
520630,0,2 user reviews,0,2,2
520640,0,1 user reviews,1,0,1
520641,0,4 user reviews,4,0,4
520642,0,2 user reviews,2,0,2
520643,0,1 user reviews,1,0,1
520644,0,1 user reviews,1,0,1
520645,0,1 user reviews,1,0,1
520646,0,1 user reviews,1,0,1
520660,5,Mixed,11,5,16
520670,7,Positive,27,6,33
520680,5,Mixed,5,7,12
520720,6,Mostly Positive,469,164,633
520750,7,Positive,11,1,12
520780,0,3 user reviews,3,0,3
520810,0,2 user reviews,0,2,2
520820,7,Positive,17,1,18
520840,5,Mixed,8,7,15
520850,7,Positive,41,3,44
520860,5,Mixed,21,13,34
520871,0,2 user reviews,1,1,2
520900,5,Mixed,6,4,10
520910,0,3 user reviews,3,0,3
520930,0,6 user reviews,5,1,6
520940,6,Mostly Positive,302,115,417
520950,5,Mixed,252,113,365
520960,6,Mostly Positive,7,3,10
520990,6,Mostly Positive,48,17,65
521000,0,5 user reviews,3,2,5
521010,0,1 user reviews,1,0,1
521090,5,Mixed,9,4,13
521100,4,Mostly Negative,7,12,19
521130,7,Positive,14,2,16
521140,0,1 user reviews,0,1,1
521150,8,Very Positive,683,148,831
521160,5,Mixed,15,9,24
521200,7,Positive,15,0,15
521210,7,Positive,10,1,11
521220,8,Very Positive,73,14,87
521230,0,7 user reviews,7,0,7
521280,7,Positive,19,2,21
521300,0,3 user reviews,3,0,3
521310,0,1 user reviews,0,1,1
521330,0,2 user reviews,2,0,2
521340,5,Mixed,43,31,74
521350,8,Very Positive,176,36,212
521420,5,Mixed,5,5,10
521430,6,Mostly Positive,8,3,11
521450,5,Mixed,11,12,23
521470,0,9 user reviews,9,0,9
521480,0,2 user reviews,1,1,2
521500,8,Very Positive,69,15,84
521510,0,3 user reviews,2,1,3
521540,7,Positive,19,4,23
521550,0,2 user reviews,1,1,2
521560,6,Mostly Positive,14,5,19
521570,0,8 user reviews,8,0,8
521580,5,Mixed,8,5,13
521590,5,Mixed,16,10,26
521600,0,6 user reviews,6,0,6
521610,0,7 user reviews,7,0,7
521620,7,Positive,9,1,10
521630,8,Very Positive,92,23,115
521650,0,3 user reviews,1,2,3
521680,0,2 user reviews,0,2,2
521690,0,2 user reviews,2,0,2
521700,0,1 user reviews,1,0,1
521720,0,4 user reviews,1,3,4
521750,0,4 user reviews,3,1,4
521760,0,6 user reviews,5,1,6
521790,5,Mixed,53,26,79
521800,7,Positive,17,1,18
521840,8,Very Positive,263,4,267
521850,0,2 user reviews,1,1,2
521860,6,Mostly Positive,18,5,23
521880,6,Mostly Positive,13,5,18
521890,6,Mostly Positive,1327,466,1793
521920,8,Very Positive,125,19,144
521950,8,Very Positive,125,28,153
521970,0,2 user reviews,0,2,2
521980,4,Mostly Negative,12,22,34
521990,0,8 user reviews,6,2,8
522000,0,5 user reviews,4,1,5
522010,0,6 user reviews,6,0,6
522020,6,Mostly Positive,71,20,91
522030,5,Mixed,52,30,82
522040,8,Very Positive,224,9,233
522050,0,5 user reviews,1,4,5
522080,0,5 user reviews,5,0,5
522090,4,Mostly Negative,4,13,17
522120,8,Very Positive,101,5,106
522130,7,Positive,18,1,19
522170,0,1 user reviews,0,1,1
522200,5,Mixed,7,9,16
522210,8,Very Positive,97,20,117
522220,0,9 user reviews,6,3,9
522240,6,Mostly Positive,42,12,54
522250,5,Mixed,16,7,23
522280,0,1 user reviews,1,0,1
522300,7,Positive,13,3,16
522331,0,2 user reviews,2,0,2
522333,0,7 user reviews,4,3,7
522334,0,7 user reviews,5,2,7
522340,7,Positive,24,1,25
522470,8,Very Positive,854,120,974
522490,8,Very Positive,54,1,55
522500,0,8 user reviews,5,3,8
522530,0,5 user reviews,2,3,5
522570,5,Mixed,28,40,68
522590,4,Mostly Negative,7,15,22
522610,0,8 user reviews,6,2,8
522650,0,2 user reviews,2,0,2
522651,0,2 user reviews,2,0,2
522652,0,2 user reviews,2,0,2
522660,0,6 user reviews,3,3,6
522690,5,Mixed,6,8,14
522700,0,7 user reviews,4,3,7
522710,7,Positive,17,0,17
522730,7,Positive,10,1,11
522740,0,9 user reviews,5,4,9
522750,0,2 user reviews,1,1,2
522880,6,Mostly Positive,36,11,47
522890,0,2 user reviews,0,2,2
522900,0,6 user reviews,6,0,6
522950,0,1 user reviews,1,0,1
522960,0,4 user reviews,1,3,4
522990,0,8 user reviews,8,0,8
523000,8,Very Positive,285,19,304
523030,7,Positive,24,2,26
523040,0,1 user reviews,1,0,1
523050,0,7 user reviews,7,0,7
523060,0,4 user reviews,2,2,4
523080,5,Mixed,17,16,33
523090,7,Positive,27,3,30
523110,5,Mixed,30,32,62
523120,5,Mixed,119,79,198
523130,5,Mixed,7,6,13
523150,7,Positive,27,4,31
523160,6,Mostly Positive,10,4,14
523170,0,1 user reviews,1,0,1
523180,5,Mixed,7,4,11
523190,0,1 user reviews,0,1,1
523210,8,Very Positive,735,110,845
523220,0,2 user reviews,1,1,2
523230,7,Positive,12,2,14
523240,0,1 user reviews,1,0,1
523340,0,1 user reviews,1,0,1
523380,0,6 user reviews,4,2,6
523410,5,Mixed,7,4,11
523440,0,5 user reviews,5,0,5
523500,5,Mixed,5,5,10
523501,0,6 user reviews,6,0,6
523502,0,5 user reviews,5,0,5
523503,0,2 user reviews,2,0,2
523504,0,4 user reviews,4,0,4
523505,0,3 user reviews,3,0,3
523506,0,4 user reviews,3,1,4
523507,0,4 user reviews,2,2,4
523508,4,Mostly Negative,5,8,13
523510,0,5 user reviews,4,1,5
523511,0,8 user reviews,5,3,8
523521,0,5 user reviews,3,2,5
523530,0,2 user reviews,1,1,2
523531,0,5 user reviews,5,0,5
523532,0,6 user reviews,5,1,6
523533,0,4 user reviews,3,1,4
523534,0,1 user reviews,1,0,1
523550,0,3 user reviews,2,1,3
523560,0,3 user reviews,1,2,3
523600,6,Mostly Positive,116,32,148
523610,4,Mostly Negative,7,13,20
523640,4,Mostly Negative,32,49,81
523650,6,Mostly Positive,482,205,687
523660,8,Very Positive,772,69,841
523670,0,2 user reviews,2,0,2
523680,0,6 user reviews,6,0,6
523690,0,1 user reviews,1,0,1
523710,5,Mixed,98,47,145
523720,0,9 user reviews,9,0,9
523730,5,Mixed,9,6,15
523740,0,2 user reviews,2,0,2
523760,7,Positive,16,2,18
523780,8,Very Positive,2449,148,2597
523810,5,Mixed,26,13,39
523840,0,2 user reviews,2,0,2
523850,0,1 user reviews,0,1,1
523851,0,1 user reviews,0,1,1
523852,0,1 user reviews,0,1,1
523870,0,5 user reviews,5,0,5
523880,0,1 user reviews,0,1,1
523890,0,2 user reviews,2,0,2
523900,0,3 user reviews,3,0,3
523940,5,Mixed,7,5,12
523970,0,5 user reviews,4,1,5
523980,0,2 user reviews,2,0,2
524010,5,Mixed,114,76,190
524020,0,1 user reviews,0,1,1
524030,0,1 user reviews,0,1,1
524040,0,1 user reviews,1,0,1
524043,0,1 user reviews,1,0,1
524050,0,9 user reviews,8,1,9
524060,0,8 user reviews,5,3,8
524120,7,Positive,25,5,30
524176,0,1 user reviews,1,0,1
524200,6,Mostly Positive,10,4,14
524220,8,Very Positive,21048,2571,23619
524240,0,4 user reviews,2,2,4
524250,8,Very Positive,47,3,50
524260,7,Positive,20,2,22
524270,7,Positive,21,2,23
524280,5,Mixed,6,7,13
524290,6,Mostly Positive,8,3,11
524300,0,7 user reviews,5,2,7
524310,6,Mostly Positive,11,3,14
524320,7,Positive,8,2,10
524330,8,Very Positive,77,12,89
524350,0,1 user reviews,1,0,1
524360,0,7 user reviews,7,0,7
524380,5,Mixed,49,60,109
524390,5,Mixed,33,22,55
524420,0,4 user reviews,1,3,4
524430,7,Positive,13,3,16
524490,7,Positive,18,2,20
524520,8,Very Positive,46,11,57
524540,7,Positive,31,6,37
524560,7,Positive,31,5,36
524580,8,Very Positive,403,85,488
524590,0,2 user reviews,2,0,2
524591,0,1 user reviews,0,1,1
524592,0,1 user reviews,0,1,1
524593,0,2 user reviews,1,1,2
524594,0,3 user reviews,2,1,3
524595,0,1 user reviews,0,1,1
524596,0,1 user reviews,0,1,1
524600,7,Positive,32,8,40
524610,0,4 user reviews,0,4,4
524640,8,Very Positive,112,20,132
524650,0,9 user reviews,8,1,9
524660,5,Mixed,11,8,19
524690,7,Positive,17,1,18
524850,8,Very Positive,350,39,389
524910,8,Very Positive,167,18,185
524920,7,Positive,14,0,14
524940,0,3 user reviews,1,2,3
524970,5,Mixed,11,5,16
525000,7,Positive,20,4,24
525011,5,Mixed,15,17,32
525012,0,5 user reviews,2,3,5
525014,0,1 user reviews,1,0,1
525015,0,1 user reviews,1,0,1
525016,0,1 user reviews,1,0,1
525017,0,2 user reviews,2,0,2
525019,0,4 user reviews,4,0,4
525030,5,Mixed,27,13,40
525031,5,Mixed,20,19,39
525032,0,1 user reviews,1,0,1
525034,0,1 user reviews,1,0,1
525036,0,1 user reviews,1,0,1
525037,0,4 user reviews,4,0,4
525040,8,Very Positive,139,17,156
525050,0,8 user reviews,8,0,8
525080,5,Mixed,8,8,16
525100,0,1 user reviews,0,1,1
525150,7,Positive,12,2,14
525190,0,4 user reviews,3,1,4
525210,6,Mostly Positive,12,5,17
525240,5,Mixed,45,39,84
525280,0,9 user reviews,4,5,9
525281,0,3 user reviews,1,2,3
525282,0,5 user reviews,3,2,5
525283,0,4 user reviews,4,0,4
525284,0,5 user reviews,5,0,5
525290,6,Mostly Positive,14,4,18
525300,5,Mixed,6,4,10
525350,5,Mixed,6,8,14
525360,5,Mixed,13,6,19
525370,0,1 user reviews,0,1,1
525380,5,Mixed,87,45,132
525420,5,Mixed,6,8,14
525430,7,Positive,12,1,13
525440,0,2 user reviews,1,1,2
525442,0,2 user reviews,1,1,2
525450,7,Positive,17,0,17
525470,0,3 user reviews,3,0,3
525480,8,Very Positive,1076,161,1237
525500,6,Mostly Positive,13,4,17
525510,8,Very Positive,475,23,498
525520,0,8 user reviews,4,4,8
525530,4,Mostly Negative,2,8,10
525550,0,6 user reviews,5,1,6
525590,0,1 user reviews,0,1,1
525600,0,5 user reviews,2,3,5
525610,5,Mixed,69,52,121
525620,8,Very Positive,219,27,246
525640,8,Very Positive,363,47,410
525660,0,7 user reviews,2,5,7
525680,8,Very Positive,230,23,253
525690,7,Positive,28,2,30
525700,5,Mixed,192,149,341
525720,8,Very Positive,152,17,169
525740,7,Positive,10,2,12
525760,0,5 user reviews,5,0,5
525780,0,6 user reviews,5,1,6
525870,0,2 user reviews,2,0,2
525910,7,Positive,13,1,14
525920,5,Mixed,47,33,80
525950,7,Positive,9,2,11
525970,0,4 user reviews,4,0,4
525971,0,2 user reviews,2,0,2
526030,0,1 user reviews,0,1,1
526040,6,Mostly Positive,14,5,19
526060,8,Very Positive,74,5,79
526090,0,2 user reviews,1,1,2
526121,0,1 user reviews,1,0,1
526130,7,Positive,14,2,16
526140,8,Very Positive,243,42,285
526160,6,Mostly Positive,947,343,1290
526220,0,3 user reviews,3,0,3
526221,0,1 user reviews,1,0,1
526222,0,1 user reviews,1,0,1
526227,0,1 user reviews,1,0,1
526228,0,1 user reviews,1,0,1
526240,6,Mostly Positive,29,8,37
526290,0,4 user reviews,0,4,4
526300,0,2 user reviews,1,1,2
526301,0,4 user reviews,3,1,4
526310,5,Mixed,6,4,10
526370,6,Mostly Positive,106,36,142
526410,0,6 user reviews,5,1,6
526411,0,5 user reviews,5,0,5
526440,0,4 user reviews,3,1,4
526450,0,4 user reviews,0,4,4
526490,8,Very Positive,128,3,131
526510,7,Positive,17,2,19
526530,0,3 user reviews,1,2,3
526531,0,8 user reviews,0,8,8
526532,0,2 user reviews,0,2,2
526540,5,Mixed,18,12,30
526550,0,5 user reviews,3,2,5
526561,0,1 user reviews,1,0,1
526571,0,1 user reviews,1,0,1
526590,5,Mixed,10,7,17
526600,5,Mixed,10,7,17
526640,0,1 user reviews,1,0,1
526680,0,2 user reviews,2,0,2
526740,4,Mostly Negative,121,195,316
526750,4,Mostly Negative,9,19,28
526780,0,9 user reviews,9,0,9
526800,0,9 user reviews,8,1,9
526840,0,1 user reviews,0,1,1
526860,0,1 user reviews,1,0,1
526870,9,Overwhelmingly Positive,13586,388,13974
526880,0,5 user reviews,2,3,5
526890,0,9 user reviews,9,0,9
526910,0,3 user reviews,3,0,3
526920,0,5 user reviews,3,2,5
526960,0,5 user reviews,0,5,5
526980,0,5 user reviews,3,2,5
527000,0,5 user reviews,5,0,5
527010,0,1 user reviews,1,0,1
527020,0,1 user reviews,1,0,1
527021,0,8 user reviews,8,0,8
527022,0,2 user reviews,2,0,2
527040,0,2 user reviews,0,2,2
527070,8,Very Positive,305,38,343
527100,6,Mostly Positive,1142,311,1453
527110,0,7 user reviews,6,1,7
527150,8,Very Positive,51,4,55
527160,5,Mixed,80,53,133
527170,0,1 user reviews,1,0,1
527180,0,9 user reviews,7,2,9
527190,8,Very Positive,91,3,94
527200,0,4 user reviews,4,0,4
527201,0,1 user reviews,1,0,1
527202,0,1 user reviews,1,0,1
527203,0,2 user reviews,2,0,2
527204,0,1 user reviews,0,1,1
527205,0,2 user reviews,2,0,2
527210,0,3 user reviews,2,1,3
527230,8,Very Positive,3863,520,4383
527240,5,Mixed,18,17,35
527250,0,9 user reviews,7,2,9
527260,0,5 user reviews,4,1,5
527270,8,Very Positive,517,61,578
527280,5,Mixed,112,56,168
527290,8,Very Positive,125,19,144
527300,0,1 user reviews,1,0,1
527310,7,Positive,10,2,12
527320,0,9 user reviews,7,2,9
527330,0,4 user reviews,2,2,4
527340,8,Very Positive,281,68,349
527350,5,Mixed,11,5,16
527360,0,1 user reviews,0,1,1
527370,0,1 user reviews,1,0,1
527380,7,Positive,11,1,12
527420,6,Mostly Positive,29,9,38
527430,6,Mostly Positive,3523,1300,4823
527440,7,Positive,28,4,32
527450,6,Mostly Positive,281,120,401
527470,6,Mostly Positive,34,9,43
527510,3,Negative,4,18,22
527520,0,4 user reviews,1,3,4
527530,0,1 user reviews,0,1,1
527580,6,Mostly Positive,13,4,17
527610,6,Mostly Positive,19,6,25
527620,0,8 user reviews,8,0,8
527640,0,1 user reviews,1,0,1
527641,0,1 user reviews,1,0,1
527700,8,Very Positive,184,24,208
527710,8,Very Positive,82,20,102
527720,7,Positive,23,2,25
527730,0,9 user reviews,5,4,9
527740,7,Positive,28,7,35
527750,5,Mixed,12,18,30
527760,5,Mixed,14,12,26
527770,5,Mixed,4,6,10
527790,0,2 user reviews,0,2,2
527800,0,3 user reviews,1,2,3
527810,0,6 user reviews,5,1,6
527820,7,Positive,18,0,18
527880,0,4 user reviews,2,2,4
527890,0,4 user reviews,3,1,4
527900,5,Mixed,6,4,10
527910,0,6 user reviews,5,1,6
527920,0,9 user reviews,8,1,9
527930,0,3 user reviews,1,2,3
527940,0,3 user reviews,3,0,3
527950,5,Mixed,4,6,10
527960,0,3 user reviews,3,0,3
527990,5,Mixed,56,25,81
528010,5,Mixed,11,11,22
528020,0,4 user reviews,3,1,4
528050,7,Positive,12,0,12
528051,7,Positive,11,1,12
528052,0,4 user reviews,4,0,4
528053,0,8 user reviews,8,0,8
528055,7,Positive,18,1,19
528056,7,Positive,17,0,17
528057,7,Positive,18,1,19
528058,0,4 user reviews,3,1,4
528070,6,Mostly Positive,9,3,12
528110,7,Positive,14,0,14
528120,7,Positive,31,3,34
528160,5,Mixed,72,31,103
528180,5,Mixed,9,13,22
528190,0,4 user reviews,2,2,4
528200,8,Very Positive,465,110,575
528230,9,Overwhelmingly Positive,3384,109,3493
528250,6,Mostly Positive,29,8,37
528260,6,Mostly Positive,34,11,45
528270,7,Positive,25,3,28
528290,0,1 user reviews,1,0,1
528300,5,Mixed,32,14,46
528310,0,3 user reviews,1,2,3
528330,6,Mostly Positive,11,3,14
528420,0,2 user reviews,2,0,2
528430,6,Mostly Positive,20,8,28
528450,0,2 user reviews,1,1,2
528460,5,Mixed,66,34,100
528480,0,1 user reviews,1,0,1
528490,0,1 user reviews,1,0,1
528510,6,Mostly Positive,35,15,50
528550,6,Mostly Positive,349,104,453
528580,0,1 user reviews,1,0,1
528590,7,Positive,14,1,15
528610,6,Mostly Positive,166,71,237
528620,5,Mixed,16,8,24
528640,5,Mixed,31,37,68
528660,6,Mostly Positive,79,22,101
528670,0,3 user reviews,3,0,3
528700,0,7 user reviews,7,0,7
528720,7,Positive,27,2,29
528730,6,Mostly Positive,44,17,61
528740,4,Mostly Negative,6,12,18
528770,0,2 user reviews,2,0,2
528790,0,1 user reviews,0,1,1
528810,0,1 user reviews,1,0,1
528820,5,Mixed,18,17,35
528860,0,9 user reviews,9,0,9
528900,0,6 user reviews,2,4,6
528910,0,5 user reviews,2,3,5
528930,0,3 user reviews,1,2,3
528950,0,3 user reviews,3,0,3
528960,7,Positive,16,2,18
528970,0,7 user reviews,2,5,7
528980,5,Mixed,7,4,11
528990,0,8 user reviews,8,0,8
529010,0,4 user reviews,1,3,4
529020,7,Positive,33,5,38
529040,0,7 user reviews,6,1,7
529050,7,Positive,16,0,16
529060,4,Mostly Negative,32,58,90
529090,0,2 user reviews,1,1,2
529100,7,Positive,30,1,31
529110,5,Mixed,53,26,79
529130,5,Mixed,30,17,47
529140,0,3 user reviews,3,0,3
529150,7,Positive,27,0,27
529160,8,Very Positive,87,13,100
529170,0,1 user reviews,0,1,1
529180,5,Mixed,2395,1856,4251
529240,5,Mixed,31,42,73
529260,0,2 user reviews,1,1,2
529280,0,7 user reviews,4,3,7
529350,0,6 user reviews,4,2,6
529360,6,Mostly Positive,22,6,28
529390,8,Very Positive,93,7,100
529410,7,Positive,28,7,35
529420,0,2 user reviews,2,0,2
529430,0,1 user reviews,1,0,1
529440,8,Very Positive,281,31,312
529450,6,Mostly Positive,18,6,24
529470,0,1 user reviews,1,0,1
529490,5,Mixed,56,26,82
529500,5,Mixed,20,10,30
529520,8,Very Positive,358,21,379
529580,0,2 user reviews,1,1,2
529590,8,Very Positive,182,42,224
529610,0,3 user reviews,3,0,3
529620,7,Positive,30,6,36
529630,5,Mixed,8,5,13
529660,8,Very Positive,254,34,288
529670,0,3 user reviews,2,1,3
529690,7,Positive,10,0,10
529700,7,Positive,45,4,49
529720,0,7 user reviews,4,3,7
529730,0,2 user reviews,2,0,2
529750,0,1 user reviews,1,0,1
529760,5,Mixed,6,8,14
529770,0,5 user reviews,4,1,5
529780,7,Positive,20,4,24
529790,0,9 user reviews,7,2,9
529820,5,Mixed,5,6,11
529830,5,Mixed,33,17,50
529860,0,7 user reviews,4,3,7
529870,0,6 user reviews,4,2,6
529890,6,Mostly Positive,42,12,54
529900,8,Very Positive,60,15,75
529910,5,Mixed,54,66,120
529920,0,4 user reviews,1,3,4
529930,6,Mostly Positive,51,17,68
529940,0,3 user reviews,2,1,3
529950,8,Very Positive,85,11,96
529970,7,Positive,21,3,24
530010,0,1 user reviews,1,0,1
530020,6,Mostly Positive,42,16,58
530040,5,Mixed,44,39,83
530060,5,Mixed,24,35,59
530070,6,Mostly Positive,1736,710,2446
530080,0,5 user reviews,1,4,5
530110,5,Mixed,9,6,15
530120,8,Very Positive,323,13,336
530130,0,8 user reviews,7,1,8
530140,0,4 user reviews,4,0,4
530152,0,1 user reviews,1,0,1
530160,6,Mostly Positive,29,11,40
530170,0,1 user reviews,0,1,1
530180,0,2 user reviews,2,0,2
530240,4,Mostly Negative,5,10,15
530290,0,3 user reviews,3,0,3
530300,0,3 user reviews,3,0,3
530310,0,2 user reviews,2,0,2
530320,9,Overwhelmingly Positive,767,19,786
530330,6,Mostly Positive,36,15,51
530350,8,Very Positive,263,19,282
530360,7,Positive,19,1,20
530370,7,Positive,11,1,12
530390,8,Very Positive,347,16,363
530400,0,1 user reviews,1,0,1
530480,0,1 user reviews,1,0,1
530490,0,1 user reviews,1,0,1
530500,0,2 user reviews,0,2,2
530510,7,Positive,13,3,16
530520,5,Mixed,7,6,13
530530,0,1 user reviews,0,1,1
530540,4,Mostly Negative,4,8,12
530550,0,7 user reviews,6,1,7
530560,4,Mostly Negative,54,143,197
530580,6,Mostly Positive,21,8,29
530595,0,5 user reviews,4,1,5
530596,0,6 user reviews,6,0,6
530597,0,5 user reviews,5,0,5
530598,0,4 user reviews,4,0,4
530599,0,6 user reviews,3,3,6
530610,5,Mixed,38,18,56
530611,8,Very Positive,162,28,190
530620,8,Very Positive,164,28,192
530630,5,Mixed,96,65,161
530640,0,2 user reviews,2,0,2
530641,0,1 user reviews,1,0,1
530650,0,4 user reviews,2,2,4
530660,0,9 user reviews,9,0,9
530661,0,3 user reviews,3,0,3
530690,0,7 user reviews,6,1,7
530700,5,Mixed,7,4,11
530710,8,Very Positive,286,41,327
530711,8,Very Positive,776,92,868
530720,0,3 user reviews,2,1,3
530760,5,Mixed,318,388,706
530780,5,Mixed,163,108,271
530820,0,3 user reviews,1,2,3
530830,0,9 user reviews,7,2,9
530860,0,4 user reviews,1,3,4
530890,8,Very Positive,1176,209,1385
530920,6,Mostly Positive,96,27,123
530930,5,Mixed,15,12,27
530940,0,1 user reviews,1,0,1
530950,5,Mixed,79,37,116
530960,5,Mixed,51,31,82
531050,5,Mixed,75,40,115
531080,0,7 user reviews,6,1,7
531110,7,Positive,10,2,12
531130,8,Very Positive,300,24,324
531131,8,Very Positive,315,27,342
531140,6,Mostly Positive,19,7,26
531150,0,5 user reviews,5,0,5
531151,0,5 user reviews,5,0,5
531152,0,2 user reviews,2,0,2
531153,0,1 user reviews,1,0,1
531155,0,1 user reviews,1,0,1
531156,0,2 user reviews,2,0,2
531157,0,2 user reviews,2,0,2
531158,0,1 user reviews,1,0,1
531160,0,4 user reviews,4,0,4
531161,0,2 user reviews,2,0,2
531163,0,4 user reviews,4,0,4
531165,0,3 user reviews,2,1,3
531166,0,4 user reviews,4,0,4
531169,0,1 user reviews,1,0,1
531170,0,1 user reviews,1,0,1
531180,8,Very Positive,48,10,58
531190,0,1 user reviews,1,0,1
531200,0,2 user reviews,1,1,2
531240,0,3 user reviews,2,1,3
531270,6,Mostly Positive,182,78,260
531480,0,5 user reviews,3,2,5
531500,0,1 user reviews,0,1,1
531510,9,Overwhelmingly Positive,4059,89,4148
531520,0,3 user reviews,1,2,3
531530,7,Positive,41,8,49
531540,0,3 user reviews,1,2,3
531590,0,1 user reviews,1,0,1
531640,8,Very Positive,118,28,146
531660,6,Mostly Positive,114,30,144
531680,8,Very Positive,134,33,167
531730,7,Positive,33,1,34
531740,6,Mostly Positive,26,11,37
531770,0,5 user reviews,5,0,5
531780,5,Mixed,9,5,14
531800,5,Mixed,8,4,12
531860,0,1 user reviews,0,1,1
531890,0,3 user reviews,2,1,3
531910,7,Positive,19,1,20
531920,0,3 user reviews,2,1,3
531930,6,Mostly Positive,210,56,266
531960,5,Mixed,10,5,15
531980,5,Mixed,17,10,27
532021,7,Positive,39,1,40
532030,4,Mostly Negative,19,32,51
532070,0,1 user reviews,1,0,1
532080,0,2 user reviews,1,1,2
532090,0,8 user reviews,7,1,8
532110,9,Overwhelmingly Positive,725,34,759
532120,7,Positive,8,2,10
532170,7,Positive,41,6,47
532190,8,Very Positive,386,31,417
532210,8,Very Positive,4617,1120,5737
532240,0,2 user reviews,1,1,2
532260,4,Mostly Negative,4,9,13
532270,8,Very Positive,92,18,110
532290,7,Positive,21,5,26
532320,8,Very Positive,85,9,94
532470,0,7 user reviews,6,1,7
532540,0,1 user reviews,1,0,1
532600,0,1 user reviews,0,1,1
532620,0,3 user reviews,3,0,3
532621,0,2 user reviews,2,0,2
532660,0,8 user reviews,4,4,8
532670,0,3 user reviews,1,2,3
532690,5,Mixed,7,5,12
532700,0,4 user reviews,3,1,4
532720,7,Positive,10,0,10
532730,0,1 user reviews,1,0,1
532750,6,Mostly Positive,29,8,37
532770,0,5 user reviews,5,0,5
532800,0,3 user reviews,3,0,3
532820,5,Mixed,5,5,10
532840,6,Mostly Positive,153,60,213
532850,0,1 user reviews,1,0,1
532890,0,8 user reviews,5,3,8
532900,0,3 user reviews,3,0,3
532920,5,Mixed,49,24,73
532940,0,1 user reviews,1,0,1
532950,3,Negative,3,13,16
532980,7,Positive,26,0,26
533010,5,Mixed,15,12,27
533030,0,4 user reviews,1,3,4
533040,0,9 user reviews,8,1,9
533050,6,Mostly Positive,8,3,11
533060,0,6 user reviews,5,1,6
533070,0,4 user reviews,4,0,4
533080,0,4 user reviews,2,2,4
533090,0,6 user reviews,4,2,6
533110,5,Mixed,103,52,155
533170,4,Mostly Negative,21,46,67
533180,3,Negative,1,14,15
533240,0,1 user reviews,1,0,1
533260,6,Mostly Positive,10,4,14
533300,8,Very Positive,1595,145,1740
533330,5,Mixed,14,16,30
533340,4,Mostly Negative,5,20,25
533470,0,1 user reviews,0,1,1
533480,5,Mixed,128,56,184
533520,0,1 user reviews,1,0,1
533530,0,1 user reviews,1,0,1
533552,0,1 user reviews,1,0,1
533556,0,1 user reviews,1,0,1
533557,0,6 user reviews,3,3,6
533558,0,3 user reviews,2,1,3
533560,0,2 user reviews,2,0,2
533570,0,2 user reviews,1,1,2
533580,7,Positive,13,0,13
533601,0,3 user reviews,1,2,3
533602,0,7 user reviews,2,5,7
533630,0,1 user reviews,1,0,1
533670,0,1 user reviews,1,0,1
533690,6,Mostly Positive,11,3,14
533770,0,7 user reviews,5,2,7
533780,7,Positive,20,4,24
533810,0,5 user reviews,5,0,5
533820,5,Mixed,9,4,13
533850,6,Mostly Positive,31,9,40
533860,0,9 user reviews,5,4,9
533870,0,1 user reviews,1,0,1
533880,0,1 user reviews,1,0,1
533890,0,4 user reviews,3,1,4
533920,0,3 user reviews,0,3,3
533950,6,Mostly Positive,33,11,44
533960,0,2 user reviews,2,0,2
534000,8,Very Positive,45,10,55
534010,0,7 user reviews,3,4,7
534110,0,4 user reviews,4,0,4
534140,0,3 user reviews,3,0,3
534160,7,Positive,15,2,17
534190,0,7 user reviews,6,1,7
534200,0,4 user reviews,2,2,4
534210,0,4 user reviews,2,2,4
534230,8,Very Positive,67,15,82
534260,0,1 user reviews,1,0,1
534270,0,5 user reviews,4,1,5
534290,8,Very Positive,82,4,86
534320,0,6 user reviews,1,5,6
534330,7,Positive,26,3,29
534331,6,Mostly Positive,406,169,575
534350,0,5 user reviews,2,3,5
534360,5,Mixed,16,11,27
534370,5,Mixed,152,77,229
534430,0,6 user reviews,4,2,6
534440,7,Positive,16,2,18
534480,5,Mixed,12,17,29
534550,8,Very Positive,660,56,716
534570,5,Mixed,18,10,28
534600,0,1 user reviews,1,0,1
534640,0,2 user reviews,2,0,2
534650,0,1 user reviews,1,0,1
534680,7,Positive,12,1,13
534720,7,Positive,31,4,35
534740,0,4 user reviews,1,3,4
534750,6,Mostly Positive,12,4,16
534780,0,6 user reviews,6,0,6
534820,4,Mostly Negative,26,40,66
534840,7,Positive,29,3,32
534870,0,8 user reviews,6,2,8
534880,0,6 user reviews,5,1,6
534910,5,Mixed,8,9,17
534920,0,4 user reviews,3,1,4
534980,0,9 user reviews,6,3,9
534990,7,Positive,30,5,35
535000,0,7 user reviews,7,0,7
535010,0,4 user reviews,3,1,4
535130,0,1 user reviews,0,1,1
535150,6,Mostly Positive,32,10,42
535170,0,1 user reviews,0,1,1
535190,7,Positive,13,1,14
535200,0,4 user reviews,4,0,4
535201,0,1 user reviews,1,0,1
535202,0,3 user reviews,2,1,3
535230,8,Very Positive,3499,450,3949
535240,0,1 user reviews,1,0,1
535260,0,6 user reviews,4,2,6
535270,0,2 user reviews,1,1,2
535280,7,Positive,22,1,23
535310,0,1 user reviews,1,0,1
535330,7,Positive,17,1,18
535350,0,6 user reviews,3,3,6
535370,0,1 user reviews,0,1,1
535380,7,Positive,17,1,18
535410,7,Positive,18,2,20
535460,7,Positive,42,3,45
535480,8,Very Positive,1189,244,1433
535490,5,Mixed,25,34,59
535510,0,2 user reviews,2,0,2
535520,6,Mostly Positive,324,91,415
535530,0,4 user reviews,2,2,4
535630,0,7 user reviews,6,1,7
535650,7,Positive,14,1,15
535680,0,2 user reviews,2,0,2
535690,0,4 user reviews,3,1,4
535700,5,Mixed,9,11,20
535720,0,1 user reviews,1,0,1
535750,0,2 user reviews,1,1,2
535760,0,6 user reviews,5,1,6
535820,5,Mixed,11,9,20
535840,0,7 user reviews,7,0,7
535850,4,Mostly Negative,23,85,108
535890,0,9 user reviews,7,2,9
535910,7,Positive,18,0,18
535930,8,Very Positive,7244,559,7803
535950,0,1 user reviews,1,0,1
535970,0,2 user reviews,2,0,2
535971,0,1 user reviews,1,0,1
535980,7,Positive,25,4,29
536010,0,1 user reviews,0,1,1
536040,5,Mixed,23,27,50
536210,0,1 user reviews,0,1,1
536220,6,Mostly Positive,2888,1116,4004
536230,0,2 user reviews,2,0,2
536270,6,Mostly Positive,709,205,914
536280,5,Mixed,62,40,102
536320,4,Mostly Negative,8,17,25
536340,4,Mostly Negative,5,8,13
536370,0,4 user reviews,3,1,4
536410,0,7 user reviews,2,5,7
536420,5,Mixed,19,9,28
536430,7,Positive,10,2,12
536450,5,Mixed,13,9,22
536470,0,9 user reviews,8,1,9
536490,0,6 user reviews,3,3,6
536510,0,9 user reviews,4,5,9
536520,0,5 user reviews,3,2,5
536530,5,Mixed,9,6,15
536540,5,Mixed,7,8,15
536541,0,1 user reviews,1,0,1
536543,0,7 user reviews,6,1,7
536544,0,2 user reviews,1,1,2
536545,4,Mostly Negative,3,8,11
536546,0,1 user reviews,0,1,1
536549,0,2 user reviews,0,2,2
536560,8,Very Positive,48,7,55
536570,0,4 user reviews,1,3,4
536573,0,9 user reviews,3,6,9
536574,0,3 user reviews,2,1,3
536575,0,7 user reviews,2,5,7
536576,4,Mostly Negative,7,14,21
536577,0,2 user reviews,2,0,2
536578,0,3 user reviews,2,1,3
536579,0,1 user reviews,1,0,1
536590,0,4 user reviews,4,0,4
536610,6,Mostly Positive,18,5,23
536630,4,Mostly Negative,3,7,10
536640,4,Mostly Negative,15,25,40
536660,5,Mixed,29,39,68
536670,0,2 user reviews,2,0,2
536680,5,Mixed,7,8,15
536690,6,Mostly Positive,18,5,23
536730,0,2 user reviews,1,1,2
536741,0,2 user reviews,2,0,2
536750,5,Mixed,9,4,13
536760,0,1 user reviews,1,0,1
536770,7,Positive,24,0,24
536780,6,Mostly Positive,38,12,50
536890,8,Very Positive,199,31,230
536900,0,7 user reviews,7,0,7
536920,0,1 user reviews,1,0,1
536960,5,Mixed,10,5,15
536990,8,Very Positive,42,9,51
537000,6,Mostly Positive,37,12,49
537020,0,3 user reviews,3,0,3
537050,0,5 user reviews,5,0,5
537080,0,3 user reviews,2,1,3
537090,0,7 user reviews,4,3,7
537100,6,Mostly Positive,54,14,68
537110,8,Very Positive,607,32,639
537120,0,2 user reviews,2,0,2
537140,7,Positive,17,2,19
537170,0,1 user reviews,0,1,1
537180,5,Mixed,52,47,99
537200,0,1 user reviews,0,1,1
537230,0,2 user reviews,2,0,2
537280,5,Mixed,4,6,10
537330,7,Positive,24,0,24
537340,6,Mostly Positive,389,139,528
537360,5,Mixed,6,6,12
537380,0,1 user reviews,1,0,1
537410,0,2 user reviews,1,1,2
537430,5,Mixed,44,56,100
537450,5,Mixed,117,69,186
537520,5,Mixed,22,21,43
537580,0,1 user reviews,1,0,1
537630,8,Very Positive,65,14,79
537660,0,8 user reviews,4,4,8
537670,0,3 user reviews,3,0,3
537700,0,9 user reviews,5,4,9
537740,5,Mixed,10,7,17
537750,0,2 user reviews,1,1,2
537760,0,5 user reviews,5,0,5
537770,0,5 user reviews,4,1,5
537780,0,8 user reviews,8,0,8
537790,0,4 user reviews,2,2,4
537800,8,Very Positive,3362,462,3824
537910,0,3 user reviews,2,1,3
537920,0,3 user reviews,2,1,3
537940,0,1 user reviews,0,1,1
537990,6,Mostly Positive,34,13,47
538000,6,Mostly Positive,8,3,11
538020,5,Mixed,102,96,198
538021,5,Mixed,11,6,17
538040,0,2 user reviews,2,0,2
538050,0,5 user reviews,2,3,5
538060,5,Mixed,14,9,23
538070,8,Very Positive,257,27,284
538080,0,4 user reviews,2,2,4
538090,0,2 user reviews,2,0,2
538100,8,Very Positive,861,119,980
538130,0,2 user reviews,2,0,2
538140,0,6 user reviews,6,0,6
538150,0,3 user reviews,3,0,3
538170,0,3 user reviews,2,1,3
538190,7,Positive,14,3,17
538200,0,1 user reviews,1,0,1
538220,0,8 user reviews,8,0,8
538290,0,1 user reviews,1,0,1
538300,0,1 user reviews,1,0,1
538310,0,2 user reviews,2,0,2
538330,7,Positive,12,3,15
538350,0,1 user reviews,0,1,1
538390,0,1 user reviews,1,0,1
538410,0,3 user reviews,2,1,3
538430,0,1 user reviews,1,0,1
538460,0,2 user reviews,2,0,2
538470,0,3 user reviews,0,3,3
538490,0,2 user reviews,1,1,2
538500,0,1 user reviews,1,0,1
538510,0,4 user reviews,1,3,4
538550,7,Positive,19,4,23
538560,3,Negative,0,12,12
538570,0,1 user reviews,1,0,1
538590,4,Mostly Negative,6,10,16
538600,0,2 user reviews,2,0,2
538610,0,2 user reviews,2,0,2
538680,9,Overwhelmingly Positive,1858,89,1947
538710,7,Positive,28,3,31
538720,0,4 user reviews,4,0,4
538760,6,Mostly Positive,22,8,30
538790,5,Mixed,8,7,15
538810,5,Mixed,134,83,217
538840,5,Mixed,55,25,80
538870,5,Mixed,88,55,143
538880,0,1 user reviews,1,0,1
538900,0,2 user reviews,2,0,2
538910,0,6 user reviews,6,0,6
538920,4,Mostly Negative,5,13,18
538930,0,1 user reviews,1,0,1
538990,5,Mixed,28,18,46
539010,0,4 user reviews,2,2,4
539040,0,2 user reviews,2,0,2
539050,5,Mixed,22,18,40
539090,6,Mostly Positive,9,3,12
539190,0,1 user reviews,1,0,1
539240,0,1 user reviews,1,0,1
539250,0,4 user reviews,4,0,4
539260,0,3 user reviews,3,0,3
539270,6,Mostly Positive,46,12,58
539280,5,Mixed,9,8,17
539290,4,Mostly Negative,6,11,17
539300,4,Mostly Negative,7,15,22
539330,8,Very Positive,67,15,82
539340,7,Positive,31,6,37
539370,0,2 user reviews,2,0,2
539380,5,Mixed,18,8,26
539400,8,Very Positive,50,10,60
539440,5,Mixed,23,27,50
539450,7,Positive,8,2,10
539460,0,4 user reviews,3,1,4
539470,8,Very Positive,792,158,950
539560,0,5 user reviews,3,2,5
539591,0,1 user reviews,0,1,1
539595,0,2 user reviews,1,1,2
539640,0,9 user reviews,3,6,9
539650,5,Mixed,22,10,32
539660,7,Positive,46,2,48
539670,8,Very Positive,76,13,89
539690,0,3 user reviews,1,2,3
539720,8,Very Positive,215,36,251
539730,7,Positive,14,0,14
539750,5,Mixed,23,13,36
539780,0,1 user reviews,1,0,1
539790,0,1 user reviews,1,0,1
539800,0,2 user reviews,2,0,2
539810,0,1 user reviews,1,0,1
539820,0,2 user reviews,2,0,2
539830,0,2 user reviews,1,1,2
539840,0,2 user reviews,2,0,2
539850,0,3 user reviews,3,0,3
539860,0,1 user reviews,1,0,1
539870,0,1 user reviews,1,0,1
539880,0,2 user reviews,2,0,2
539890,0,2 user reviews,2,0,2
539900,0,2 user reviews,2,0,2
539910,0,3 user reviews,3,0,3
539920,0,2 user reviews,2,0,2
539930,0,2 user reviews,2,0,2
539940,0,1 user reviews,1,0,1
539950,0,2 user reviews,1,1,2
539960,0,1 user reviews,1,0,1
539970,0,1 user reviews,1,0,1
539980,7,Positive,12,1,13
540000,0,2 user reviews,2,0,2
540010,0,4 user reviews,3,1,4
540020,4,Mostly Negative,7,14,21
540040,0,1 user reviews,1,0,1
540060,7,Positive,29,3,32
540070,0,2 user reviews,1,1,2
540100,5,Mixed,47,36,83
540150,0,5 user reviews,3,2,5
540180,3,Negative,4,17,21
540190,5,Mixed,10,5,15
540220,0,1 user reviews,0,1,1
540230,5,Mixed,6,4,10
540250,0,2 user reviews,1,1,2
540320,0,5 user reviews,3,2,5
540330,0,7 user reviews,1,6,7
540340,5,Mixed,54,35,89
540350,0,1 user reviews,1,0,1
540360,0,4 user reviews,3,1,4
540410,7,Positive,14,0,14
540420,0,1 user reviews,1,0,1
540440,0,1 user reviews,1,0,1
540460,0,1 user reviews,1,0,1
540500,7,Positive,11,2,13
540510,8,Very Positive,173,34,207
540550,5,Mixed,5,6,11
540590,0,3 user reviews,1,2,3
540610,8,Very Positive,430,64,494
540640,0,9 user reviews,7,2,9
540650,0,7 user reviews,4,3,7
540660,7,Positive,16,3,19
540680,0,2 user reviews,2,0,2
540690,5,Mixed,20,14,34
540710,7,Positive,38,1,39
540711,7,Positive,31,2,33
540720,7,Positive,10,1,11
540721,7,Positive,13,0,13
540730,0,8 user reviews,8,0,8
540740,5,Mixed,16,19,35
540770,0,4 user reviews,4,0,4
540780,7,Positive,17,0,17
540810,5,Mixed,251,153,404
540820,0,5 user reviews,5,0,5
540840,8,Very Positive,604,56,660
540860,6,Mostly Positive,31,13,44
540870,6,Mostly Positive,14,6,20
540880,8,Very Positive,113,5,118
540900,0,7 user reviews,7,0,7
541130,0,9 user reviews,7,2,9
541160,0,9 user reviews,9,0,9
541200,8,Very Positive,550,39,589
541210,8,Very Positive,1614,276,1890
541230,8,Very Positive,91,14,105
541240,0,7 user reviews,6,1,7
541270,0,7 user reviews,4,3,7
541300,5,Mixed,388,239,627
541350,5,Mixed,14,8,22
541370,0,8 user reviews,1,7,8
541380,4,Mostly Negative,6,19,25
541400,0,4 user reviews,3,1,4
541410,0,2 user reviews,2,0,2
541420,0,5 user reviews,4,1,5
541450,5,Mixed,32,17,49
541460,0,1 user reviews,1,0,1
541470,0,1 user reviews,0,1,1
541500,0,2 user reviews,1,1,2
541540,0,1 user reviews,1,0,1
541560,0,7 user reviews,4,3,7
541570,9,Overwhelmingly Positive,1781,68,1849
541610,0,1 user reviews,1,0,1
541620,0,3 user reviews,2,1,3
541640,6,Mostly Positive,34,9,43
541660,7,Positive,24,4,28
541670,6,Mostly Positive,145,38,183
541720,5,Mixed,12,13,25
541760,0,1 user reviews,1,0,1
541770,0,2 user reviews,0,2,2
541800,0,5 user reviews,3,2,5
541830,0,3 user reviews,3,0,3
541920,0,9 user reviews,2,7,9
541930,8,Very Positive,103,6,109
541970,0,1 user reviews,0,1,1
542030,7,Positive,28,2,30
542040,0,1 user reviews,1,0,1
542050,8,Very Positive,388,34,422
542100,0,2 user reviews,1,1,2
542110,0,8 user reviews,3,5,8
542130,0,4 user reviews,3,1,4
542150,7,Positive,21,0,21
542160,7,Positive,16,3,19
542190,0,1 user reviews,1,0,1
542200,8,Very Positive,84,9,93
542210,0,2 user reviews,2,0,2
542220,0,8 user reviews,8,0,8
542240,0,6 user reviews,5,1,6
542260,8,Very Positive,65,11,76
542270,0,3 user reviews,1,2,3
542280,0,8 user reviews,2,6,8
542290,7,Positive,27,2,29
542300,0,1 user reviews,1,0,1
542310,6,Mostly Positive,26,7,33
542330,0,2 user reviews,2,0,2
542340,4,Mostly Negative,21,37,58
542350,6,Mostly Positive,45,18,63
542380,7,Positive,10,0,10
542400,6,Mostly Positive,57,22,79
542410,4,Mostly Negative,4,8,12
542430,4,Mostly Negative,10,35,45
542450,5,Mixed,13,10,23
542490,0,5 user reviews,5,0,5
542491,0,4 user reviews,4,0,4
542500,0,1 user reviews,1,0,1
542501,0,1 user reviews,1,0,1
542520,7,Positive,24,3,27
542530,0,4 user reviews,1,3,4
542550,7,Positive,18,2,20
542570,0,8 user reviews,6,2,8
542600,0,1 user reviews,1,0,1
542620,0,3 user reviews,2,1,3
542650,3,Negative,2,9,11
542660,6,Mostly Positive,42,11,53
542670,0,6 user reviews,1,5,6
542680,5,Mixed,7,4,11
542690,0,2 user reviews,2,0,2
542710,0,3 user reviews,3,0,3
542720,0,1 user reviews,1,0,1
542730,0,2 user reviews,0,2,2
542740,0,1 user reviews,1,0,1
542750,0,1 user reviews,0,1,1
542770,8,Very Positive,164,14,178
542780,0,1 user reviews,1,0,1
542820,6,Mostly Positive,10,3,13
542830,0,2 user reviews,1,1,2
542910,0,5 user reviews,3,2,5
542930,0,1 user reviews,1,0,1
542970,0,1 user reviews,1,0,1
542972,0,3 user reviews,3,0,3
543010,5,Mixed,112,58,170
543030,5,Mixed,30,22,52
543040,0,3 user reviews,3,0,3
543050,0,6 user reviews,3,3,6
543070,7,Positive,16,1,17
543080,0,3 user reviews,3,0,3
543090,0,1 user reviews,1,0,1
543100,5,Mixed,23,10,33
543110,0,3 user reviews,3,0,3
543120,0,1 user reviews,0,1,1
543140,5,Mixed,13,8,21
543160,0,6 user reviews,2,4,6
543170,0,3 user reviews,2,1,3
543180,6,Mostly Positive,40,14,54
543190,0,6 user reviews,6,0,6
543191,0,7 user reviews,7,0,7
543192,7,Positive,14,0,14
543193,0,9 user reviews,8,1,9
543200,0,1 user reviews,1,0,1
543240,6,Mostly Positive,69,20,89
543260,8,Very Positive,490,56,546
543270,7,Positive,13,3,16
543290,0,5 user reviews,3,2,5
543300,0,2 user reviews,1,1,2
543320,5,Mixed,6,6,12
543340,0,1 user reviews,1,0,1
543350,5,Mixed,9,4,13
543360,0,8 user reviews,0,8,8
543380,0,6 user reviews,3,3,6
543390,5,Mixed,75,41,116
543410,6,Mostly Positive,10,3,13
543430,5,Mixed,8,4,12
543440,7,Positive,21,4,25
543460,5,Mixed,341,265,606
543470,0,1 user reviews,1,0,1
543510,5,Mixed,7,5,12
543520,0,3 user reviews,2,1,3
543530,7,Positive,12,1,13
543540,0,3 user reviews,1,2,3
543580,7,Positive,22,4,26
543600,7,Positive,15,1,16
543610,0,1 user reviews,1,0,1
543650,0,6 user reviews,1,5,6
543660,0,1 user reviews,1,0,1
543670,0,2 user reviews,1,1,2
543710,5,Mixed,9,4,13
543720,0,3 user reviews,3,0,3
543740,0,4 user reviews,2,2,4
543811,0,1 user reviews,0,1,1
543870,8,Very Positive,210,46,256
543900,5,Mixed,1048,610,1658
543910,0,1 user reviews,1,0,1
543930,0,2 user reviews,1,1,2
543940,0,3 user reviews,3,0,3
543950,0,2 user reviews,0,2,2
543980,8,Very Positive,96,10,106
544130,0,3 user reviews,3,0,3
544140,0,1 user reviews,0,1,1
544150,0,1 user reviews,1,0,1
544180,7,Positive,11,0,11
544190,5,Mixed,8,4,12
544220,0,9 user reviews,3,6,9
544240,0,4 user reviews,2,2,4
544260,0,1 user reviews,1,0,1
544270,5,Mixed,13,7,20
544290,0,4 user reviews,4,0,4
544310,8,Very Positive,126,6,132
544330,8,Very Positive,513,77,590
544370,0,1 user reviews,0,1,1
544380,0,2 user reviews,2,0,2
544390,8,Very Positive,475,40,515
544400,7,Positive,10,0,10
544410,5,Mixed,9,7,16
544440,5,Mixed,6,4,10
544480,4,Mostly Negative,5,12,17
544520,0,1 user reviews,1,0,1
544530,6,Mostly Positive,26,9,35
544540,7,Positive,22,3,25
544550,8,Very Positive,1441,326,1767
544560,0,2 user reviews,1,1,2
544580,7,Positive,14,1,15
544590,0,2 user reviews,1,1,2
544600,7,Positive,27,5,32
544610,8,Very Positive,1057,167,1224
544630,7,Positive,10,1,11
544650,6,Mostly Positive,13,5,18
544680,0,4 user reviews,1,3,4
544710,7,Positive,18,2,20
544750,8,Very Positive,2463,552,3015
544770,0,1 user reviews,0,1,1
544790,5,Mixed,34,19,53
544800,0,6 user reviews,4,2,6
544820,0,2 user reviews,2,0,2
544830,0,2 user reviews,2,0,2
544832,0,1 user reviews,1,0,1
544840,0,5 user reviews,3,2,5
544870,5,Mixed,9,7,16
544880,0,3 user reviews,1,2,3
544920,6,Mostly Positive,625,221,846
544940,0,2 user reviews,2,0,2
544970,8,Very Positive,238,10,248
544980,0,2 user reviews,2,0,2
545020,0,7 user reviews,7,0,7
545030,8,Very Positive,51,3,54
545040,8,Very Positive,103,8,111
545050,5,Mixed,120,79,199
545060,5,Mixed,7,4,11
545090,7,Positive,25,5,30
545100,6,Mostly Positive,97,30,127
545110,6,Mostly Positive,19,8,27
545130,4,Mostly Negative,7,12,19
545150,5,Mixed,10,8,18
545170,0,2 user reviews,2,0,2
545180,8,Very Positive,51,11,62
545200,5,Mixed,9,6,15
545210,5,Mixed,8,6,14
545260,0,1 user reviews,0,1,1
545270,5,Mixed,260,148,408
545330,5,Mixed,14,18,32
545340,0,8 user reviews,8,0,8
545400,0,8 user reviews,6,2,8
545410,8,Very Positive,53,13,66
545430,7,Positive,41,2,43
545470,0,4 user reviews,3,1,4
545490,0,6 user reviews,0,6,6
545540,8,Very Positive,252,45,297
545560,0,3 user reviews,3,0,3
545580,5,Mixed,26,23,49
545590,7,Positive,14,1,15
545600,8,Very Positive,144,31,175
545620,5,Mixed,12,8,20
545640,0,6 user reviews,4,2,6
545650,5,Mixed,63,72,135
545660,0,5 user reviews,5,0,5
545670,7,Positive,10,2,12
545690,8,Very Positive,173,10,183
545700,0,5 user reviews,1,4,5
545720,0,5 user reviews,3,2,5
545800,5,Mixed,7,7,14
545820,0,8 user reviews,4,4,8
545830,5,Mixed,8,10,18
545840,0,1 user reviews,1,0,1
545850,7,Positive,9,1,10
545860,5,Mixed,14,12,26
545880,0,3 user reviews,3,0,3
545890,0,9 user reviews,6,3,9
545910,0,1 user reviews,1,0,1
545920,0,6 user reviews,3,3,6
545930,4,Mostly Negative,4,9,13
545940,7,Positive,12,1,13
545960,7,Positive,30,4,34
545980,8,Very Positive,196,15,211
546030,0,7 user reviews,3,4,7
546040,0,3 user reviews,1,2,3
546050,8,Very Positive,1391,166,1557
546070,6,Mostly Positive,22,8,30
546080,8,Very Positive,67,16,83
546090,8,Very Positive,69,6,75
546100,0,5 user reviews,5,0,5
546110,0,3 user reviews,2,1,3
546150,6,Mostly Positive,48,19,67
546160,7,Positive,10,1,11
546170,7,Positive,13,0,13
546180,0,7 user reviews,5,2,7
546200,7,Positive,18,3,21
546210,5,Mixed,12,10,22
546220,7,Positive,10,2,12
546230,5,Mixed,9,4,13
546240,0,9 user reviews,2,7,9
546260,7,Positive,12,1,13
546310,0,8 user reviews,5,3,8
546311,0,4 user reviews,4,0,4
546312,0,4 user reviews,2,2,4
546320,0,9 user reviews,7,2,9
546330,7,Positive,10,0,10
546340,4,Mostly Negative,4,11,15
546350,5,Mixed,40,24,64
546360,5,Mixed,5,7,12
546370,0,2 user reviews,2,0,2
546371,0,6 user reviews,2,4,6
546372,0,4 user reviews,3,1,4
546373,4,Mostly Negative,6,10,16
546374,0,1 user reviews,1,0,1
546390,7,Positive,37,1,38
546400,4,Mostly Negative,9,21,30
546410,7,Positive,13,2,15
546430,6,Mostly Positive,613,232,845
546440,0,2 user reviews,0,2,2
546460,7,Positive,11,0,11
546490,5,Mixed,12,9,21
546520,0,1 user reviews,1,0,1
546550,7,Positive,35,2,37
546560,9,Overwhelmingly Positive,24622,367,24989
546600,0,3 user reviews,3,0,3
546610,0,3 user reviews,2,1,3
546650,5,Mixed,11,5,16
546660,0,8 user reviews,1,7,8
546700,6,Mostly Positive,33,14,47
546780,7,Positive,17,2,19
546790,0,9 user reviews,8,1,9
546800,0,1 user reviews,1,0,1
546810,0,4 user reviews,4,0,4
546820,0,9 user reviews,4,5,9
546860,0,1 user reviews,1,0,1
546870,0,5 user reviews,3,2,5
546890,0,1 user reviews,1,0,1
546900,5,Mixed,19,24,43
546930,5,Mixed,81,76,157
546980,4,Mostly Negative,19,43,62
546990,5,Mixed,6,7,13
547000,0,1 user reviews,0,1,1
547040,5,Mixed,7,5,12
547050,7,Positive,36,5,41
547070,0,3 user reviews,3,0,3
547090,0,6 user reviews,3,3,6
547120,7,Positive,12,1,13
547130,0,4 user reviews,3,1,4
547140,0,6 user reviews,4,2,6
547150,0,9 user reviews,6,3,9
547180,5,Mixed,7,4,11
547200,0,8 user reviews,7,1,8
547210,0,3 user reviews,3,0,3
547230,0,1 user reviews,1,0,1
547250,0,5 user reviews,0,5,5
547260,0,1 user reviews,0,1,1
547280,0,6 user reviews,6,0,6
547310,5,Mixed,19,10,29
547340,8,Very Positive,77,13,90
547360,6,Mostly Positive,163,41,204
547390,7,Positive,22,0,22
547410,5,Mixed,109,112,221
547430,0,2 user reviews,2,0,2
547470,0,4 user reviews,3,1,4
547480,8,Very Positive,79,2,81
547490,0,1 user reviews,1,0,1
547500,8,Very Positive,47,7,54
547501,6,Mostly Positive,51,17,68
547502,8,Very Positive,275,49,324
547520,0,4 user reviews,2,2,4
547540,0,1 user reviews,1,0,1
547560,0,1 user reviews,1,0,1
547561,0,1 user reviews,0,1,1
547562,0,1 user reviews,0,1,1
547570,0,4 user reviews,4,0,4
547590,8,Very Positive,151,27,178
547630,0,1 user reviews,1,0,1
547680,6,Mostly Positive,166,53,219
547710,0,5 user reviews,4,1,5
547730,0,3 user reviews,1,2,3
547740,0,6 user reviews,3,3,6
547750,0,3 user reviews,2,1,3
547760,6,Mostly Positive,15,4,19
547820,0,5 user reviews,2,3,5
547840,5,Mixed,8,6,14
547850,8,Very Positive,45,10,55
547860,5,Mixed,502,404,906
547880,0,6 user reviews,4,2,6
547900,8,Very Positive,157,32,189
547910,6,Mostly Positive,188,61,249
547920,0,2 user reviews,0,2,2
547930,5,Mixed,8,4,12
547960,0,5 user reviews,3,2,5
547970,7,Positive,9,2,11
547980,7,Positive,38,2,40
547990,5,Mixed,8,5,13
548010,5,Mixed,14,8,22
548020,5,Mixed,24,22,46
548050,7,Positive,12,2,14
548080,5,Mixed,10,6,16
548110,0,5 user reviews,5,0,5
548130,7,Positive,13,1,14
548170,0,2 user reviews,2,0,2
548220,0,2 user reviews,2,0,2
548230,7,Positive,39,5,44
548240,6,Mostly Positive,13,5,18
548260,0,4 user reviews,2,2,4
548290,0,5 user reviews,4,1,5
548320,5,Mixed,7,5,12
548330,7,Positive,17,1,18
548340,8,Very Positive,207,15,222
548350,0,6 user reviews,0,6,6
548360,0,9 user reviews,6,3,9
548370,5,Mixed,40,58,98
548380,0,3 user reviews,2,1,3
548390,0,5 user reviews,4,1,5
548410,0,2 user reviews,0,2,2
548420,8,Very Positive,103,22,125
548421,6,Mostly Positive,85,25,110
548430,9,Overwhelmingly Positive,27724,770,28494
548450,5,Mixed,8,4,12
548470,0,8 user reviews,5,3,8
548480,4,Mostly Negative,11,27,38
548490,0,1 user reviews,1,0,1
548500,7,Positive,29,4,33
548510,0,1 user reviews,0,1,1
548540,0,1 user reviews,0,1,1
548560,5,Mixed,36,19,55
548570,5,Mixed,3427,2101,5528
548630,0,1 user reviews,1,0,1
548650,6,Mostly Positive,20,7,27
548660,0,9 user reviews,8,1,9
548680,7,Positive,38,4,42
548700,0,1 user reviews,1,0,1
548710,0,1 user reviews,1,0,1
548720,0,2 user reviews,2,0,2
548740,0,7 user reviews,3,4,7
548760,5,Mixed,13,15,28
548810,6,Mostly Positive,9,3,12
548821,0,1 user reviews,0,1,1
548840,8,Very Positive,63,15,78
548850,0,3 user reviews,2,1,3
548860,5,Mixed,11,6,17
549000,7,Positive,14,2,16
549030,0,9 user reviews,3,6,9
549040,5,Mixed,22,32,54
549070,0,9 user reviews,8,1,9
549071,0,6 user reviews,6,0,6
549080,8,Very Positive,110,25,135
549090,0,2 user reviews,2,0,2
549100,6,Mostly Positive,39,15,54
549111,0,2 user reviews,1,1,2
549112,0,1 user reviews,1,0,1
549113,0,3 user reviews,3,0,3
549160,7,Positive,37,7,44
549170,5,Mixed,31,18,49
549180,5,Mixed,21,13,34
549190,0,5 user reviews,5,0,5
549200,7,Positive,13,0,13
549220,0,1 user reviews,1,0,1
549240,5,Mixed,45,23,68
549260,6,Mostly Positive,188,48,236
549280,0,2 user reviews,0,2,2
549290,0,3 user reviews,3,0,3
549300,0,1 user reviews,1,0,1
549310,0,1 user reviews,1,0,1
549320,0,1 user reviews,1,0,1
549390,6,Mostly Positive,20,7,27
549400,6,Mostly Positive,18,7,25
549450,0,1 user reviews,1,0,1
549490,0,2 user reviews,2,0,2
549510,0,3 user reviews,3,0,3
549520,0,1 user reviews,0,1,1
549550,0,1 user reviews,1,0,1
549590,0,2 user reviews,2,0,2
549660,0,1 user reviews,1,0,1
549670,0,7 user reviews,4,3,7
549680,7,Positive,25,6,31
549700,0,7 user reviews,4,3,7
549720,0,1 user reviews,0,1,1
549740,7,Positive,19,1,20
549750,0,2 user reviews,2,0,2
549760,7,Positive,11,2,13
549770,0,3 user reviews,1,2,3
549780,0,3 user reviews,2,1,3
549830,0,1 user reviews,0,1,1
549840,7,Positive,20,1,21
549850,7,Positive,24,4,28
549860,8,Very Positive,258,35,293
549880,0,1 user reviews,1,0,1
549900,0,6 user reviews,5,1,6
549910,5,Mixed,16,7,23
549950,5,Mixed,6,7,13
549971,0,1 user reviews,1,0,1
550010,8,Very Positive,718,129,847
550050,7,Positive,11,0,11
550060,8,Very Positive,68,0,68
550080,8,Very Positive,278,42,320
550160,7,Positive,16,0,16
550170,7,Positive,16,0,16
550200,0,2 user reviews,2,0,2
550210,0,8 user reviews,7,1,8
550220,0,1 user reviews,1,0,1
550240,0,9 user reviews,4,5,9
550270,0,1 user reviews,1,0,1
550310,8,Very Positive,94,23,117
550320,9,Overwhelmingly Positive,513,26,539
550330,0,2 user reviews,1,1,2
550331,7,Positive,10,0,10
550332,0,3 user reviews,2,1,3
550333,0,1 user reviews,1,0,1
550334,0,2 user reviews,2,0,2
550335,0,1 user reviews,1,0,1
550340,8,Very Positive,73,14,87
550350,0,1 user reviews,1,0,1
550360,5,Mixed,23,12,35
550380,0,1 user reviews,1,0,1
550381,0,2 user reviews,2,0,2
550382,0,2 user reviews,2,0,2
550390,6,Mostly Positive,7,3,10
550400,7,Positive,13,0,13
550420,0,8 user reviews,7,1,8
550440,0,3 user reviews,2,1,3
550450,5,Mixed,8,4,12
550460,0,3 user reviews,3,0,3
550461,0,8 user reviews,8,0,8
550480,0,1 user reviews,1,0,1
550540,0,7 user reviews,4,3,7
550580,6,Mostly Positive,29,10,39
550590,8,Very Positive,80,5,85
550600,0,2 user reviews,0,2,2
550650,0,8 user reviews,5,3,8
550670,4,Mostly Negative,30,95,125
550710,0,1 user reviews,1,0,1
550800,0,3 user reviews,3,0,3
550810,7,Positive,31,6,37
550820,0,2 user reviews,2,0,2
550840,5,Mixed,57,44,101
550870,0,2 user reviews,1,1,2
550880,6,Mostly Positive,11,4,15
550890,0,3 user reviews,2,1,3
550930,0,4 user reviews,4,0,4
550990,7,Positive,23,1,24
551050,4,Mostly Negative,4,7,11
551060,0,5 user reviews,5,0,5
551080,6,Mostly Positive,25,8,33
551100,0,5 user reviews,4,1,5
551110,8,Very Positive,161,29,190
551150,0,8 user reviews,8,0,8
551160,0,1 user reviews,1,0,1
551170,8,Very Positive,125,28,153
551190,8,Very Positive,59,6,65
551260,0,6 user reviews,6,0,6
551320,5,Mixed,8,4,12
551360,0,2 user reviews,2,0,2
551370,5,Mixed,46,25,71
551380,0,5 user reviews,5,0,5
551440,5,Mixed,14,7,21
551450,8,Very Positive,170,18,188
551500,0,1 user reviews,0,1,1
551520,0,9 user reviews,6,3,9
551550,4,Mostly Negative,3,8,11
551560,0,5 user reviews,5,0,5
551570,0,6 user reviews,6,0,6
551580,7,Positive,36,5,41
551610,0,9 user reviews,1,8,9
551620,8,Very Positive,66,6,72
551630,5,Mixed,15,15,30
551650,0,7 user reviews,4,3,7
551670,0,2 user reviews,1,1,2
551680,0,4 user reviews,3,1,4
551690,6,Mostly Positive,81,23,104
551700,6,Mostly Positive,174,49,223
551720,5,Mixed,13,7,20
551730,6,Mostly Positive,345,90,435
551740,0,4 user reviews,1,3,4
551750,0,8 user reviews,6,2,8
551770,8,Very Positive,614,140,754
551780,0,6 user reviews,3,3,6
551790,0,5 user reviews,4,1,5
551810,0,2 user reviews,2,0,2
551820,6,Mostly Positive,7,3,10
551821,7,Positive,12,3,15
551840,0,5 user reviews,4,1,5
551860,6,Mostly Positive,347,118,465
551880,7,Positive,32,8,40
551930,5,Mixed,11,8,19
551960,0,1 user reviews,1,0,1
551970,0,1 user reviews,1,0,1
551971,0,2 user reviews,1,1,2
552000,0,1 user reviews,1,0,1
552010,0,2 user reviews,0,2,2
552030,5,Mixed,34,18,52
552060,7,Positive,34,8,42
552080,9,Overwhelmingly Positive,516,13,529
552090,5,Mixed,16,11,27
552100,8,Very Positive,5996,527,6523
552110,0,2 user reviews,1,1,2
552120,6,Mostly Positive,8,3,11
552130,5,Mixed,50,72,122
552140,0,3 user reviews,2,1,3
552150,0,1 user reviews,0,1,1
552160,8,Very Positive,64,5,69
552190,0,1 user reviews,1,0,1
552200,0,8 user reviews,8,0,8
552210,0,1 user reviews,1,0,1
552220,0,1 user reviews,1,0,1
552230,0,7 user reviews,3,4,7
552240,0,1 user reviews,1,0,1
552270,0,6 user reviews,3,3,6
552280,7,Positive,16,4,20
552300,0,6 user reviews,2,4,6
552310,0,5 user reviews,2,3,5
552330,0,2 user reviews,2,0,2
552350,5,Mixed,10,7,17
552360,0,1 user reviews,1,0,1
552370,7,Positive,10,1,11
552380,0,4 user reviews,3,1,4
552390,5,Mixed,17,17,34
552400,7,Positive,11,1,12
552410,5,Mixed,16,11,27
552440,8,Very Positive,356,69,425
552450,8,Very Positive,320,55,375
552460,8,Very Positive,95,10,105
552500,8,Very Positive,17410,2971,20381
552520,6,Mostly Positive,21927,6900,28827
552540,0,4 user reviews,2,2,4
552550,0,3 user reviews,0,3,3
552570,0,3 user reviews,2,1,3
552580,5,Mixed,9,5,14
552590,8,Very Positive,1157,93,1250
552600,8,Very Positive,235,48,283
552610,0,7 user reviews,7,0,7
552620,8,Very Positive,1848,323,2171
552630,0,8 user reviews,6,2,8
552640,0,1 user reviews,1,0,1
552643,0,1 user reviews,1,0,1
552650,0,1 user reviews,1,0,1
552651,4,Mostly Negative,5,9,14
552660,0,1 user reviews,0,1,1
552670,0,1 user reviews,0,1,1
552690,0,4 user reviews,4,0,4
552700,6,Mostly Positive,716,181,897
552720,6,Mostly Positive,7,3,10
552770,0,2 user reviews,2,0,2
552780,7,Positive,10,2,12
552800,0,3 user reviews,3,0,3
552820,0,1 user reviews,1,0,1
552850,0,3 user reviews,3,0,3
552870,0,4 user reviews,3,1,4
552880,8,Very Positive,114,12,126
552900,0,1 user reviews,1,0,1
552910,4,Mostly Negative,4,7,11
552920,5,Mixed,270,149,419
552940,0,1 user reviews,1,0,1
552950,0,2 user reviews,1,1,2
552960,0,2 user reviews,0,2,2
552970,5,Mixed,44,21,65
552990,8,Very Positive,123,18,141
553000,5,Mixed,4,6,10
553020,0,4 user reviews,4,0,4
553030,5,Mixed,13,8,21
553040,0,6 user reviews,5,1,6
553050,5,Mixed,8,4,12
553070,0,1 user reviews,1,0,1
553073,0,1 user reviews,1,0,1
553074,0,2 user reviews,2,0,2
553075,0,2 user reviews,2,0,2
553090,0,1 user reviews,1,0,1
553100,0,9 user reviews,1,8,9
553110,5,Mixed,6,9,15
553120,0,3 user reviews,3,0,3
553130,0,2 user reviews,1,1,2
553150,0,7 user reviews,2,5,7
553160,0,6 user reviews,6,0,6
553170,0,1 user reviews,1,0,1
553180,0,4 user reviews,2,2,4
553190,0,1 user reviews,1,0,1
553210,6,Mostly Positive,196,78,274
553260,5,Mixed,192,133,325
553280,8,Very Positive,441,83,524
553290,5,Mixed,10,13,23
553310,9,Overwhelmingly Positive,2296,77,2373
553320,5,Mixed,11,13,24
553330,0,2 user reviews,2,0,2
553340,7,Positive,25,6,31
553370,0,1 user reviews,1,0,1
553380,0,2 user reviews,2,0,2
553410,0,8 user reviews,4,4,8
553430,0,5 user reviews,3,2,5
553440,0,4 user reviews,4,0,4
553450,6,Mostly Positive,17,7,24
553470,5,Mixed,8,8,16
553480,8,Very Positive,162,27,189
553490,0,2 user reviews,1,1,2
553500,0,2 user reviews,2,0,2
553520,6,Mostly Positive,190,69,259
553570,0,2 user reviews,0,2,2
553590,0,5 user reviews,5,0,5
553610,5,Mixed,12,6,18
553630,0,2 user reviews,0,2,2
553640,8,Very Positive,1886,427,2313
553660,6,Mostly Positive,50,17,67
553670,7,Positive,16,0,16
553680,0,1 user reviews,0,1,1
553690,0,8 user reviews,3,5,8
553700,0,2 user reviews,2,0,2
553720,0,1 user reviews,1,0,1
553750,0,3 user reviews,3,0,3
553760,8,Very Positive,77,3,80
553780,0,2 user reviews,2,0,2
553790,8,Very Positive,42,8,50
553800,5,Mixed,11,11,22
553820,6,Mostly Positive,11,4,15
553830,0,3 user reviews,1,2,3
553861,0,1 user reviews,1,0,1
553880,6,Mostly Positive,83,33,116
553910,0,2 user reviews,1,1,2
553920,5,Mixed,6,6,12
553950,7,Positive,20,1,21
553960,5,Mixed,19,15,34
554000,8,Very Positive,162,4,166
554140,0,3 user reviews,2,1,3
554150,7,Positive,31,3,34
554180,7,Positive,20,5,25
554220,7,Positive,33,7,40
554272,0,1 user reviews,0,1,1
554280,7,Positive,27,5,32
554290,7,Positive,34,3,37
554310,6,Mostly Positive,105,27,132
554320,0,2 user reviews,2,0,2
554321,0,2 user reviews,2,0,2
554330,7,Positive,22,2,24
554380,8,Very Positive,127,25,152
554381,6,Mostly Positive,223,63,286
554390,7,Positive,17,0,17
554470,7,Positive,19,2,21
554530,7,Positive,24,6,30
554550,0,6 user reviews,3,3,6
554560,0,3 user reviews,3,0,3
554570,5,Mixed,24,24,48
554590,0,2 user reviews,1,1,2
554600,8,Very Positive,184,14,198
554620,8,Very Positive,9767,793,10560
554640,0,2 user reviews,0,2,2
554660,0,3 user reviews,3,0,3
554680,0,9 user reviews,6,3,9
554690,0,1 user reviews,1,0,1
554700,0,8 user reviews,7,1,8
554750,5,Mixed,65,46,111
554770,0,1 user reviews,0,1,1
554790,5,Mixed,7,7,14
554791,5,Mixed,30,23,53
554800,7,Positive,26,6,32
554810,8,Very Positive,51,12,63
554820,6,Mostly Positive,18,5,23
554870,7,Positive,17,2,19
554920,0,1 user reviews,1,0,1
554940,0,4 user reviews,3,1,4
554950,7,Positive,21,1,22
554980,0,4 user reviews,3,1,4
555000,8,Very Positive,226,22,248
555010,5,Mixed,28,13,41
555020,0,1 user reviews,1,0,1
555050,6,Mostly Positive,81,22,103
555060,6,Mostly Positive,41,11,52
555100,0,2 user reviews,1,1,2
555120,0,9 user reviews,9,0,9
555130,0,2 user reviews,0,2,2
555150,6,Mostly Positive,1043,287,1330
555160,8,Very Positive,12369,739,13108
555170,0,6 user reviews,4,2,6
555180,5,Mixed,15,14,29
555210,8,Very Positive,290,50,340
555220,9,Overwhelmingly Positive,1559,62,1621
555230,0,1 user reviews,0,1,1
555260,4,Mostly Negative,3,8,11
555280,5,Mixed,7,4,11
555290,8,Very Positive,53,13,66
555300,5,Mixed,19,11,30
555310,6,Mostly Positive,11,3,14
555320,6,Mostly Positive,39,12,51
555340,0,2 user reviews,2,0,2
555360,0,1 user reviews,1,0,1
555370,0,5 user reviews,2,3,5
555400,8,Very Positive,105,26,131
555410,0,4 user reviews,3,1,4
555440,6,Mostly Positive,2321,716,3037
555450,4,Mostly Negative,14,43,57
555510,5,Mixed,147,111,258
555520,0,4 user reviews,4,0,4
555530,0,5 user reviews,3,2,5
555531,5,Mixed,11,5,16
555532,0,3 user reviews,1,2,3
555570,5,Mixed,389,515,904
555580,7,Positive,20,0,20
555600,7,Positive,19,1,20
555610,6,Mostly Positive,20,8,28
555630,7,Positive,33,2,35
555640,8,Very Positive,47,3,50
555650,5,Mixed,12,9,21
555660,4,Mostly Negative,24,39,63
555670,0,8 user reviews,0,8,8
555710,6,Mostly Positive,44,13,57
555720,0,7 user reviews,6,1,7
555730,7,Positive,8,2,10
555750,5,Mixed,111,65,176
555760,0,4 user reviews,2,2,4
555770,0,1 user reviews,1,0,1
555810,0,1 user reviews,1,0,1
555820,0,5 user reviews,0,5,5
555850,0,4 user reviews,1,3,4
555880,8,Very Positive,924,124,1048
555890,0,5 user reviews,4,1,5
555920,3,Negative,1,16,17
555930,0,4 user reviews,2,2,4
555950,8,Very Positive,909,98,1007
555970,7,Positive,17,1,18
556000,0,4 user reviews,0,4,4
556050,8,Very Positive,136,8,144
556060,7,Positive,16,4,20
556130,0,2 user reviews,2,0,2
556140,7,Positive,23,3,26
556150,0,1 user reviews,1,0,1
556170,0,1 user reviews,1,0,1
556180,6,Mostly Positive,106,33,139
556190,6,Mostly Positive,14,4,18
556200,0,1 user reviews,0,1,1
556210,6,Mostly Positive,9,3,12
556212,5,Mixed,60,37,97
556213,5,Mixed,24,17,41
556214,0,5 user reviews,4,1,5
556217,0,9 user reviews,2,7,9
556218,0,3 user reviews,3,0,3
556219,0,6 user reviews,0,6,6
556220,0,2 user reviews,2,0,2
556221,5,Mixed,27,22,49
556222,5,Mixed,26,17,43
556223,0,4 user reviews,4,0,4
556224,0,3 user reviews,0,3,3
556225,0,4 user reviews,1,3,4
556226,0,5 user reviews,1,4,5
556229,0,3 user reviews,3,0,3
556230,5,Mixed,35,19,54
556240,8,Very Positive,140,25,165
556250,0,4 user reviews,4,0,4
556260,0,6 user reviews,4,2,6
556280,6,Mostly Positive,44,18,62
556300,3,Negative,0,11,11
556310,0,2 user reviews,2,0,2
556340,8,Very Positive,87,21,108
556350,0,1 user reviews,1,0,1
556390,0,2 user reviews,1,1,2
556391,4,Mostly Negative,10,31,41
556392,5,Mixed,13,6,19
556470,6,Mostly Positive,105,32,137
556480,5,Mixed,37,31,68
556500,0,2 user reviews,2,0,2
556520,5,Mixed,6,4,10
556530,6,Mostly Positive,9,3,12
556540,0,7 user reviews,5,2,7
556550,5,Mixed,33,32,65
556570,0,4 user reviews,4,0,4
556640,6,Mostly Positive,119,33,152
556650,0,9 user reviews,9,0,9
556670,0,1 user reviews,0,1,1
556680,0,5 user reviews,1,4,5
556700,0,5 user reviews,2,3,5
556710,5,Mixed,10,5,15
556740,6,Mostly Positive,106,39,145
556750,0,1 user reviews,1,0,1
556760,0,8 user reviews,7,1,8
556770,0,7 user reviews,2,5,7
556780,5,Mixed,17,9,26
556810,0,1 user reviews,1,0,1
556820,5,Mixed,224,140,364
556830,0,4 user reviews,4,0,4
556840,0,9 user reviews,3,6,9
556850,0,1 user reviews,0,1,1
556860,6,Mostly Positive,81,31,112
556870,5,Mixed,37,22,59
556880,7,Positive,11,1,12
556890,7,Positive,28,6,34
556900,7,Positive,15,1,16
556920,5,Mixed,7,4,11
556960,7,Positive,11,0,11
556970,8,Very Positive,352,63,415
556990,0,5 user reviews,4,1,5
557000,0,5 user reviews,5,0,5
557001,0,1 user reviews,1,0,1
557020,0,1 user reviews,1,0,1
557030,4,Mostly Negative,5,8,13
557040,5,Mixed,33,22,55
557190,0,7 user reviews,4,3,7
557240,7,Positive,9,2,11
557260,4,Mostly Negative,4,14,18
557280,6,Mostly Positive,10,3,13
557290,0,1 user reviews,1,0,1
557300,0,1 user reviews,0,1,1
557330,7,Positive,19,4,23
557340,9,Overwhelmingly Positive,8474,380,8854
557350,0,5 user reviews,1,4,5
557380,0,6 user reviews,5,1,6
557390,0,3 user reviews,2,1,3
557400,8,Very Positive,141,24,165
557410,8,Very Positive,114,20,134
557420,0,3 user reviews,2,1,3
557460,0,5 user reviews,4,1,5
557520,5,Mixed,53,36,89
557570,7,Positive,17,0,17
557580,6,Mostly Positive,17,6,23
557600,9,Overwhelmingly Positive,2113,100,2213
557630,8,Very Positive,128,1,129
557680,5,Mixed,8,6,14
557700,5,Mixed,9,5,14
557720,0,5 user reviews,4,1,5
557730,7,Positive,10,1,11
557750,7,Positive,43,2,45
557760,0,1 user reviews,1,0,1
557770,0,5 user reviews,2,3,5
557780,0,7 user reviews,5,2,7
557790,0,3 user reviews,3,0,3
557800,0,1 user reviews,1,0,1
557810,5,Mixed,8,12,20
557830,0,9 user reviews,6,3,9
557850,7,Positive,10,1,11
557860,7,Positive,11,1,12
557880,0,4 user reviews,1,3,4
557890,0,3 user reviews,3,0,3
557900,5,Mixed,20,9,29
557940,0,3 user reviews,2,1,3
557960,0,5 user reviews,3,2,5
557970,0,5 user reviews,5,0,5
557980,0,2 user reviews,2,0,2
558000,0,3 user reviews,2,1,3
558050,0,3 user reviews,1,2,3
558060,0,3 user reviews,1,2,3
558080,0,6 user reviews,6,0,6
558100,8,Very Positive,245,17,262
558110,6,Mostly Positive,96,29,125
558130,0,6 user reviews,4,2,6
558160,0,1 user reviews,1,0,1
558190,0,3 user reviews,3,0,3
558200,0,2 user reviews,1,1,2
558210,0,1 user reviews,0,1,1
558241,7,Positive,40,4,44
558242,7,Positive,23,3,26
558243,7,Positive,15,0,15
558244,8,Very Positive,290,24,314
558245,8,Very Positive,417,65,482
558260,6,Mostly Positive,110,46,156
558290,0,2 user reviews,2,0,2
558300,0,3 user reviews,2,1,3
558301,0,1 user reviews,1,0,1
558302,0,1 user reviews,1,0,1
558320,7,Positive,13,3,16
558340,5,Mixed,9,6,15
558370,6,Mostly Positive,16,6,22
558390,0,6 user reviews,1,5,6
558391,0,4 user reviews,2,2,4
558410,6,Mostly Positive,15,4,19
558420,8,Very Positive,1797,271,2068
558440,0,2 user reviews,2,0,2
558450,8,Very Positive,69,12,81
558480,4,Mostly Negative,3,7,10
558490,5,Mixed,16,12,28
558640,0,3 user reviews,3,0,3
558641,0,2 user reviews,2,0,2
558650,0,1 user reviews,0,1,1
558660,6,Mostly Positive,22,7,29
558670,0,5 user reviews,5,0,5
558720,0,2 user reviews,1,1,2
558740,0,5 user reviews,1,4,5
558750,0,5 user reviews,5,0,5
558760,0,6 user reviews,3,3,6
558761,0,3 user reviews,1,2,3
558762,0,9 user reviews,6,3,9
558780,6,Mostly Positive,36,10,46
558790,7,Positive,38,0,38
558850,5,Mixed,15,7,22
558870,4,Mostly Negative,16,46,62
558910,0,1 user reviews,1,0,1
558990,9,Overwhelmingly Positive,1560,44,1604
559010,7,Positive,13,0,13
559030,0,3 user reviews,2,1,3
559040,0,8 user reviews,5,3,8
559070,7,Positive,18,3,21
559100,6,Mostly Positive,974,310,1284
559130,5,Mixed,11,11,22
559140,0,4 user reviews,2,2,4
559150,0,2 user reviews,2,0,2
559200,0,2 user reviews,0,2,2
559210,9,Overwhelmingly Positive,1855,34,1889
559250,0,3 user reviews,3,0,3
559260,6,Mostly Positive,64,22,86
559280,0,3 user reviews,2,1,3
559310,5,Mixed,60,33,93
559330,8,Very Positive,306,13,319
559340,5,Mixed,55,64,119
559350,0,8 user reviews,6,2,8
559430,7,Positive,16,2,18
559450,0,2 user reviews,0,2,2
559470,0,1 user reviews,1,0,1
559590,0,1 user reviews,1,0,1
559610,8,Very Positive,530,40,570
559620,8,Very Positive,134,7,141
559630,0,3 user reviews,2,1,3
559640,7,Positive,36,7,43
559650,8,Very Positive,1078,90,1168
559670,0,4 user reviews,4,0,4
559680,8,Very Positive,198,35,233
559840,7,Positive,14,1,15
559850,7,Positive,13,1,14
559870,6,Mostly Positive,47,16,63
559890,0,1 user reviews,1,0,1
559900,4,Mostly Negative,5,12,17
559910,6,Mostly Positive,123,50,173
559920,0,2 user reviews,0,2,2
559930,0,9 user reviews,9,0,9
559950,0,3 user reviews,3,0,3
559960,8,Very Positive,49,9,58
559970,0,2 user reviews,2,0,2
559990,0,1 user reviews,1,0,1
560000,8,Very Positive,111,7,118
560010,0,7 user reviews,4,3,7
560040,0,1 user reviews,1,0,1
560050,7,Positive,40,3,43
560080,0,9 user reviews,6,3,9
560100,0,1 user reviews,1,0,1
560130,8,Very Positive,3545,568,4113
560150,6,Mostly Positive,11,4,15
560170,6,Mostly Positive,190,79,269
560180,0,5 user reviews,5,0,5
560200,0,6 user reviews,4,2,6
560220,7,Positive,9,1,10
560230,0,4 user reviews,1,3,4
560250,5,Mixed,40,19,59
560260,8,Very Positive,274,48,322
560300,7,Positive,33,2,35
560340,0,3 user reviews,1,2,3
560350,5,Mixed,18,12,30
560370,5,Mixed,89,43,132
560400,0,1 user reviews,1,0,1
560410,5,Mixed,8,4,12
560430,8,Very Positive,184,18,202
560510,0,9 user reviews,7,2,9
560550,7,Positive,16,1,17
560570,0,2 user reviews,0,2,2
560581,0,1 user reviews,1,0,1
560600,0,6 user reviews,6,0,6
560640,5,Mixed,35,21,56
560710,0,6 user reviews,5,1,6
560720,7,Positive,32,7,39
560730,5,Mixed,8,11,19
560740,6,Mostly Positive,13,5,18
560750,5,Mixed,11,8,19
560760,5,Mixed,10,10,20
560770,0,2 user reviews,2,0,2
560820,0,9 user reviews,5,4,9
560870,0,4 user reviews,2,2,4
560930,0,1 user reviews,0,1,1
560940,7,Positive,12,3,15
560941,5,Mixed,8,4,12
560960,0,2 user reviews,1,1,2
560970,0,2 user reviews,2,0,2
560990,0,3 user reviews,3,0,3
561000,7,Positive,25,3,28
561010,0,9 user reviews,6,3,9
561030,0,2 user reviews,2,0,2
561040,7,Positive,12,0,12
561050,0,1 user reviews,0,1,1
561060,0,1 user reviews,0,1,1
561080,7,Positive,39,2,41
561100,0,7 user reviews,4,3,7
561110,0,1 user reviews,1,0,1
561120,5,Mixed,20,14,34
561140,0,7 user reviews,3,4,7
561150,7,Positive,10,0,10
561190,7,Positive,27,2,29
561230,5,Mixed,11,7,18
561260,7,Positive,14,1,15
561340,0,3 user reviews,2,1,3
561360,7,Positive,14,3,17
561390,0,1 user reviews,1,0,1
561400,7,Positive,9,2,11
561420,5,Mixed,5,5,10
561440,0,4 user reviews,4,0,4
561450,0,5 user reviews,3,2,5
561470,8,Very Positive,59,3,62
561480,7,Positive,24,3,27
561490,0,7 user reviews,1,6,7
561510,0,3 user reviews,3,0,3
561527,0,4 user reviews,4,0,4
561549,0,1 user reviews,1,0,1
561590,5,Mixed,15,12,27
561600,8,Very Positive,163,37,200
561610,5,Mixed,84,37,121
561630,4,Mostly Negative,31,71,102
561631,4,Mostly Negative,15,33,48
561650,4,Mostly Negative,65,128,193
561680,7,Positive,15,0,15
561690,0,1 user reviews,0,1,1
561730,6,Mostly Positive,38,10,48
561740,8,Very Positive,128,23,151
561770,6,Mostly Positive,76,31,107
561930,0,5 user reviews,5,0,5
561970,0,3 user reviews,1,2,3
562010,0,2 user reviews,1,1,2
562050,4,Mostly Negative,4,7,11
562160,6,Mostly Positive,19,7,26
562210,5,Mixed,9,6,15
562220,8,Very Positive,896,71,967
562230,8,Very Positive,343,49,392
562240,0,9 user reviews,2,7,9
562250,8,Very Positive,43,10,53
562260,7,Positive,14,1,15
562270,0,4 user reviews,2,2,4
562280,7,Positive,20,4,24
562290,0,9 user reviews,5,4,9
562310,0,3 user reviews,3,0,3
562320,6,Mostly Positive,25,8,33
562330,7,Positive,11,2,13
562340,4,Mostly Negative,14,26,40
562360,8,Very Positive,258,33,291
562370,0,2 user reviews,0,2,2
562372,0,7 user reviews,2,5,7
562373,7,Positive,35,3,38
562374,0,3 user reviews,2,1,3
562375,5,Mixed,10,12,22
562376,5,Mixed,7,5,12
562378,5,Mixed,6,5,11
562379,7,Positive,11,2,13
562380,7,Positive,9,1,10
562381,7,Positive,22,4,26
562382,0,9 user reviews,8,1,9
562384,0,8 user reviews,3,5,8
562385,0,1 user reviews,1,0,1
562386,7,Positive,13,1,14
562387,0,1 user reviews,1,0,1
562388,0,2 user reviews,2,0,2
562389,0,8 user reviews,7,1,8
562390,0,2 user reviews,2,0,2
562391,0,2 user reviews,0,2,2
562397,0,1 user reviews,1,0,1
562398,0,8 user reviews,8,0,8
562399,6,Mostly Positive,30,8,38
562410,8,Very Positive,189,12,201
562420,5,Mixed,34,24,58
562430,0,4 user reviews,3,1,4
562450,0,6 user reviews,2,4,6
562460,0,5 user reviews,5,0,5
562470,6,Mostly Positive,23,8,31
562480,7,Positive,24,1,25
562490,5,Mixed,6,4,10
562500,8,Very Positive,472,72,544
562510,0,9 user reviews,6,3,9
562520,0,2 user reviews,1,1,2
562540,5,Mixed,7,5,12
562570,6,Mostly Positive,65,26,91
562590,5,Mixed,211,100,311
562600,0,2 user reviews,1,1,2
562630,0,1 user reviews,1,0,1
562640,5,Mixed,10,5,15
562660,0,3 user reviews,1,2,3
562680,0,4 user reviews,3,1,4
562690,0,7 user reviews,5,2,7
562700,4,Mostly Negative,11,19,30
562730,6,Mostly Positive,11,3,14
562740,0,5 user reviews,4,1,5
562800,5,Mixed,8,9,17
562810,5,Mixed,1220,1558,2778
562840,5,Mixed,14,12,26
562860,9,Overwhelmingly Positive,2323,105,2428
562870,0,1 user reviews,1,0,1
562890,0,1 user reviews,1,0,1
562891,0,1 user reviews,1,0,1
563102,0,1 user reviews,1,0,1
563103,0,3 user reviews,3,0,3
563105,0,1 user reviews,1,0,1
563106,0,4 user reviews,4,0,4
563107,0,3 user reviews,3,0,3
563120,5,Mixed,17,13,30
563130,0,8 user reviews,7,1,8
563150,5,Mixed,8,5,13
563160,0,2 user reviews,0,2,2
563170,0,4 user reviews,4,0,4
563180,7,Positive,26,1,27
563190,7,Positive,36,4,40
563200,8,Very Positive,63,15,78
563210,4,Mostly Negative,4,7,11
563250,0,5 user reviews,4,1,5
563260,7,Positive,21,1,22
563270,6,Mostly Positive,9,3,12
563300,0,2 user reviews,2,0,2
563320,4,Mostly Negative,12,21,33
563330,5,Mixed,10,9,19
563340,5,Mixed,14,20,34
563360,5,Mixed,52,30,82
563370,0,2 user reviews,2,0,2
563380,0,3 user reviews,3,0,3
563390,7,Positive,9,2,11
563400,0,1 user reviews,0,1,1
563410,0,8 user reviews,8,0,8
563420,5,Mixed,5,7,12
563430,0,3 user reviews,3,0,3
563490,3,Negative,2,12,14
563500,0,6 user reviews,3,3,6
563520,0,5 user reviews,5,0,5
563550,7,Positive,39,9,48
563610,0,2 user reviews,1,1,2
563680,0,9 user reviews,3,6,9
563710,7,Positive,9,2,11
563740,0,3 user reviews,3,0,3
563750,5,Mixed,65,40,105
563760,5,Mixed,13,15,28
563780,0,3 user reviews,3,0,3
563790,0,1 user reviews,1,0,1
563810,7,Positive,33,2,35
563830,7,Positive,16,2,18
563840,8,Very Positive,889,116,1005
563860,7,Positive,10,2,12
563880,0,1 user reviews,1,0,1
563890,0,8 user reviews,7,1,8
563910,0,2 user reviews,1,1,2
564010,4,Mostly Negative,6,12,18
564030,0,5 user reviews,4,1,5
564040,7,Positive,11,2,13
564050,8,Very Positive,150,25,175
564060,0,1 user reviews,0,1,1
564070,5,Mixed,5,5,10
564080,0,6 user reviews,6,0,6
564090,0,1 user reviews,1,0,1
564100,0,1 user reviews,1,0,1
564140,0,1 user reviews,0,1,1
564150,5,Mixed,100,44,144
564160,7,Positive,32,5,37
564170,0,5 user reviews,5,0,5
564180,7,Positive,15,0,15
564190,8,Very Positive,48,4,52
564210,6,Mostly Positive,8,3,11
564230,8,Very Positive,1429,154,1583
564250,0,3 user reviews,2,1,3
564251,0,6 user reviews,1,5,6
564260,0,1 user reviews,1,0,1
564280,0,4 user reviews,3,1,4
564290,0,2 user reviews,1,1,2
564300,0,8 user reviews,7,1,8
564310,8,Very Positive,876,69,945
564330,0,5 user reviews,5,0,5
564340,0,2 user reviews,0,2,2
564360,4,Mostly Negative,21,43,64
564400,0,1 user reviews,1,0,1
564420,0,5 user reviews,5,0,5
564440,0,2 user reviews,2,0,2
564450,0,2 user reviews,2,0,2
564470,6,Mostly Positive,26,7,33
564480,0,4 user reviews,4,0,4
564490,3,Negative,5,24,29
564520,0,9 user reviews,6,3,9
564530,8,Very Positive,593,75,668
564670,0,1 user reviews,1,0,1
564680,0,7 user reviews,5,2,7
564681,0,2 user reviews,2,0,2
564700,7,Positive,13,1,14
564710,8,Very Positive,479,33,512
564720,0,2 user reviews,0,2,2
564730,0,5 user reviews,3,2,5
564750,0,8 user reviews,8,0,8
564780,5,Mixed,16,12,28
564790,6,Mostly Positive,66,26,92
564791,6,Mostly Positive,41,12,53
564792,4,Mostly Negative,43,78,121
564793,4,Mostly Negative,7,15,22
564794,5,Mixed,19,20,39
564810,7,Positive,22,0,22
564850,0,2 user reviews,2,0,2
564900,4,Mostly Negative,5,17,22
564910,0,3 user reviews,2,1,3
564920,0,2 user reviews,1,1,2
564940,7,Positive,27,6,33
564950,5,Mixed,10,10,20
564960,5,Mixed,19,15,34
564980,0,1 user reviews,1,0,1
564990,0,2 user reviews,1,1,2
565000,0,3 user reviews,2,1,3
565001,0,6 user reviews,2,4,6
565002,0,2 user reviews,1,1,2
565030,7,Positive,16,2,18
565040,6,Mostly Positive,17,6,23
565050,0,4 user reviews,3,1,4
565100,0,2 user reviews,2,0,2
565110,0,3 user reviews,3,0,3
565120,8,Very Positive,309,66,375
565140,0,4 user reviews,4,0,4
565170,6,Mostly Positive,71,19,90
565180,7,Positive,23,1,24
565190,7,Positive,15,0,15
565200,0,2 user reviews,2,0,2
565210,7,Positive,10,0,10
565220,0,4 user reviews,4,0,4
565230,0,6 user reviews,6,0,6
565240,0,2 user reviews,2,0,2
565250,0,2 user reviews,2,0,2
565261,0,6 user reviews,6,0,6
565310,0,1 user reviews,1,0,1
565320,0,1 user reviews,1,0,1
565321,0,1 user reviews,1,0,1
565322,0,1 user reviews,1,0,1
565323,0,2 user reviews,2,0,2
565324,0,1 user reviews,0,1,1
565330,0,2 user reviews,0,2,2
565380,0,7 user reviews,3,4,7
565390,7,Positive,21,4,25
565410,5,Mixed,70,56,126
565420,0,1 user reviews,1,0,1
565490,0,1 user reviews,0,1,1
565510,0,1 user reviews,1,0,1
565520,0,8 user reviews,7,1,8
565540,0,1 user reviews,1,0,1
565550,5,Mixed,36,18,54
565560,0,1 user reviews,1,0,1
565570,0,1 user reviews,1,0,1
565580,0,1 user reviews,1,0,1
565590,0,1 user reviews,1,0,1
565600,7,Positive,19,2,21
565610,8,Very Positive,63,2,65
565620,5,Mixed,14,17,31
565621,5,Mixed,12,9,21
565622,6,Mostly Positive,11,3,14
565630,0,8 user reviews,8,0,8
565640,0,2 user reviews,1,1,2
565650,0,3 user reviews,3,0,3
565660,6,Mostly Positive,8,3,11
565670,0,8 user reviews,5,3,8
565690,0,7 user reviews,7,0,7
565720,8,Very Positive,61,8,69
565770,0,2 user reviews,2,0,2
565810,0,1 user reviews,1,0,1
565820,0,1 user reviews,1,0,1
565830,0,1 user reviews,1,0,1
565840,8,Very Positive,87,10,97
565860,6,Mostly Positive,110,33,143
565910,0,5 user reviews,4,1,5
565980,6,Mostly Positive,20,7,27
566010,0,1 user reviews,1,0,1
566050,8,Very Positive,375,22,397
566090,5,Mixed,303,148,451
566140,0,1 user reviews,1,0,1
566160,8,Very Positive,382,32,414
566170,0,1 user reviews,0,1,1
566180,0,4 user reviews,1,3,4
566190,5,Mixed,48,26,74
566200,0,4 user reviews,3,1,4
566250,0,2 user reviews,1,1,2
566260,0,2 user reviews,2,0,2
566270,5,Mixed,6,4,10
566280,0,1 user reviews,1,0,1
566320,0,4 user reviews,3,1,4
566350,0,3 user reviews,3,0,3
566380,0,1 user reviews,1,0,1
566420,0,6 user reviews,3,3,6
566430,5,Mixed,6,8,14
566440,5,Mixed,750,486,1236
566490,7,Positive,14,0,14
566530,6,Mostly Positive,151,44,195
566540,8,Very Positive,157,36,193
566550,5,Mixed,20,28,48
566560,0,2 user reviews,1,1,2
566570,5,Mixed,14,12,26
566580,0,5 user reviews,3,2,5
566670,7,Positive,17,1,18
566690,0,1 user reviews,1,0,1
566700,7,Positive,42,1,43
566710,0,1 user reviews,1,0,1
566750,0,7 user reviews,5,2,7
566780,6,Mostly Positive,24,8,32
566860,8,Very Positive,692,114,806
566870,6,Mostly Positive,12,5,17
566880,7,Positive,14,2,16
566890,7,Positive,15,1,16
566900,7,Positive,10,0,10
566910,0,1 user reviews,0,1,1
566930,0,5 user reviews,4,1,5
566940,0,7 user reviews,6,1,7
566970,6,Mostly Positive,12,5,17
566980,0,8 user reviews,8,0,8
567010,0,8 user reviews,7,1,8
567020,0,5 user reviews,2,3,5
567030,8,Very Positive,148,2,150
567040,4,Mostly Negative,6,13,19
567060,8,Very Positive,76,19,95
567080,8,Very Positive,52,7,59
567130,8,Very Positive,70,13,83
567140,7,Positive,13,3,16
567150,6,Mostly Positive,14,4,18
567160,7,Positive,34,3,37
567200,5,Mixed,12,6,18
567210,0,8 user reviews,8,0,8
567220,5,Mixed,5,6,11
567240,7,Positive,11,2,13
567260,5,Mixed,6,6,12
567280,8,Very Positive,158,29,187
567290,8,Very Positive,221,24,245
567320,4,Mostly Negative,17,26,43
567340,7,Positive,31,1,32
567360,0,2 user reviews,1,1,2
567370,8,Very Positive,60,1,61
567380,9,Overwhelmingly Positive,516,22,538
567480,0,3 user reviews,2,1,3
567580,6,Mostly Positive,68,25,93
567600,0,9 user reviews,4,5,9
567610,0,4 user reviews,2,2,4
567630,0,1 user reviews,0,1,1
567640,8,Very Positive,3558,398,3956
567660,0,4 user reviews,4,0,4
567670,8,Very Positive,193,22,215
567680,4,Mostly Negative,9,18,27
567730,7,Positive,30,4,34
567750,6,Mostly Positive,108,39,147
567780,5,Mixed,11,6,17
567800,8,Very Positive,61,12,73
567810,7,Positive,40,4,44
567840,0,5 user reviews,3,2,5
567860,0,2 user reviews,2,0,2
567890,5,Mixed,7,4,11
567980,0,5 user reviews,5,0,5
567990,8,Very Positive,157,5,162
568010,7,Positive,12,1,13
568011,7,Positive,9,1,10
568012,0,3 user reviews,3,0,3
568013,0,2 user reviews,2,0,2
568020,7,Positive,45,2,47
568030,7,Positive,9,2,11
568040,8,Very Positive,101,15,116
568060,0,6 user reviews,6,0,6
568070,5,Mixed,10,6,16
568090,8,Very Positive,1369,126,1495
568110,7,Positive,10,2,12
568150,0,2 user reviews,2,0,2
568160,0,6 user reviews,6,0,6
568180,0,8 user reviews,8,0,8
568200,7,Positive,10,1,11
568220,8,Very Positive,1331,221,1552
568240,0,1 user reviews,1,0,1
568250,0,6 user reviews,3,3,6
568290,0,7 user reviews,7,0,7
568310,0,7 user reviews,7,0,7
568320,8,Very Positive,318,9,327
568330,0,2 user reviews,1,1,2
568370,7,Positive,18,2,20
568380,6,Mostly Positive,9,3,12
568400,0,6 user reviews,4,2,6
568440,6,Mostly Positive,29,10,39
568460,7,Positive,11,1,12
568470,0,8 user reviews,4,4,8
568480,0,2 user reviews,2,0,2
568490,7,Positive,13,0,13
568500,0,8 user reviews,5,3,8
568570,5,Mixed,785,370,1155
568580,5,Mixed,19,13,32
568600,0,5 user reviews,5,0,5
568610,7,Positive,23,3,26
568640,0,4 user reviews,4,0,4
568690,0,1 user reviews,1,0,1
568710,0,1 user reviews,0,1,1
568720,5,Mixed,16,21,37
568750,6,Mostly Positive,116,33,149
568780,6,Mostly Positive,8,3,11
568800,0,2 user reviews,2,0,2
568830,7,Positive,10,1,11
568840,0,4 user reviews,4,0,4
568850,5,Mixed,12,6,18
568860,0,4 user reviews,1,3,4
568910,0,6 user reviews,3,3,6
568920,7,Positive,12,2,14
568930,6,Mostly Positive,94,32,126
568940,5,Mixed,18,10,28
568950,7,Positive,25,2,27
568960,5,Mixed,10,5,15
568970,5,Mixed,15,15,30
568980,0,9 user reviews,7,2,9
568990,0,9 user reviews,9,0,9
569000,0,6 user reviews,5,1,6
569010,0,1 user reviews,1,0,1
569030,0,1 user reviews,1,0,1
569050,0,3 user reviews,3,0,3
569130,0,1 user reviews,1,0,1
569140,0,4 user reviews,4,0,4
569150,0,4 user reviews,4,0,4
569160,0,1 user reviews,1,0,1
569180,4,Mostly Negative,3,7,10
569190,0,1 user reviews,1,0,1
569200,0,3 user reviews,3,0,3
569210,0,7 user reviews,4,3,7
569220,7,Positive,11,1,12
569241,0,2 user reviews,1,1,2
569243,0,3 user reviews,2,1,3
569245,0,1 user reviews,1,0,1
569270,0,4 user reviews,4,0,4
569290,7,Positive,16,4,20
569340,6,Mostly Positive,45,14,59
569350,0,5 user reviews,2,3,5
569360,7,Positive,15,1,16
569380,7,Positive,12,2,14
569390,0,3 user reviews,0,3,3
569410,0,1 user reviews,1,0,1
569420,0,7 user reviews,7,0,7
569430,5,Mixed,13,8,21
569480,8,Very Positive,8051,835,8886
569500,0,2 user reviews,2,0,2
569520,0,2 user reviews,2,0,2
569530,8,Very Positive,139,34,173
569570,6,Mostly Positive,8,3,11
569590,0,4 user reviews,2,2,4
569610,6,Mostly Positive,49,20,69
569630,6,Mostly Positive,48,20,68
569640,5,Mixed,11,13,24
569685,0,4 user reviews,3,1,4
569686,0,4 user reviews,3,1,4
569687,0,6 user reviews,5,1,6
569688,0,1 user reviews,1,0,1
569700,7,Positive,17,3,20
569710,0,5 user reviews,5,0,5
569711,0,1 user reviews,0,1,1
569712,0,5 user reviews,4,1,5
569713,0,1 user reviews,0,1,1
569714,0,2 user reviews,1,1,2
569715,0,1 user reviews,0,1,1
569716,0,9 user reviews,8,1,9
569717,0,4 user reviews,4,0,4
569720,0,1 user reviews,1,0,1
569770,5,Mixed,45,33,78
569800,8,Very Positive,87,21,108
569810,8,Very Positive,47,5,52
569820,0,1 user reviews,1,0,1
569850,0,2 user reviews,2,0,2
569860,8,Very Positive,1307,108,1415
569870,0,5 user reviews,1,4,5
569940,0,6 user reviews,5,1,6
569970,5,Mixed,38,35,73
570000,8,Very Positive,108,8,116
570050,6,Mostly Positive,39,13,52
570060,0,2 user reviews,1,1,2
570090,7,Positive,27,5,32
570120,0,2 user reviews,2,0,2
570150,7,Positive,9,2,11
570170,0,1 user reviews,0,1,1
570180,0,1 user reviews,1,0,1
570181,0,3 user reviews,3,0,3
570190,0,2 user reviews,2,0,2
570200,0,2 user reviews,1,1,2
570210,0,5 user reviews,3,2,5
570220,6,Mostly Positive,26,9,35
570230,6,Mostly Positive,7,3,10
570260,0,1 user reviews,1,0,1
570290,0,2 user reviews,2,0,2
570310,7,Positive,21,2,23
570320,0,1 user reviews,0,1,1
570350,5,Mixed,14,7,21
570360,0,6 user reviews,6,0,6
570361,0,6 user reviews,6,0,6
570362,0,5 user reviews,2,3,5
570363,0,2 user reviews,2,0,2
570370,0,4 user reviews,4,0,4
570380,0,7 user reviews,1,6,7
570420,6,Mostly Positive,71,30,101
570460,8,Very Positive,494,99,593
570470,5,Mixed,6,5,11
570490,8,Very Positive,79,2,81
570500,0,4 user reviews,1,3,4
570520,0,1 user reviews,1,0,1
570530,0,4 user reviews,4,0,4
570540,0,8 user reviews,5,3,8
570571,0,1 user reviews,1,0,1
570580,7,Positive,28,3,31
570590,7,Positive,9,2,11
570600,0,2 user reviews,2,0,2
570660,5,Mixed,1303,768,2071
570680,7,Positive,27,2,29
570690,3,Negative,0,13,13
570710,5,Mixed,17,25,42
570770,7,Positive,30,6,36
570780,6,Mostly Positive,38,12,50
570790,0,6 user reviews,2,4,6
570810,0,8 user reviews,8,0,8
570820,0,2 user reviews,2,0,2
570840,0,6 user reviews,6,0,6
570850,0,6 user reviews,4,2,6
570860,7,Positive,24,4,28
570890,0,3 user reviews,2,1,3
570900,7,Positive,36,0,36
570930,7,Positive,19,0,19
570940,8,Very Positive,10314,2121,12435
570960,5,Mixed,23,12,35
570970,5,Mixed,47,23,70
570980,0,6 user reviews,4,2,6
571010,7,Positive,18,3,21
571020,5,Mixed,14,11,25
571040,0,6 user reviews,3,3,6
571050,0,3 user reviews,1,2,3
571060,7,Positive,13,2,15
571080,0,1 user reviews,1,0,1
571100,5,Mixed,10,8,18
571120,0,2 user reviews,2,0,2
571210,7,Positive,40,0,40
571220,0,1 user reviews,1,0,1
571230,0,4 user reviews,4,0,4
571260,8,Very Positive,352,62,414
571310,9,Overwhelmingly Positive,1171,50,1221
571330,0,1 user reviews,1,0,1
571340,5,Mixed,19,12,31
571350,7,Positive,24,4,28
571410,7,Positive,13,1,14
571430,7,Positive,33,3,36
571500,0,2 user reviews,2,0,2
571520,6,Mostly Positive,11,3,14
571530,8,Very Positive,216,16,232
571550,0,4 user reviews,2,2,4
571570,0,6 user reviews,4,2,6
571600,7,Positive,33,2,35
571610,0,2 user reviews,2,0,2
571630,5,Mixed,9,4,13
571660,0,4 user reviews,4,0,4
571670,0,1 user reviews,1,0,1
571680,0,4 user reviews,4,0,4
571690,0,3 user reviews,0,3,3
571710,8,Very Positive,373,26,399
571720,6,Mostly Positive,40,17,57
571740,8,Very Positive,4046,609,4655
571760,6,Mostly Positive,9,3,12
571761,0,6 user reviews,5,1,6
571810,0,1 user reviews,0,1,1
571850,0,1 user reviews,1,0,1
571860,5,Mixed,7,4,11
571870,5,Mixed,7,8,15
571880,9,Overwhelmingly Positive,820,17,837
571890,5,Mixed,19,10,29
571960,0,3 user reviews,2,1,3
571990,0,1 user reviews,1,0,1
572000,0,3 user reviews,3,0,3
572010,4,Mostly Negative,5,16,21
572020,7,Positive,25,2,27
572040,5,Mixed,5,6,11
572050,5,Mixed,16,14,30
572130,0,4 user reviews,4,0,4
572160,7,Positive,37,8,45
572170,0,2 user reviews,1,1,2
572180,0,7 user reviews,7,0,7
572210,0,2 user reviews,2,0,2
572220,8,Very Positive,119,9,128
572230,0,7 user reviews,1,6,7
572240,0,3 user reviews,2,1,3
572290,0,2 user reviews,1,1,2
572300,6,Mostly Positive,38,14,52
572310,0,1 user reviews,1,0,1
572311,0,1 user reviews,1,0,1
572330,5,Mixed,27,13,40
572350,0,3 user reviews,2,1,3
572381,0,1 user reviews,1,0,1
572410,6,Mostly Positive,1636,618,2254
572430,6,Mostly Positive,220,80,300
572480,0,1 user reviews,1,0,1
572520,6,Mostly Positive,51,18,69
572540,7,Positive,23,2,25
572570,0,5 user reviews,5,0,5
572580,6,Mostly Positive,10,4,14
572600,5,Mixed,4120,2121,6241
572620,5,Mixed,26,13,39
572630,7,Positive,14,1,15
572640,0,7 user reviews,6,1,7
572660,0,5 user reviews,2,3,5
572700,8,Very Positive,51,5,56
572710,6,Mostly Positive,14,4,18
572720,5,Mixed,6,8,14
572730,7,Positive,37,2,39
572740,7,Positive,33,4,37
572760,0,8 user reviews,8,0,8
572890,8,Very Positive,800,56,856
572910,0,5 user reviews,5,0,5
572942,0,1 user reviews,1,0,1
572960,0,3 user reviews,3,0,3
572965,0,1 user reviews,1,0,1
572972,0,1 user reviews,1,0,1
572980,0,5 user reviews,0,5,5
572990,0,2 user reviews,1,1,2
573020,0,2 user reviews,2,0,2
573022,0,2 user reviews,2,0,2
573031,0,1 user reviews,1,0,1
573040,7,Positive,14,2,16
573050,7,Positive,14,1,15
573060,6,Mostly Positive,117,34,151
573070,5,Mixed,10,5,15
573080,6,Mostly Positive,30,12,42
573090,8,Very Positive,7617,584,8201
573100,6,Mostly Positive,2142,565,2707
573110,5,Mixed,13,7,20
573120,6,Mostly Positive,264,71,335
573130,8,Very Positive,142,29,171
573160,8,Very Positive,89,11,100
573170,8,Very Positive,193,8,201
573180,7,Positive,22,1,23
573190,0,1 user reviews,1,0,1
573210,5,Mixed,6,8,14
573260,0,7 user reviews,3,4,7
573270,7,Positive,18,4,22
573290,7,Positive,14,0,14
573300,7,Positive,17,3,20
573320,8,Very Positive,341,26,367
573330,0,4 user reviews,1,3,4
573350,0,2 user reviews,2,0,2
573360,7,Positive,11,0,11
573370,5,Mixed,9,5,14
573410,8,Very Positive,523,53,576
573460,0,5 user reviews,3,2,5
573470,0,1 user reviews,0,1,1
573490,6,Mostly Positive,187,55,242
573511,0,1 user reviews,0,1,1
573512,0,1 user reviews,0,1,1
573520,7,Positive,39,2,41
573530,0,5 user reviews,3,2,5
573541,0,2 user reviews,2,0,2
573542,0,1 user reviews,1,0,1
573543,0,1 user reviews,1,0,1
573544,0,1 user reviews,1,0,1
573545,0,1 user reviews,1,0,1
573548,0,2 user reviews,2,0,2
573550,7,Positive,13,1,14
573570,0,3 user reviews,1,2,3
573580,0,3 user reviews,2,1,3
573600,5,Mixed,37,21,58
573610,0,1 user reviews,1,0,1
573620,0,1 user reviews,1,0,1
573640,0,1 user reviews,0,1,1
573650,0,1 user reviews,0,1,1
573660,0,8 user reviews,0,8,8
573670,0,4 user reviews,4,0,4
573680,5,Mixed,22,25,47
573690,0,2 user reviews,2,0,2
573700,0,2 user reviews,2,0,2
573710,0,1 user reviews,1,0,1
573720,0,3 user reviews,3,0,3
573730,0,1 user reviews,1,0,1
573750,0,1 user reviews,0,1,1
573760,0,5 user reviews,5,0,5
573770,7,Positive,13,1,14
573780,5,Mixed,38,19,57
573790,7,Positive,30,2,32
573830,4,Mostly Negative,29,88,117
573832,5,Mixed,49,29,78
573900,0,8 user reviews,8,0,8
573960,0,5 user reviews,1,4,5
574010,6,Mostly Positive,12,4,16
574030,5,Mixed,17,22,39
574040,0,2 user reviews,1,1,2
574050,5,Mixed,223,105,328
574080,5,Mixed,123,128,251
574090,8,Very Positive,518,117,635
574120,5,Mixed,12,7,19
574140,6,Mostly Positive,39,15,54
574150,0,2 user reviews,2,0,2
574160,7,Positive,13,1,14
574170,0,3 user reviews,2,1,3
574190,0,1 user reviews,1,0,1
574200,5,Mixed,30,15,45
574220,0,2 user reviews,2,0,2
574260,7,Positive,28,7,35
574270,7,Positive,21,5,26
574280,0,4 user reviews,3,1,4
574310,8,Very Positive,94,20,114
574330,0,2 user reviews,2,0,2
574380,0,2 user reviews,2,0,2
574400,0,1 user reviews,1,0,1
574410,0,1 user reviews,1,0,1
574420,0,6 user reviews,5,1,6
574500,0,9 user reviews,8,1,9
574520,0,2 user reviews,1,1,2
574560,8,Very Positive,459,110,569
574570,6,Mostly Positive,12,5,17
574580,6,Mostly Positive,11,4,15
574590,0,5 user reviews,5,0,5
574640,6,Mostly Positive,30,11,41
574670,0,1 user reviews,0,1,1
574677,0,1 user reviews,0,1,1
574690,0,6 user reviews,5,1,6
574710,0,4 user reviews,1,3,4
574720,8,Very Positive,454,69,523
574760,5,Mixed,349,329,678
574820,8,Very Positive,65,7,72
574860,0,9 user reviews,3,6,9
574890,7,Positive,16,3,19
574910,0,2 user reviews,2,0,2
574920,0,4 user reviews,3,1,4
574940,8,Very Positive,54,8,62
574961,0,1 user reviews,1,0,1
574967,0,2 user reviews,2,0,2
574980,8,Very Positive,1056,86,1142
574990,0,1 user reviews,0,1,1
575010,6,Mostly Positive,63,19,82
575030,0,1 user reviews,0,1,1
575050,0,5 user reviews,5,0,5
575080,0,1 user reviews,0,1,1
575090,0,9 user reviews,5,4,9
575100,0,2 user reviews,1,1,2
575110,0,9 user reviews,8,1,9
575160,4,Mostly Negative,5,11,16
575180,0,1 user reviews,1,0,1
575210,7,Positive,16,4,20
575270,0,6 user reviews,4,2,6
575290,6,Mostly Positive,8,3,11
575291,7,Positive,12,1,13
575300,7,Positive,9,2,11
575301,0,7 user reviews,3,4,7
575330,8,Very Positive,151,20,171
575340,5,Mixed,22,11,33
575360,0,3 user reviews,2,1,3
575400,7,Positive,30,6,36
575420,7,Positive,21,3,24
575430,5,Mixed,14,7,21
575450,6,Mostly Positive,17,5,22
575480,8,Very Positive,68,4,72
575490,0,6 user reviews,4,2,6
575500,0,2 user reviews,0,2,2
575501,0,1 user reviews,0,1,1
575510,6,Mostly Positive,41,13,54
575540,5,Mixed,8,7,15
575550,8,Very Positive,655,126,781
575560,0,4 user reviews,2,2,4
575570,5,Mixed,26,16,42
575580,5,Mixed,13,6,19
575590,7,Positive,14,0,14
575600,5,Mixed,36,26,62
575630,5,Mixed,6,4,10
575640,8,Very Positive,1110,126,1236
575650,8,Very Positive,109,16,125
575670,7,Positive,9,2,11
575680,0,1 user reviews,1,0,1
575690,0,5 user reviews,5,0,5
575700,5,Mixed,18,13,31
575710,0,5 user reviews,5,0,5
575750,0,4 user reviews,2,2,4
575760,0,3 user reviews,2,1,3
575780,0,5 user reviews,3,2,5
575800,0,4 user reviews,3,1,4
575810,0,1 user reviews,1,0,1
575820,6,Mostly Positive,64,20,84
575830,5,Mixed,11,14,25
575840,0,6 user reviews,5,1,6
575850,5,Mixed,13,11,24
575860,0,9 user reviews,3,6,9
575880,0,3 user reviews,2,1,3
575890,5,Mixed,11,6,17
575900,7,Positive,16,3,19
575920,0,3 user reviews,2,1,3
575940,8,Very Positive,55,8,63
575950,5,Mixed,89,55,144
575960,5,Mixed,18,18,36
575970,8,Very Positive,52,7,59
575990,0,9 user reviews,7,2,9
576020,0,5 user reviews,1,4,5
576030,8,Very Positive,160,19,179
576050,4,Mostly Negative,6,10,16
576060,0,6 user reviews,2,4,6
576100,6,Mostly Positive,14,5,19
576110,0,4 user reviews,1,3,4
576120,0,7 user reviews,2,5,7
576130,8,Very Positive,45,7,52
576160,7,Positive,11,1,12
576260,5,Mixed,57,33,90
576280,6,Mostly Positive,10,3,13
576290,0,2 user reviews,1,1,2
576300,0,7 user reviews,7,0,7
576310,5,Mixed,69,54,123
576320,5,Mixed,12,16,28
576330,0,1 user reviews,0,1,1
576370,0,5 user reviews,3,2,5
576380,0,3 user reviews,2,1,3
576390,0,9 user reviews,3,6,9
576400,5,Mixed,29,14,43
576410,6,Mostly Positive,23,6,29
576420,7,Positive,41,0,41
576440,2,Very Negative,9,42,51
576470,7,Positive,19,4,23
576480,0,9 user reviews,4,5,9
576500,7,Positive,42,0,42
576520,0,1 user reviews,0,1,1
576530,0,1 user reviews,0,1,1
576540,0,9 user reviews,4,5,9
576590,4,Mostly Negative,6,10,16
576610,0,1 user reviews,1,0,1
576615,0,1 user reviews,1,0,1
576620,6,Mostly Positive,28,9,37
576650,0,6 user reviews,6,0,6
576660,0,2 user reviews,2,0,2
576670,0,1 user reviews,1,0,1
576690,0,4 user reviews,1,3,4
576700,0,3 user reviews,0,3,3
576720,7,Positive,10,2,12
576730,6,Mostly Positive,7,3,10
576740,0,7 user reviews,7,0,7
576750,6,Mostly Positive,15,4,19
576770,8,Very Positive,510,39,549
576790,0,5 user reviews,4,1,5
576800,0,4 user reviews,2,2,4
576810,6,Mostly Positive,38,13,51
576820,0,3 user reviews,3,0,3
576840,7,Positive,11,1,12
576860,0,2 user reviews,2,0,2
576920,0,1 user reviews,1,0,1
576950,5,Mixed,21,11,32
576960,5,Mixed,18,8,26
576970,0,1 user reviews,1,0,1
576980,7,Positive,23,2,25
577000,0,1 user reviews,1,0,1
577020,0,4 user reviews,4,0,4
577030,0,2 user reviews,2,0,2
577080,5,Mixed,83,38,121
577100,0,1 user reviews,1,0,1
577120,0,2 user reviews,1,1,2
577130,0,1 user reviews,1,0,1
577131,0,3 user reviews,3,0,3
577150,0,3 user reviews,3,0,3
577160,0,1 user reviews,1,0,1
577210,0,4 user reviews,3,1,4
577230,6,Mostly Positive,132,54,186
577270,0,8 user reviews,8,0,8
577280,5,Mixed,6,5,11
577290,7,Positive,15,3,18
577310,0,2 user reviews,2,0,2
577311,0,1 user reviews,1,0,1
577312,0,1 user reviews,0,1,1
577320,0,2 user reviews,2,0,2
577330,0,7 user reviews,2,5,7
577350,6,Mostly Positive,106,45,151
577351,6,Mostly Positive,27,10,37
577352,7,Positive,20,0,20
577353,7,Positive,43,6,49
577354,6,Mostly Positive,49,21,70
577355,8,Very Positive,55,9,64
577356,6,Mostly Positive,46,16,62
577357,4,Mostly Negative,35,64,99
577358,5,Mixed,35,28,63
577359,5,Mixed,21,12,33
577360,6,Mostly Positive,10,3,13
577370,0,1 user reviews,1,0,1
577400,0,1 user reviews,1,0,1
577401,0,2 user reviews,0,2,2
577402,0,2 user reviews,2,0,2
577403,0,1 user reviews,1,0,1
577404,0,2 user reviews,1,1,2
577405,0,1 user reviews,1,0,1
577410,5,Mixed,110,50,160
577440,7,Positive,18,3,21
577450,7,Positive,11,0,11
577460,5,Mixed,34,44,78
577470,6,Mostly Positive,12,5,17
577480,8,Very Positive,121,2,123
577490,7,Positive,17,1,18
577530,8,Very Positive,81,13,94
577560,0,2 user reviews,2,0,2
577570,0,1 user reviews,0,1,1
577580,6,Mostly Positive,11,4,15
577600,0,4 user reviews,4,0,4
577640,0,1 user reviews,0,1,1
577670,5,Mixed,163,76,239
577690,8,Very Positive,521,31,552
577700,7,Positive,30,4,34
577730,6,Mostly Positive,74,24,98
577740,5,Mixed,17,12,29
577760,0,9 user reviews,9,0,9
577780,0,4 user reviews,3,1,4
577800,4,Mostly Negative,965,1907,2872
577810,0,1 user reviews,1,0,1
577850,7,Positive,19,3,22
577890,0,6 user reviews,0,6,6
577901,8,Very Positive,127,25,152
577910,7,Positive,20,0,20
577940,8,Very Positive,1062,97,1159
577970,8,Very Positive,69,2,71
577980,5,Mixed,5,7,12
577990,7,Positive,41,6,47
578010,4,Mostly Negative,3,7,10
578020,0,1 user reviews,1,0,1
578030,7,Positive,9,2,11
578060,7,Positive,14,0,14
578080,5,Mixed,144242,93342,237584
578140,0,4 user reviews,0,4,4
578190,0,4 user reviews,4,0,4
578210,6,Mostly Positive,206,79,285
578300,7,Positive,21,0,21
578310,6,Mostly Positive,95,38,133
578320,7,Positive,10,0,10
578330,6,Mostly Positive,466,127,593
578340,0,5 user reviews,5,0,5
578350,7,Positive,26,6,32
578360,0,5 user reviews,3,2,5
578380,0,3 user reviews,3,0,3
578390,0,6 user reviews,2,4,6
578420,7,Positive,12,0,12
578430,7,Positive,38,3,41
578470,0,4 user reviews,4,0,4
578560,0,3 user reviews,1,2,3
578590,0,5 user reviews,0,5,5
578610,0,7 user reviews,6,1,7
578620,9,Overwhelmingly Positive,4669,226,4895
578650,8,Very Positive,1062,228,1290
578660,7,Positive,8,2,10
578670,0,1 user reviews,1,0,1
578690,7,Positive,9,1,10
578720,5,Mixed,256,125,381
578740,0,3 user reviews,1,2,3
578770,0,3 user reviews,3,0,3
578800,5,Mixed,7,5,12
578830,5,Mixed,17,11,28
578850,8,Very Positive,186,16,202
578870,7,Positive,14,3,17
578880,0,5 user reviews,3,2,5
578890,0,7 user reviews,7,0,7
578900,8,Very Positive,268,11,279
578930,8,Very Positive,97,3,100
578970,0,3 user reviews,2,1,3
578980,0,1 user reviews,1,0,1
578990,0,6 user reviews,0,6,6
579020,5,Mixed,158,68,226
579050,0,8 user reviews,6,2,8
579080,0,1 user reviews,1,0,1
579100,0,1 user reviews,0,1,1
579110,8,Very Positive,111,11,122
579120,5,Mixed,19,24,43
579130,0,8 user reviews,4,4,8
579150,5,Mixed,9,5,14
579160,0,2 user reviews,1,1,2
579180,8,Very Positive,670,90,760
579210,0,8 user reviews,3,5,8
579230,7,Positive,31,4,35
579270,0,2 user reviews,2,0,2
579320,0,7 user reviews,6,1,7
579330,0,8 user reviews,1,7,8
579410,0,2 user reviews,2,0,2
579490,7,Positive,17,4,21
579510,0,2 user reviews,2,0,2
579531,0,1 user reviews,1,0,1
579538,0,1 user reviews,0,1,1
579580,0,1 user reviews,0,1,1
579640,0,2 user reviews,2,0,2
579720,6,Mostly Positive,10,4,14
579750,0,1 user reviews,0,1,1
579760,8,Very Positive,164,20,184
579780,6,Mostly Positive,15,6,21
579800,0,2 user reviews,0,2,2
579820,5,Mixed,87,78,165
579840,6,Mostly Positive,103,30,133
579870,0,2 user reviews,0,2,2
579890,0,1 user reviews,1,0,1
579920,7,Positive,26,4,30
579930,4,Mostly Negative,4,10,14
579940,8,Very Positive,140,21,161
579950,8,Very Positive,619,112,731
579960,0,1 user reviews,0,1,1
579980,7,Positive,26,3,29
580010,7,Positive,12,2,14
580020,4,Mostly Negative,58,141,199
580040,5,Mixed,226,131,357
580050,0,6 user reviews,2,4,6
580051,0,8 user reviews,7,1,8
580081,0,8 user reviews,4,4,8
580100,5,Mixed,417,217,634
580120,0,1 user reviews,1,0,1
580160,0,2 user reviews,2,0,2
580170,8,Very Positive,190,41,231
580180,0,9 user reviews,9,0,9
580200,8,Very Positive,975,227,1202
580300,7,Positive,12,1,13
580310,0,5 user reviews,5,0,5
580320,5,Mixed,6,5,11
580410,5,Mixed,6,6,12
580420,7,Positive,13,2,15
580480,0,2 user reviews,2,0,2
580510,0,1 user reviews,1,0,1
580520,5,Mixed,14,7,21
580530,0,1 user reviews,0,1,1
580540,0,1 user reviews,0,1,1
580560,0,2 user reviews,1,1,2
580570,0,8 user reviews,5,3,8
580590,0,3 user reviews,3,0,3
580600,6,Mostly Positive,257,84,341
580620,6,Mostly Positive,23,6,29
580630,0,4 user reviews,4,0,4
580680,5,Mixed,6,5,11
580700,0,1 user reviews,1,0,1
580710,6,Mostly Positive,144,56,200
580720,8,Very Positive,361,58,419
580730,5,Mixed,34,15,49
580731,7,Positive,34,3,37
580780,0,1 user reviews,1,0,1
580820,5,Mixed,20,9,29
580830,0,3 user reviews,3,0,3
580831,0,2 user reviews,2,0,2
580832,0,3 user reviews,3,0,3
580833,7,Positive,11,0,11
580870,0,8 user reviews,6,2,8
580880,0,5 user reviews,2,3,5
580890,7,Positive,18,4,22
580910,0,8 user reviews,2,6,8
580930,0,9 user reviews,4,5,9
580940,7,Positive,8,2,10
580950,0,8 user reviews,1,7,8
581030,5,Mixed,24,27,51
581060,0,2 user reviews,2,0,2
581100,0,4 user reviews,3,1,4
581200,5,Mixed,12,9,21
581210,0,3 user reviews,2,1,3
581220,4,Mostly Negative,18,41,59
581230,5,Mixed,15,10,25
581270,8,Very Positive,412,55,467
581300,5,Mixed,35,45,80
581310,5,Mixed,7,10,17
581320,8,Very Positive,24273,4112,28385
581340,0,7 user reviews,4,3,7
581360,8,Very Positive,89,6,95
581370,5,Mixed,43,26,69
581380,0,8 user reviews,5,3,8
581400,0,5 user reviews,5,0,5
581450,8,Very Positive,724,83,807
581460,0,7 user reviews,6,1,7
581510,0,2 user reviews,2,0,2
581520,6,Mostly Positive,42,15,57
581590,6,Mostly Positive,8,3,11
581600,0,8 user reviews,4,4,8
581630,8,Very Positive,2647,499,3146
581650,0,9 user reviews,7,2,9
581670,0,3 user reviews,2,1,3
581710,5,Mixed,5,5,10
581730,5,Mixed,17,8,25
581740,0,3 user reviews,0,3,3
581760,8,Very Positive,71,6,77
581800,7,Positive,10,2,12
581810,0,6 user reviews,2,4,6
581820,6,Mostly Positive,13,4,17
581840,0,8 user reviews,8,0,8
581910,6,Mostly Positive,10,3,13
581920,0,6 user reviews,2,4,6
581930,0,2 user reviews,0,2,2
581950,0,1 user reviews,1,0,1
581960,0,5 user reviews,4,1,5
581970,6,Mostly Positive,24,10,34
581980,4,Mostly Negative,5,16,21
581990,0,1 user reviews,1,0,1
582010,8,Very Positive,52814,6194,59008
582030,0,1 user reviews,1,0,1
582040,7,Positive,16,1,17
582050,5,Mixed,7,6,13
582150,0,7 user reviews,4,3,7
582160,8,Very Positive,12860,2662,15522
582170,0,4 user reviews,3,1,4
582171,0,2 user reviews,2,0,2
582172,0,2 user reviews,2,0,2
582200,0,4 user reviews,3,1,4
582210,7,Positive,17,2,19
582220,0,4 user reviews,2,2,4
582230,0,1 user reviews,1,0,1
582260,5,Mixed,21,17,38
582270,8,Very Positive,1410,268,1678
582280,0,9 user reviews,7,2,9
582290,0,5 user reviews,1,4,5
582330,8,Very Positive,128,15,143
582350,0,4 user reviews,4,0,4
582360,0,2 user reviews,2,0,2
582370,0,9 user reviews,8,1,9
582380,6,Mostly Positive,198,55,253
582390,0,3 user reviews,2,1,3
582440,0,1 user reviews,0,1,1
582500,8,Very Positive,806,82,888
582510,0,4 user reviews,3,1,4
582530,0,7 user reviews,7,0,7
582540,7,Positive,12,1,13
582550,8,Very Positive,1189,260,1449
582560,8,Very Positive,173,9,182
582570,7,Positive,10,2,12
582571,7,Positive,13,1,14
582572,0,6 user reviews,6,0,6
582573,7,Positive,9,2,11
582574,0,8 user reviews,5,3,8
582575,0,4 user reviews,2,2,4
582576,0,1 user reviews,1,0,1
582577,4,Mostly Negative,7,17,24
582578,0,4 user reviews,3,1,4
582600,8,Very Positive,387,53,440
582610,0,7 user reviews,3,4,7
582620,6,Mostly Positive,39,10,49
582660,6,Mostly Positive,13341,5203,18544
582740,0,1 user reviews,1,0,1
582750,0,1 user reviews,0,1,1
582800,0,2 user reviews,2,0,2
582810,5,Mixed,44,30,74
582820,0,5 user reviews,4,1,5
582840,0,6 user reviews,3,3,6
582880,7,Positive,17,4,21
582890,6,Mostly Positive,15,5,20
582920,0,5 user reviews,2,3,5
582960,0,6 user reviews,5,1,6
582980,7,Positive,12,1,13
582990,5,Mixed,12,6,18
583010,8,Very Positive,312,12,324
583030,0,3 user reviews,2,1,3
583040,6,Mostly Positive,41,17,58
583060,5,Mixed,5,6,11
583070,0,1 user reviews,1,0,1
583090,7,Positive,35,4,39
583140,7,Positive,21,0,21
583150,6,Mostly Positive,14,5,19
583190,7,Positive,16,1,17
583200,0,6 user reviews,5,1,6
583240,0,8 user reviews,8,0,8
583270,8,Very Positive,133,9,142
583360,0,1 user reviews,1,0,1
583470,8,Very Positive,1034,99,1133
583490,5,Mixed,15,8,23
583500,0,9 user reviews,7,2,9
583510,0,2 user reviews,1,1,2
583530,7,Positive,10,1,11
583570,0,1 user reviews,0,1,1
583580,0,1 user reviews,0,1,1
583590,5,Mixed,22,18,40
583620,5,Mixed,17,8,25
583630,0,1 user reviews,1,0,1
583640,7,Positive,38,0,38
583680,0,8 user reviews,7,1,8
583681,0,1 user reviews,1,0,1
583690,0,3 user reviews,0,3,3
583691,0,1 user reviews,1,0,1
583710,0,2 user reviews,2,0,2
583730,6,Mostly Positive,8,3,11
583760,8,Very Positive,230,22,252
583810,7,Positive,15,0,15
583820,0,3 user reviews,2,1,3
583821,0,1 user reviews,1,0,1
583850,5,Mixed,10,5,15
583860,0,6 user reviews,5,1,6
583870,0,2 user reviews,1,1,2
583890,5,Mixed,7,4,11
583930,8,Very Positive,131,22,153
583950,5,Mixed,4815,3408,8223
584000,0,1 user reviews,1,0,1
584050,0,1 user reviews,1,0,1
584095,5,Mixed,68,40,108
584096,6,Mostly Positive,55,21,76
584097,8,Very Positive,58,12,70
584100,4,Mostly Negative,5,9,14
584140,5,Mixed,289,307,596
584141,8,Very Positive,76,5,81
584150,5,Mixed,14,8,22
584180,0,1 user reviews,1,0,1
584191,0,1 user reviews,1,0,1
584200,6,Mostly Positive,7,3,10
584210,5,Mixed,992,1122,2114
584220,0,4 user reviews,4,0,4
584240,7,Positive,10,0,10
584260,0,2 user reviews,2,0,2
584280,3,Negative,6,36,42
584320,0,3 user reviews,3,0,3
584370,5,Mixed,41,20,61
584380,0,6 user reviews,6,0,6
584381,0,5 user reviews,5,0,5
584382,0,2 user reviews,2,0,2
584383,0,8 user reviews,8,0,8
584400,8,Very Positive,6548,651,7199
584507,0,1 user reviews,1,0,1
584570,0,1 user reviews,0,1,1
584590,0,1 user reviews,1,0,1
584600,0,6 user reviews,4,2,6
584630,0,1 user reviews,1,0,1
584760,0,2 user reviews,1,1,2
584770,0,4 user reviews,4,0,4
584780,3,Negative,1,14,15
584800,6,Mostly Positive,27,9,36
584820,0,2 user reviews,0,2,2
584850,0,7 user reviews,6,1,7
584860,0,2 user reviews,2,0,2
584880,7,Positive,12,0,12
584890,5,Mixed,33,20,53
584930,8,Very Positive,158,6,164
584940,5,Mixed,19,9,28
584970,7,Positive,17,2,19
584980,8,Very Positive,934,146,1080
584990,8,Very Positive,88,20,108
585040,5,Mixed,18,8,26
585080,5,Mixed,25,30,55
585090,4,Mostly Negative,5,8,13
585180,8,Very Positive,216,2,218
585190,8,Very Positive,51,9,60
585220,5,Mixed,6,4,10
585240,7,Positive,21,2,23
585260,7,Positive,24,1,25
585290,5,Mixed,20,14,34
585300,0,2 user reviews,2,0,2
585310,0,2 user reviews,1,1,2
585340,0,1 user reviews,1,0,1
585360,4,Mostly Negative,5,8,13
585410,8,Very Positive,366,59,425
585420,8,Very Positive,2327,234,2561
585430,0,9 user reviews,5,4,9
585440,0,1 user reviews,1,0,1
585450,8,Very Positive,443,96,539
585480,0,7 user reviews,6,1,7
585481,0,4 user reviews,2,2,4
585482,0,7 user reviews,6,1,7
585500,7,Positive,15,1,16
585540,0,1 user reviews,1,0,1
585550,8,Very Positive,549,110,659
585560,0,2 user reviews,1,1,2
585600,0,4 user reviews,3,1,4
585610,0,2 user reviews,1,1,2
585620,5,Mixed,15,7,22
585690,5,Mixed,153,108,261
585710,8,Very Positive,228,46,274
585740,0,5 user reviews,1,4,5
585750,0,2 user reviews,1,1,2
585770,0,4 user reviews,3,1,4
585820,0,7 user reviews,2,5,7
585830,5,Mixed,32,30,62
585840,8,Very Positive,275,66,341
585860,3,Negative,0,15,15
585880,7,Positive,15,0,15
585890,8,Very Positive,258,16,274
585900,6,Mostly Positive,429,137,566
585910,8,Very Positive,93,17,110
585920,0,7 user reviews,6,1,7
585940,0,2 user reviews,2,0,2
585950,8,Very Positive,48,5,53
585970,0,1 user reviews,1,0,1
585990,0,7 user reviews,6,1,7
586010,0,4 user reviews,3,1,4
586020,7,Positive,22,3,25
586030,0,2 user reviews,1,1,2
586060,5,Mixed,12,6,18
586070,0,1 user reviews,1,0,1
586080,4,Mostly Negative,6,11,17
586100,0,5 user reviews,0,5,5
586130,0,8 user reviews,3,5,8
586140,8,Very Positive,1131,77,1208
586150,0,8 user reviews,2,6,8
586170,0,4 user reviews,3,1,4
586200,5,Mixed,336,166,502
586210,5,Mixed,259,113,372
586230,0,9 user reviews,9,0,9
586240,8,Very Positive,65,10,75
586310,8,Very Positive,44,11,55
586320,7,Positive,14,0,14
586340,0,6 user reviews,5,1,6
586350,8,Very Positive,84,6,90
586360,5,Mixed,13,8,21
586380,0,6 user reviews,3,3,6
586390,7,Positive,33,1,34
586410,0,2 user reviews,2,0,2
586420,0,5 user reviews,5,0,5
586430,0,3 user reviews,2,1,3
586450,0,9 user reviews,9,0,9
586460,0,8 user reviews,4,4,8
586490,0,1 user reviews,1,0,1
586560,0,2 user reviews,2,0,2
586570,0,3 user reviews,2,1,3
586600,0,8 user reviews,1,7,8
586620,0,9 user reviews,3,6,9
586660,7,Positive,19,1,20
586670,0,8 user reviews,7,1,8
586680,0,6 user reviews,1,5,6
586690,0,3 user reviews,3,0,3
586700,0,2 user reviews,1,1,2
586710,0,5 user reviews,3,2,5
586720,0,1 user reviews,1,0,1
586740,0,2 user reviews,2,0,2
586750,5,Mixed,136,82,218
586770,7,Positive,9,2,11
586790,0,9 user reviews,1,8,9
586830,6,Mostly Positive,10,4,14
586880,8,Very Positive,123,7,130
586890,0,1 user reviews,0,1,1
586910,5,Mixed,9,7,16
586920,6,Mostly Positive,7,3,10
586930,0,5 user reviews,2,3,5
586940,0,1 user reviews,0,1,1
586950,6,Mostly Positive,170,51,221
586960,8,Very Positive,99,24,123
586970,5,Mixed,34,18,52
586980,5,Mixed,7,10,17
586990,0,5 user reviews,5,0,5
587000,8,Very Positive,220,48,268
587010,0,2 user reviews,0,2,2
587070,0,6 user reviews,4,2,6
587100,8,Very Positive,170,16,186
587110,8,Very Positive,178,12,190
587170,0,1 user reviews,1,0,1
587180,7,Positive,30,7,37
587200,0,2 user reviews,2,0,2
587210,0,9 user reviews,5,4,9
587220,9,Overwhelmingly Positive,896,37,933
587260,8,Very Positive,418,48,466
587290,7,Positive,9,1,10
587310,7,Positive,21,0,21
587330,0,4 user reviews,1,3,4
587390,0,2 user reviews,1,1,2
587400,6,Mostly Positive,12,4,16
587410,0,5 user reviews,3,2,5
587414,0,1 user reviews,1,0,1
587420,5,Mixed,83,40,123
587430,8,Very Positive,901,50,951
587440,7,Positive,11,2,13
587450,5,Mixed,422,282,704
587470,8,Very Positive,195,7,202
587490,5,Mixed,8,6,14
587500,0,3 user reviews,2,1,3
587560,0,7 user reviews,6,1,7
587580,8,Very Positive,148,21,169
587620,8,Very Positive,2166,145,2311
587660,0,1 user reviews,1,0,1
587690,0,4 user reviews,2,2,4
587710,0,1 user reviews,1,0,1
587730,0,7 user reviews,6,1,7
587780,0,1 user reviews,1,0,1
587790,0,2 user reviews,0,2,2
587810,4,Mostly Negative,9,21,30
587820,0,1 user reviews,1,0,1
587840,6,Mostly Positive,12,4,16
587860,8,Very Positive,43,7,50
587920,6,Mostly Positive,20,8,28
587930,6,Mostly Positive,19,6,25
587970,0,8 user reviews,6,2,8
588010,0,5 user reviews,5,0,5
588030,8,Very Positive,859,63,922
588040,8,Very Positive,161,25,186
588050,0,2 user reviews,1,1,2
588070,0,7 user reviews,2,5,7
588080,0,4 user reviews,2,2,4
588110,6,Mostly Positive,85,22,107
588120,6,Mostly Positive,19,8,27
588140,0,1 user reviews,0,1,1
588150,0,1 user reviews,1,0,1
588160,5,Mixed,51,58,109
588180,7,Positive,17,0,17
588190,5,Mixed,258,133,391
588200,0,4 user reviews,4,0,4
588230,6,Mostly Positive,31,8,39
588240,8,Very Positive,81,16,97
588260,0,2 user reviews,2,0,2
588263,0,1 user reviews,1,0,1
588270,0,8 user reviews,3,5,8
588280,0,1 user reviews,1,0,1
588290,7,Positive,28,1,29
588300,0,5 user reviews,4,1,5
588310,7,Positive,25,2,27
588340,5,Mixed,16,13,29
588350,0,2 user reviews,1,1,2
588410,5,Mixed,19,11,30
588440,5,Mixed,21,10,31
588490,7,Positive,9,1,10
588530,0,1 user reviews,1,0,1
588540,7,Positive,9,1,10
588550,0,3 user reviews,1,2,3
588560,5,Mixed,21,16,37
588570,0,3 user reviews,1,2,3
588600,7,Positive,14,0,14
588620,7,Positive,13,1,14
588630,6,Mostly Positive,11,4,15
588650,9,Overwhelmingly Positive,17023,674,17697
588660,8,Very Positive,120,2,122
588690,8,Very Positive,192,23,215
588710,5,Mixed,8,7,15
588720,0,1 user reviews,0,1,1
588730,8,Very Positive,189,11,200
588750,5,Mixed,5,6,11
588790,0,1 user reviews,1,0,1
588800,0,6 user reviews,3,3,6
588830,0,2 user reviews,2,0,2
588840,0,1 user reviews,1,0,1
588880,0,5 user reviews,4,1,5
588890,5,Mixed,7,4,11
588920,5,Mixed,13,12,25
588950,8,Very Positive,615,72,687
588960,0,9 user reviews,9,0,9
588961,0,1 user reviews,1,0,1
588962,0,5 user reviews,4,1,5
588963,7,Positive,21,2,23
588964,0,1 user reviews,1,0,1
588970,8,Very Positive,192,25,217
588980,0,5 user reviews,4,1,5
588990,6,Mostly Positive,9,3,12
589021,0,2 user reviews,2,0,2
589040,7,Positive,42,4,46
589060,7,Positive,13,1,14
589080,0,3 user reviews,2,1,3
589100,7,Positive,11,2,13
589110,5,Mixed,7,7,14
589140,0,1 user reviews,1,0,1
589141,0,1 user reviews,1,0,1
589142,0,1 user reviews,1,0,1
589150,0,9 user reviews,5,4,9
589160,0,5 user reviews,3,2,5
589170,0,4 user reviews,2,2,4
589190,7,Positive,9,1,10
589200,8,Very Positive,173,8,181
589220,0,9 user reviews,8,1,9
589250,5,Mixed,26,12,38
589260,0,4 user reviews,1,3,4
589270,0,4 user reviews,4,0,4
589280,7,Positive,25,0,25
589290,8,Very Positive,5885,732,6617
589300,0,8 user reviews,3,5,8
589320,6,Mostly Positive,31,13,44
589360,8,Very Positive,2251,446,2697
589380,0,6 user reviews,4,2,6
589410,0,6 user reviews,4,2,6
589420,8,Very Positive,56,8,64
589430,0,6 user reviews,1,5,6
589470,7,Positive,13,3,16
589480,7,Positive,28,3,31
589500,8,Very Positive,94,6,100
589510,8,Very Positive,134,12,146
589530,8,Very Positive,263,37,300
589590,8,Very Positive,2417,129,2546
589620,6,Mostly Positive,11,4,15
589640,7,Positive,27,6,33
589650,0,1 user reviews,1,0,1
589651,0,1 user reviews,1,0,1
589670,7,Positive,19,4,23
589680,0,4 user reviews,4,0,4
589690,6,Mostly Positive,13,5,18
589730,5,Mixed,8,6,14
589740,5,Mixed,9,12,21
589760,8,Very Positive,165,39,204
589770,7,Positive,10,1,11
589780,8,Very Positive,1609,166,1775
589850,0,6 user reviews,6,0,6
589860,8,Very Positive,70,4,74
589880,6,Mostly Positive,42,13,55
589900,5,Mixed,6,4,10
589910,0,2 user reviews,1,1,2
589920,0,9 user reviews,3,6,9
589930,0,6 user reviews,4,2,6
590170,0,1 user reviews,1,0,1
590172,0,1 user reviews,1,0,1
590175,0,1 user reviews,1,0,1
590188,0,1 user reviews,0,1,1
590192,0,1 user reviews,1,0,1
590201,0,2 user reviews,0,2,2
590205,0,3 user reviews,2,1,3
590209,0,1 user reviews,0,1,1
590215,0,1 user reviews,1,0,1
590216,0,1 user reviews,1,0,1
590218,0,1 user reviews,0,1,1
590222,0,2 user reviews,2,0,2
590239,0,1 user reviews,0,1,1
590242,0,1 user reviews,1,0,1
590245,0,1 user reviews,1,0,1
590250,4,Mostly Negative,4,8,12
590270,0,5 user reviews,2,3,5
590280,7,Positive,13,0,13
590290,0,1 user reviews,1,0,1
590360,0,1 user reviews,0,1,1
590370,0,7 user reviews,4,3,7
590380,8,Very Positive,5893,407,6300
590390,7,Positive,17,0,17
590391,0,8 user reviews,7,1,8
590430,0,4 user reviews,2,2,4
590460,0,6 user reviews,6,0,6
590470,0,1 user reviews,1,0,1
590490,0,1 user reviews,1,0,1
590510,8,Very Positive,53,13,66
590530,6,Mostly Positive,9,3,12
590570,0,1 user reviews,0,1,1
590580,4,Mostly Negative,4,7,11
590590,8,Very Positive,149,7,156
590610,7,Positive,17,0,17
590660,0,5 user reviews,3,2,5
590690,8,Very Positive,372,58,430
590720,7,Positive,29,5,34
590750,0,8 user reviews,6,2,8
590770,0,1 user reviews,0,1,1
590780,7,Positive,15,1,16
590820,0,4 user reviews,3,1,4
590840,0,7 user reviews,6,1,7
590850,7,Positive,13,3,16
590860,0,8 user reviews,6,2,8
590870,4,Mostly Negative,4,9,13
590940,6,Mostly Positive,12,4,16
590950,7,Positive,33,0,33
590970,4,Mostly Negative,23,49,72
591000,8,Very Positive,49,8,57
591090,0,2 user reviews,2,0,2
591130,0,4 user reviews,2,2,4
591350,7,Positive,17,1,18
591370,8,Very Positive,1356,224,1580
591380,8,Very Positive,238,39,277
591420,8,Very Positive,529,56,585
591460,9,Overwhelmingly Positive,945,42,987
591470,0,3 user reviews,2,1,3
591480,0,2 user reviews,0,2,2
591490,0,1 user reviews,0,1,1
591491,0,1 user reviews,1,0,1
591492,0,1 user reviews,1,0,1
591493,0,1 user reviews,0,1,1
591494,0,1 user reviews,1,0,1
591495,0,1 user reviews,1,0,1
591496,0,1 user reviews,1,0,1
591497,0,1 user reviews,1,0,1
591498,0,1 user reviews,1,0,1
591499,0,2 user reviews,0,2,2
591500,0,1 user reviews,0,1,1
591501,0,2 user reviews,2,0,2
591502,0,1 user reviews,1,0,1
591503,0,2 user reviews,2,0,2
591509,0,2 user reviews,2,0,2
591530,5,Mixed,159,72,231
591560,7,Positive,22,4,26
591580,0,5 user reviews,2,3,5
591610,0,2 user reviews,1,1,2
591620,0,3 user reviews,3,0,3
591630,8,Very Positive,54,7,61
591640,0,1 user reviews,1,0,1
591660,0,6 user reviews,3,3,6
591710,5,Mixed,90,39,129
591750,7,Positive,21,2,23
591760,7,Positive,19,1,20
591790,5,Mixed,68,62,130
591800,5,Mixed,74,87,161
591810,0,7 user reviews,3,4,7
591812,0,4 user reviews,4,0,4
591813,0,4 user reviews,4,0,4
591910,5,Mixed,10,8,18
591920,0,5 user reviews,4,1,5
591930,5,Mixed,12,7,19
591970,0,7 user reviews,6,1,7
591971,0,1 user reviews,1,0,1
591980,0,3 user reviews,3,0,3
591981,0,1 user reviews,0,1,1
591982,0,1 user reviews,0,1,1
591983,0,1 user reviews,1,0,1
591984,0,7 user reviews,6,1,7
591985,0,4 user reviews,3,1,4
591986,0,6 user reviews,4,2,6
591990,0,9 user reviews,5,4,9
592020,0,9 user reviews,8,1,9
592030,6,Mostly Positive,95,25,120
592040,0,3 user reviews,3,0,3
592060,0,7 user reviews,1,6,7
592100,7,Positive,16,3,19
592120,0,7 user reviews,5,2,7
592130,0,1 user reviews,1,0,1
592200,0,7 user reviews,6,1,7
592240,7,Positive,9,1,10
592260,8,Very Positive,1118,160,1278
592270,7,Positive,12,0,12
592290,0,4 user reviews,3,1,4
592291,0,2 user reviews,2,0,2
592292,0,3 user reviews,2,1,3
592300,7,Positive,27,2,29
592310,6,Mostly Positive,9,3,12
592320,5,Mixed,5,7,12
592330,0,8 user reviews,5,3,8
592340,5,Mixed,15,21,36
592350,7,Positive,10,0,10
592360,0,1 user reviews,0,1,1
592372,4,Mostly Negative,40,81,121
592373,8,Very Positive,75,7,82
592374,6,Mostly Positive,71,24,95
592390,5,Mixed,21,15,36
592400,0,8 user reviews,8,0,8
592410,5,Mixed,13,10,23
592450,0,1 user reviews,1,0,1
592460,8,Very Positive,62,3,65
592461,7,Positive,16,0,16
592480,8,Very Positive,108,4,112
592550,5,Mixed,13,11,24
592560,0,2 user reviews,1,1,2
592570,0,4 user reviews,2,2,4
592580,5,Mixed,230,160,390
592620,0,9 user reviews,3,6,9
592660,5,Mixed,10,7,17
592700,0,4 user reviews,0,4,4
592720,0,4 user reviews,3,1,4
592730,5,Mixed,17,8,25
592740,0,3 user reviews,1,2,3
592750,7,Positive,13,0,13
592800,5,Mixed,30,17,47
592820,0,2 user reviews,2,0,2
592890,0,1 user reviews,0,1,1
592920,0,3 user reviews,2,1,3
592990,0,3 user reviews,1,2,3
593030,8,Very Positive,76,13,89
593051,4,Mostly Negative,5,8,13
593052,0,1 user reviews,1,0,1
593055,0,3 user reviews,1,2,3
593060,0,2 user reviews,2,0,2
593070,7,Positive,18,2,20
593100,0,4 user reviews,3,1,4
593200,7,Positive,26,2,28
593210,7,Positive,25,3,28
593240,5,Mixed,30,20,50
593250,0,2 user reviews,2,0,2
593260,0,4 user reviews,2,2,4
593270,6,Mostly Positive,8,3,11
593271,0,1 user reviews,1,0,1
593272,0,2 user reviews,1,1,2
593273,0,1 user reviews,1,0,1
593280,9,Overwhelmingly Positive,1592,74,1666
593330,4,Mostly Negative,9,30,39
593340,7,Positive,13,3,16
593360,0,1 user reviews,1,0,1
593380,8,Very Positive,1468,287,1755
593410,7,Positive,13,2,15
593430,0,1 user reviews,1,0,1
593490,6,Mostly Positive,76,31,107
593530,4,Mostly Negative,20,36,56
593540,5,Mixed,6,4,10
593560,4,Mostly Negative,5,8,13
593600,5,Mixed,1415,696,2111
593670,0,3 user reviews,3,0,3
593680,0,9 user reviews,9,0,9
593700,7,Positive,29,4,33
593730,0,5 user reviews,2,3,5
593740,7,Positive,8,2,10
593850,5,Mixed,13,10,23
593900,8,Very Positive,56,13,69
593920,0,1 user reviews,0,1,1
593950,0,2 user reviews,2,0,2
593960,8,Very Positive,291,41,332
593970,0,3 user reviews,3,0,3
593980,0,3 user reviews,1,2,3
594000,0,9 user reviews,7,2,9
594040,5,Mixed,48,46,94
594050,6,Mostly Positive,69,18,87
594060,0,1 user reviews,1,0,1
594120,0,3 user reviews,0,3,3
594130,8,Very Positive,248,8,256
594150,0,2 user reviews,2,0,2
594160,3,Negative,2,9,11
594184,7,Positive,14,0,14
594200,7,Positive,10,0,10
594320,7,Positive,10,0,10
594330,8,Very Positive,1344,182,1526
594350,8,Very Positive,49,9,58
594360,0,9 user reviews,8,1,9
594370,5,Mixed,35,24,59
594410,0,5 user reviews,4,1,5
594490,0,1 user reviews,1,0,1
594550,6,Mostly Positive,42,11,53
594570,8,Very Positive,29147,2011,31158
594591,5,Mixed,216,300,516
594630,7,Positive,14,2,16
594640,4,Mostly Negative,8,23,31
594650,8,Very Positive,22323,4944,27267
594660,7,Positive,36,9,45
594680,7,Positive,42,4,46
594700,7,Positive,10,0,10
594720,5,Mixed,22,16,38
594750,5,Mixed,8,5,13
594770,5,Mixed,184,144,328
594800,0,4 user reviews,3,1,4
594810,0,6 user reviews,6,0,6
594820,0,3 user reviews,3,0,3
594950,7,Positive,29,0,29
594970,5,Mixed,9,9,18
594980,7,Positive,23,2,25
595000,4,Mostly Negative,7,11,18
595010,5,Mixed,8,4,12
595020,0,1 user reviews,1,0,1
595030,0,8 user reviews,2,6,8
595060,7,Positive,22,4,26
595070,0,5 user reviews,3,2,5
595080,7,Positive,14,2,16
595090,5,Mixed,23,12,35
595100,6,Mostly Positive,32,10,42
595110,6,Mostly Positive,142,46,188
595120,5,Mixed,52,27,79
595130,0,8 user reviews,8,0,8
595140,8,Very Positive,780,69,849
595150,0,2 user reviews,1,1,2
595160,0,7 user reviews,1,6,7
595200,7,Positive,23,4,27
595230,7,Positive,20,0,20
595260,5,Mixed,7,4,11
595270,7,Positive,10,0,10
595280,8,Very Positive,1413,312,1725
595290,7,Positive,40,7,47
595300,5,Mixed,9,5,14
595320,2,Very Negative,9,58,67
595330,0,6 user reviews,6,0,6
595331,0,4 user reviews,4,0,4
595332,0,7 user reviews,7,0,7
595333,0,7 user reviews,7,0,7
595360,5,Mixed,13,10,23
595370,0,1 user reviews,1,0,1
595420,5,Mixed,70,45,115
595430,8,Very Positive,227,10,237
595440,8,Very Positive,92,15,107
595460,8,Very Positive,111,26,137
595470,0,1 user reviews,0,1,1
595520,8,Very Positive,1834,233,2067
595550,5,Mixed,23,14,37
595560,7,Positive,36,1,37
595630,0,1 user reviews,0,1,1
595640,0,7 user reviews,5,2,7
595660,6,Mostly Positive,16,6,22
595680,0,1 user reviews,1,0,1
595690,6,Mostly Positive,1035,309,1344
595730,8,Very Positive,58,8,66
595740,8,Very Positive,76,17,93
595770,5,Mixed,58,32,90
595780,0,2 user reviews,1,1,2
595790,8,Very Positive,97,7,104
595830,0,1 user reviews,1,0,1
595920,0,9 user reviews,5,4,9
595930,6,Mostly Positive,26,11,37
595940,0,5 user reviews,4,1,5
595960,8,Very Positive,69,13,82
595970,0,1 user reviews,0,1,1
595990,0,3 user reviews,2,1,3
596000,7,Positive,37,6,43
596010,0,2 user reviews,2,0,2
596020,3,Negative,3,15,18
596070,0,5 user reviews,1,4,5
596080,7,Positive,10,2,12
596140,5,Mixed,9,4,13
596190,4,Mostly Negative,18,63,81
596200,7,Positive,13,3,16
596231,0,1 user reviews,1,0,1
596240,5,Mixed,35,40,75
596260,0,2 user reviews,2,0,2
596270,0,3 user reviews,2,1,3
596280,4,Mostly Negative,5,20,25
596290,0,1 user reviews,1,0,1
596370,0,8 user reviews,8,0,8
596380,5,Mixed,16,13,29
596390,0,9 user reviews,9,0,9
596400,0,2 user reviews,2,0,2
596460,0,1 user reviews,0,1,1
596470,0,8 user reviews,7,1,8
596520,0,1 user reviews,1,0,1
596530,0,3 user reviews,3,0,3
596540,5,Mixed,16,12,28
596560,6,Mostly Positive,17,6,23
596590,0,3 user reviews,3,0,3
596620,7,Positive,20,3,23
596630,7,Positive,13,1,14
596640,5,Mixed,11,9,20
596710,0,1 user reviews,1,0,1
596730,0,1 user reviews,0,1,1
596740,5,Mixed,10,7,17
596760,0,3 user reviews,0,3,3
596810,0,9 user reviews,9,0,9
596870,6,Mostly Positive,16,6,22
596890,7,Positive,21,2,23
596910,7,Positive,34,5,39
596950,6,Mostly Positive,21,7,28
596960,0,8 user reviews,5,3,8
596970,8,Very Positive,1118,207,1325
596990,0,3 user reviews,2,1,3
597020,0,4 user reviews,4,0,4
597030,8,Very Positive,84,14,98
597040,5,Mixed,5,7,12
597071,0,1 user reviews,1,0,1
597074,0,4 user reviews,1,3,4
597075,0,5 user reviews,4,1,5
597076,0,1 user reviews,1,0,1
597090,0,2 user reviews,1,1,2
597120,7,Positive,12,0,12
597150,8,Very Positive,183,18,201
597170,9,Overwhelmingly Positive,4389,111,4500
597190,0,6 user reviews,5,1,6
597200,6,Mostly Positive,12,4,16
597210,4,Mostly Negative,9,15,24
597220,9,Overwhelmingly Positive,4301,92,4393
597230,8,Very Positive,174,10,184
597240,0,7 user reviews,3,4,7
597280,0,1 user reviews,1,0,1
597290,0,1 user reviews,0,1,1
597310,0,2 user reviews,2,0,2
597590,7,Positive,17,2,19
597670,0,2 user reviews,2,0,2
597700,8,Very Positive,121,11,132
597720,5,Mixed,6,4,10
597730,0,9 user reviews,8,1,9
597760,9,Overwhelmingly Positive,529,25,554
597770,5,Mixed,30,20,50
597810,7,Positive,9,1,10
597840,6,Mostly Positive,83,35,118
597860,5,Mixed,9,5,14
597900,0,7 user reviews,5,2,7
597910,0,5 user reviews,4,1,5
597920,5,Mixed,6,9,15
597970,8,Very Positive,124,21,145
597990,0,2 user reviews,1,1,2
598030,0,7 user reviews,1,6,7
598050,0,1 user reviews,1,0,1
598060,8,Very Positive,86,11,97
598070,7,Positive,17,0,17
598090,0,5 user reviews,2,3,5
598180,5,Mixed,19,16,35
598190,8,Very Positive,63,2,65
598240,5,Mixed,10,11,21
598330,8,Very Positive,1400,343,1743
598340,7,Positive,9,2,11
598350,7,Positive,16,2,18
598380,0,2 user reviews,2,0,2
598400,5,Mixed,16,9,25
598440,5,Mixed,37,19,56
598450,5,Mixed,90,55,145
598480,4,Mostly Negative,5,11,16
598490,8,Very Positive,70,9,79
598500,0,7 user reviews,3,4,7
598590,0,1 user reviews,1,0,1
598600,5,Mixed,5,6,11
598610,5,Mixed,9,5,14
598620,0,6 user reviews,3,3,6
598640,7,Positive,24,2,26
598660,5,Mixed,17,10,27
598670,7,Positive,19,1,20
598690,5,Mixed,44,25,69
598700,8,Very Positive,894,96,990
598710,0,4 user reviews,4,0,4
598720,5,Mixed,7,5,12
598730,7,Positive,32,4,36
598740,7,Positive,10,2,12
598810,6,Mostly Positive,299,99,398
598840,0,7 user reviews,7,0,7
598860,6,Mostly Positive,9,3,12
598880,0,7 user reviews,7,0,7
598940,5,Mixed,12,6,18
598960,8,Very Positive,519,87,606
598980,9,Overwhelmingly Positive,1590,51,1641
598990,7,Positive,12,0,12
599000,5,Mixed,21,14,35
599040,5,Mixed,6,6,12
599050,7,Positive,10,0,10
599070,0,2 user reviews,2,0,2
599080,8,Very Positive,939,162,1101
599140,8,Very Positive,4918,1082,6000
599160,7,Positive,17,3,20
599180,0,3 user reviews,2,1,3
599420,0,1 user reviews,1,0,1
599430,0,2 user reviews,2,0,2
599440,0,6 user reviews,4,2,6
599441,0,7 user reviews,6,1,7
599460,6,Mostly Positive,169,45,214
599480,7,Positive,9,1,10
599510,0,5 user reviews,2,3,5
599560,5,Mixed,30,14,44
599590,7,Positive,40,1,41
599600,6,Mostly Positive,11,4,15
599630,0,6 user reviews,4,2,6
599670,0,5 user reviews,3,2,5
599690,0,1 user reviews,1,0,1
599750,6,Mostly Positive,254,91,345
599800,0,1 user reviews,1,0,1
599810,0,4 user reviews,3,1,4
599840,7,Positive,26,0,26
599880,0,6 user reviews,2,4,6
599890,0,1 user reviews,1,0,1
599900,5,Mixed,13,8,21
599960,6,Mostly Positive,107,42,149
599990,0,8 user reviews,3,5,8
600000,0,5 user reviews,4,1,5
600030,0,1 user reviews,1,0,1
600090,8,Very Positive,63,13,76
600100,0,6 user reviews,3,3,6
600130,8,Very Positive,328,24,352
600150,5,Mixed,13,6,19
600170,0,6 user reviews,6,0,6
600190,0,6 user reviews,3,3,6
600210,0,7 user reviews,4,3,7
600250,0,8 user reviews,7,1,8
600280,5,Mixed,32,18,50
600310,0,2 user reviews,2,0,2
600320,0,1 user reviews,1,0,1
600330,0,7 user reviews,6,1,7
600350,0,3 user reviews,1,2,3
600370,9,Overwhelmingly Positive,591,16,607
600420,7,Positive,24,4,28
600430,0,5 user reviews,4,1,5
600460,6,Mostly Positive,129,40,169
600480,8,Very Positive,929,65,994
600500,0,1 user reviews,1,0,1
600520,0,4 user reviews,4,0,4
600530,0,6 user reviews,4,2,6
600550,4,Mostly Negative,5,10,15
600580,0,1 user reviews,1,0,1
600600,6,Mostly Positive,10,3,13
600630,5,Mixed,13,14,27
600640,0,3 user reviews,3,0,3
600650,7,Positive,16,1,17
600660,7,Positive,16,0,16
600670,0,4 user reviews,2,2,4
600690,0,2 user reviews,2,0,2
600720,5,Mixed,68,37,105
600740,5,Mixed,10,9,19
600750,0,2 user reviews,1,1,2
600980,0,4 user reviews,2,2,4
600990,8,Very Positive,446,33,479
601010,5,Mixed,34,22,56
601020,4,Mostly Negative,4,7,11
601050,8,Very Positive,595,79,674
601110,0,3 user reviews,1,2,3
601120,0,4 user reviews,4,0,4
601130,0,3 user reviews,3,0,3
601150,8,Very Positive,8114,739,8853
601170,0,9 user reviews,5,4,9
601180,0,8 user reviews,5,3,8
601200,0,2 user reviews,1,1,2
601220,8,Very Positive,217,8,225
601240,0,5 user reviews,4,1,5
601250,0,4 user reviews,4,0,4
601270,7,Positive,21,2,23
601320,0,3 user reviews,2,1,3
601340,0,5 user reviews,1,4,5
601380,3,Negative,6,26,32
601390,0,1 user reviews,1,0,1
601400,6,Mostly Positive,13,4,17
601420,0,6 user reviews,5,1,6
601430,8,Very Positive,2560,278,2838
601490,5,Mixed,7,6,13
601500,0,9 user reviews,6,3,9
601530,8,Very Positive,186,23,209
601540,5,Mixed,178,121,299
601550,0,3 user reviews,0,3,3
601570,6,Mostly Positive,8,3,11
601590,0,6 user reviews,4,2,6
601620,0,6 user reviews,1,5,6
601640,0,9 user reviews,4,5,9
601670,5,Mixed,209,108,317
601690,0,6 user reviews,4,2,6
601710,7,Positive,14,0,14
601750,5,Mixed,10,10,20
601760,0,1 user reviews,0,1,1
601770,8,Very Positive,221,42,263
601780,6,Mostly Positive,13,5,18
601790,5,Mixed,8,5,13
601810,8,Very Positive,292,24,316
601840,9,Overwhelmingly Positive,1547,55,1602
601850,0,1 user reviews,1,0,1
601870,6,Mostly Positive,7,3,10
601890,0,9 user reviews,8,1,9
601920,7,Positive,8,2,10
601930,0,6 user reviews,6,0,6
601940,0,1 user reviews,1,0,1
602010,7,Positive,22,4,26
602070,0,2 user reviews,2,0,2
602080,7,Positive,14,0,14
602120,7,Positive,14,0,14
602130,0,8 user reviews,5,3,8
602150,0,1 user reviews,0,1,1
602160,0,5 user reviews,4,1,5
602180,0,2 user reviews,0,2,2
602200,0,5 user reviews,4,1,5
602270,0,2 user reviews,1,1,2
602290,0,1 user reviews,0,1,1
602300,0,7 user reviews,7,0,7
602320,8,Very Positive,539,51,590
602350,0,1 user reviews,0,1,1
602430,7,Positive,37,5,42
602440,0,3 user reviews,3,0,3
602441,0,2 user reviews,2,0,2
602450,7,Positive,10,2,12
602460,0,4 user reviews,4,0,4
602461,0,5 user reviews,3,2,5
602470,0,2 user reviews,2,0,2
602471,5,Mixed,8,4,12
602472,0,6 user reviews,6,0,6
602480,7,Positive,34,7,41
602510,5,Mixed,27,16,43
602520,9,Overwhelmingly Positive,1579,37,1616
602540,0,5 user reviews,2,3,5
602550,0,3 user reviews,3,0,3
602580,0,1 user reviews,1,0,1
602581,0,1 user reviews,1,0,1
602582,0,1 user reviews,0,1,1
602584,0,5 user reviews,3,2,5
602590,7,Positive,8,2,10
602620,0,4 user reviews,3,1,4
602621,0,2 user reviews,1,1,2
602622,0,6 user reviews,4,2,6
602623,7,Positive,12,1,13
602630,7,Positive,15,1,16
602700,8,Very Positive,280,26,306
602720,0,3 user reviews,3,0,3
602730,0,7 user reviews,6,1,7
602770,6,Mostly Positive,111,33,144
602790,0,3 user reviews,2,1,3
602800,0,3 user reviews,1,2,3
602801,0,4 user reviews,3,1,4
602810,0,4 user reviews,2,2,4
602811,0,2 user reviews,2,0,2
602812,0,3 user reviews,1,2,3
602813,0,2 user reviews,2,0,2
602816,0,1 user reviews,1,0,1
602818,0,5 user reviews,3,2,5
602819,0,5 user reviews,4,1,5
602830,5,Mixed,7,5,12
602860,7,Positive,13,0,13
602880,0,3 user reviews,3,0,3
602890,5,Mixed,43,48,91
602910,5,Mixed,9,6,15
602920,0,1 user reviews,1,0,1
602930,5,Mixed,4,6,10
602960,8,Very Positive,3104,318,3422
602970,0,1 user reviews,1,0,1
603000,0,1 user reviews,1,0,1
603010,7,Positive,18,3,21
603020,6,Mostly Positive,111,34,145
603030,5,Mixed,13,8,21
603060,7,Positive,10,2,12
603090,0,9 user reviews,5,4,9
603100,6,Mostly Positive,47,18,65
603110,0,7 user reviews,6,1,7
603120,5,Mixed,21,29,50
603130,6,Mostly Positive,37,10,47
603150,4,Mostly Negative,6,12,18
603190,6,Mostly Positive,49,17,66
603210,0,5 user reviews,2,3,5
603220,0,3 user reviews,3,0,3
603230,7,Positive,14,1,15
603250,0,7 user reviews,3,4,7
603260,8,Very Positive,252,30,282
603280,7,Positive,11,1,12
603320,6,Mostly Positive,77,27,104
603330,7,Positive,31,4,35
603340,0,1 user reviews,1,0,1
603350,6,Mostly Positive,51,16,67
603360,4,Mostly Negative,5,17,22
603380,5,Mixed,12,6,18
603390,8,Very Positive,104,6,110
603400,5,Mixed,29,17,46
603420,5,Mixed,7,5,12
603450,0,1 user reviews,1,0,1
603460,0,4 user reviews,3,1,4
603490,0,2 user reviews,0,2,2
603510,7,Positive,9,1,10
603530,8,Very Positive,374,40,414
603550,0,3 user reviews,1,2,3
603610,0,1 user reviews,1,0,1
603700,6,Mostly Positive,60,18,78
603730,5,Mixed,29,14,43
603750,3,Negative,5,25,30
603760,0,7 user reviews,7,0,7
603790,5,Mixed,10,6,16
603800,8,Very Positive,55,10,65
603810,8,Very Positive,48,11,59
603840,0,2 user reviews,2,0,2
603850,8,Very Positive,2346,566,2912
603870,7,Positive,14,1,15
603910,0,2 user reviews,1,1,2
603930,5,Mixed,22,10,32
603940,8,Very Positive,98,23,121
603960,9,Overwhelmingly Positive,820,11,831
603970,0,1 user reviews,0,1,1
603990,0,2 user reviews,1,1,2
604000,7,Positive,38,3,41
604010,7,Positive,17,3,20
604040,0,5 user reviews,2,3,5
604060,0,3 user reviews,2,1,3
604070,5,Mixed,6,4,10
604090,0,1 user reviews,0,1,1
604110,0,6 user reviews,4,2,6
604140,5,Mixed,7,4,11
604150,0,3 user reviews,2,1,3
604170,7,Positive,13,2,15
604200,0,7 user reviews,3,4,7
604240,9,Overwhelmingly Positive,4397,182,4579
604280,0,1 user reviews,1,0,1
604290,0,3 user reviews,3,0,3
604300,7,Positive,18,3,21
604330,8,Very Positive,227,7,234
604340,0,2 user reviews,2,0,2
604380,0,1 user reviews,1,0,1
604450,8,Very Positive,198,32,230
604490,6,Mostly Positive,388,134,522
604510,7,Positive,29,1,30
604550,0,1 user reviews,0,1,1
604600,0,1 user reviews,0,1,1
604601,0,1 user reviews,0,1,1
604602,0,1 user reviews,0,1,1
604610,0,1 user reviews,0,1,1
604630,0,4 user reviews,3,1,4
604640,0,2 user reviews,1,1,2
604740,5,Mixed,80,37,117
604770,0,7 user reviews,7,0,7
604780,6,Mostly Positive,120,35,155
604830,0,8 user reviews,4,4,8
604900,0,6 user reviews,6,0,6
604920,0,9 user reviews,9,0,9
604980,0,5 user reviews,5,0,5
604990,0,1 user reviews,1,0,1
605040,0,1 user reviews,0,1,1
605100,5,Mixed,8,9,17
605110,0,4 user reviews,1,3,4
605140,5,Mixed,13,11,24
605160,0,5 user reviews,2,3,5
605180,5,Mixed,21,11,32
605190,7,Positive,16,2,18
605200,0,9 user reviews,6,3,9
605210,0,4 user reviews,3,1,4
605230,8,Very Positive,265,42,307
605250,7,Positive,19,1,20
605270,0,3 user reviews,3,0,3
605280,0,1 user reviews,1,0,1
605310,5,Mixed,15,9,24
605325,0,1 user reviews,1,0,1
605328,0,1 user reviews,1,0,1
605334,0,1 user reviews,0,1,1
605410,0,3 user reviews,1,2,3
605430,0,1 user reviews,1,0,1
605450,8,Very Positive,529,66,595
605490,0,2 user reviews,1,1,2
605540,0,3 user reviews,1,2,3
605550,8,Very Positive,50,8,58
605560,4,Mostly Negative,3,7,10
605740,8,Very Positive,3569,567,4136
605760,5,Mixed,17,22,39
605770,7,Positive,44,4,48
605780,0,2 user reviews,0,2,2
605790,0,4 user reviews,4,0,4
605800,5,Mixed,15,8,23
605830,8,Very Positive,130,16,146
605860,0,3 user reviews,0,3,3
605920,7,Positive,27,6,33
605930,0,2 user reviews,2,0,2
605990,8,Very Positive,72,1,73
606000,6,Mostly Positive,17,5,22
606030,0,4 user reviews,2,2,4
606060,0,5 user reviews,1,4,5
606080,5,Mixed,9,6,15
606100,0,1 user reviews,1,0,1
606140,0,1 user reviews,0,1,1
606150,8,Very Positive,2677,555,3232
606190,0,6 user reviews,5,1,6
606230,6,Mostly Positive,605,168,773
606270,0,3 user reviews,1,2,3
606280,6,Mostly Positive,2051,618,2669
606300,0,3 user reviews,2,1,3
606320,0,1 user reviews,0,1,1
606321,0,2 user reviews,1,1,2
606330,8,Very Positive,47,8,55
606360,0,7 user reviews,5,2,7
606370,6,Mostly Positive,47,14,61
606400,0,1 user reviews,1,0,1
606440,0,5 user reviews,3,2,5
606441,0,1 user reviews,1,0,1
606460,0,2 user reviews,2,0,2
606480,7,Positive,37,5,42
606490,7,Positive,29,6,35
606500,6,Mostly Positive,463,116,579
606510,8,Very Positive,51,10,61
606520,7,Positive,11,1,12
606540,0,1 user reviews,1,0,1
606580,0,1 user reviews,1,0,1
606600,0,1 user reviews,0,1,1
606649,0,2 user reviews,1,1,2
606680,8,Very Positive,130,7,137
606690,7,Positive,19,3,22
606710,8,Very Positive,213,18,231
606720,0,1 user reviews,1,0,1
606730,5,Mixed,59,38,97
606790,0,4 user reviews,3,1,4
606800,6,Mostly Positive,1547,387,1934
606850,0,2 user reviews,2,0,2
606860,5,Mixed,77,48,125
606870,7,Positive,12,2,14
606880,6,Mostly Positive,4468,1120,5588
606890,6,Mostly Positive,47,15,62
606920,8,Very Positive,65,1,66
606940,7,Positive,13,2,15
606950,0,9 user reviews,5,4,9
606960,5,Mixed,36,42,78
606971,7,Positive,18,2,20
607020,0,6 user reviews,4,2,6
607030,0,7 user reviews,3,4,7
607040,5,Mixed,6,5,11
607050,8,Very Positive,1464,254,1718
607090,0,3 user reviews,3,0,3
607120,5,Mixed,23,11,34
607160,0,2 user reviews,2,0,2
607190,0,2 user reviews,1,1,2
607200,0,1 user reviews,1,0,1
607210,5,Mixed,6,6,12
607250,0,2 user reviews,1,1,2
607270,0,6 user reviews,4,2,6
607330,7,Positive,13,0,13
607350,0,2 user reviews,0,2,2
607360,0,5 user reviews,4,1,5
607380,8,Very Positive,48,3,51
607400,8,Very Positive,72,6,78
607440,0,3 user reviews,1,2,3
607490,0,7 user reviews,7,0,7
607560,0,9 user reviews,9,0,9
607590,0,7 user reviews,6,1,7
607600,0,2 user reviews,2,0,2
607660,5,Mixed,14,8,22
607670,0,5 user reviews,3,2,5
607680,0,5 user reviews,3,2,5
607690,0,4 user reviews,0,4,4
607720,0,6 user reviews,4,2,6
607760,0,9 user reviews,8,1,9
607770,0,2 user reviews,2,0,2
607780,0,3 user reviews,3,0,3
607820,8,Very Positive,49,5,54
607830,0,3 user reviews,2,1,3
607840,0,3 user reviews,3,0,3
607880,6,Mostly Positive,168,57,225
607890,6,Mostly Positive,759,268,1027
607980,0,1 user reviews,1,0,1
608110,7,Positive,14,0,14
608120,8,Very Positive,102,13,115
608160,0,6 user reviews,6,0,6
608170,0,2 user reviews,2,0,2
608180,0,4 user reviews,4,0,4
608190,5,Mixed,5,5,10
608230,0,1 user reviews,1,0,1
608241,0,1 user reviews,0,1,1
608250,0,3 user reviews,3,0,3
608255,0,1 user reviews,1,0,1
608261,0,2 user reviews,2,0,2
608270,0,6 user reviews,5,1,6
608271,0,1 user reviews,1,0,1
608280,0,1 user reviews,1,0,1
608287,0,3 user reviews,3,0,3
608294,0,3 user reviews,2,1,3
608300,0,1 user reviews,1,0,1
608330,0,1 user reviews,1,0,1
608370,6,Mostly Positive,28,12,40
608420,0,3 user reviews,3,0,3
608450,0,2 user reviews,2,0,2
608460,7,Positive,11,2,13
608530,5,Mixed,41,60,101
608540,0,5 user reviews,2,3,5
608580,5,Mixed,5,7,12
608630,0,1 user reviews,1,0,1
608660,7,Positive,26,4,30
608670,7,Positive,10,0,10
608680,5,Mixed,17,22,39
608720,0,2 user reviews,2,0,2
608730,0,1 user reviews,0,1,1
608760,7,Positive,18,2,20
608800,6,Mostly Positive,275,76,351
608830,3,Negative,3,13,16
608870,7,Positive,24,3,27
608880,0,3 user reviews,3,0,3
608890,0,4 user reviews,4,0,4
608891,0,1 user reviews,1,0,1
608892,0,1 user reviews,1,0,1
608893,0,1 user reviews,1,0,1
608894,0,2 user reviews,2,0,2
608895,0,1 user reviews,1,0,1
608901,0,1 user reviews,1,0,1
608990,5,Mixed,100,87,187
609010,7,Positive,8,2,10
609020,0,3 user reviews,2,1,3
609100,0,6 user reviews,2,4,6
609110,8,Very Positive,209,19,228
609120,0,3 user reviews,3,0,3
609150,6,Mostly Positive,379,162,541
609170,5,Mixed,9,9,18
609200,0,1 user reviews,1,0,1
609260,0,1 user reviews,1,0,1
609320,8,Very Positive,3053,245,3298
609340,0,1 user reviews,1,0,1
609410,6,Mostly Positive,22,8,30
609420,7,Positive,32,1,33
609440,0,5 user reviews,5,0,5
609490,8,Very Positive,537,46,583
609720,0,3 user reviews,2,1,3
609760,7,Positive,21,3,24
609800,4,Mostly Negative,11,22,33
609820,0,3 user reviews,2,1,3
609821,5,Mixed,16,17,33
609822,0,4 user reviews,4,0,4
609823,0,3 user reviews,0,3,3
609824,0,4 user reviews,3,1,4
609826,5,Mixed,12,10,22
609827,0,5 user reviews,3,2,5
609828,0,4 user reviews,2,2,4
609829,0,4 user reviews,3,1,4
609850,7,Positive,12,1,13
609880,0,7 user reviews,6,1,7
609920,6,Mostly Positive,147,48,195
609970,7,Positive,21,4,25
609990,0,6 user reviews,6,0,6
610010,0,2 user reviews,1,1,2
610070,0,6 user reviews,5,1,6
610090,0,5 user reviews,5,0,5
610110,0,2 user reviews,2,0,2
610120,5,Mixed,6,5,11
610130,6,Mostly Positive,31,12,43
610160,5,Mixed,40,32,72
610180,8,Very Positive,684,59,743
610190,8,Very Positive,107,25,132
610210,5,Mixed,7,10,17
610220,7,Positive,17,0,17
610221,0,2 user reviews,2,0,2
610222,0,5 user reviews,5,0,5
610250,7,Positive,14,0,14
610260,0,2 user reviews,0,2,2
610270,0,1 user reviews,1,0,1
610280,0,5 user reviews,5,0,5
610290,0,4 user reviews,2,2,4
610310,7,Positive,23,3,26
610340,0,6 user reviews,4,2,6
610350,4,Mostly Negative,7,13,20
610360,8,Very Positive,401,33,434
610370,9,Overwhelmingly Positive,1163,36,1199
610380,5,Mixed,33,40,73
610400,7,Positive,39,4,43
610410,7,Positive,19,1,20
610460,0,1 user reviews,1,0,1
610490,0,4 user reviews,3,1,4
610500,5,Mixed,58,28,86
610520,7,Positive,10,1,11
610530,0,1 user reviews,1,0,1
610550,0,1 user reviews,1,0,1
610560,0,3 user reviews,2,1,3
610570,5,Mixed,11,12,23
610610,7,Positive,16,2,18
610640,0,1 user reviews,1,0,1
610660,7,Positive,10,2,12
610670,4,Mostly Negative,6,19,25
610680,5,Mixed,25,27,52
610690,0,2 user reviews,2,0,2
610692,0,4 user reviews,4,0,4
610693,7,Positive,12,1,13
610694,0,1 user reviews,1,0,1
610695,0,5 user reviews,3,2,5
610697,0,1 user reviews,0,1,1
610698,0,4 user reviews,4,0,4
610699,0,8 user reviews,6,2,8
610700,0,9 user reviews,5,4,9
610701,0,7 user reviews,4,3,7
610702,0,2 user reviews,2,0,2
610703,5,Mixed,16,10,26
610704,5,Mixed,6,5,11
610705,0,7 user reviews,6,1,7
610730,0,7 user reviews,5,2,7
610740,5,Mixed,9,4,13
610750,6,Mostly Positive,66,21,87
610780,0,7 user reviews,2,5,7
610810,5,Mixed,134,72,206
610840,6,Mostly Positive,25,8,33
610860,5,Mixed,29,26,55
610900,7,Positive,48,0,48
610910,0,2 user reviews,2,0,2
610960,7,Positive,17,1,18
610970,0,3 user reviews,3,0,3
610980,0,7 user reviews,7,0,7
611040,6,Mostly Positive,149,62,211
611050,0,4 user reviews,2,2,4
611060,6,Mostly Positive,9,3,12
611110,5,Mixed,5,6,11
611140,0,8 user reviews,4,4,8
611160,8,Very Positive,380,43,423
611180,5,Mixed,36,37,73
611230,7,Positive,33,8,41
611260,0,1 user reviews,1,0,1
611320,7,Positive,14,3,17
611350,5,Mixed,30,19,49
611370,7,Positive,13,1,14
611390,0,6 user reviews,6,0,6
611400,7,Positive,12,3,15
611420,5,Mixed,9,5,14
611421,7,Positive,27,6,33
611430,0,1 user reviews,1,0,1
611500,6,Mostly Positive,2584,943,3527
611550,0,2 user reviews,2,0,2
611620,5,Mixed,7,5,12
611630,7,Positive,16,3,19
611640,7,Positive,21,3,24
611660,5,Mixed,1742,864,2606
611670,6,Mostly Positive,2422,724,3146
611690,0,6 user reviews,2,4,6
611710,7,Positive,14,0,14
611720,7,Positive,20,3,23
611730,0,3 user reviews,2,1,3
611740,0,5 user reviews,5,0,5
611750,5,Mixed,56,50,106
611760,9,Overwhelmingly Positive,568,6,574
611770,7,Positive,15,3,18
611780,5,Mixed,14,9,23
611790,8,Very Positive,2684,358,3042
611800,5,Mixed,113,76,189
611810,0,6 user reviews,2,4,6
611830,7,Positive,36,4,40
611850,7,Positive,12,1,13
611860,6,Mostly Positive,10,4,14
611960,0,7 user reviews,5,2,7
611970,0,2 user reviews,0,2,2
611980,8,Very Positive,124,17,141
612010,0,3 user reviews,1,2,3
612030,0,8 user reviews,5,3,8
612060,0,5 user reviews,4,1,5
612070,6,Mostly Positive,267,97,364
612100,8,Very Positive,67,8,75
612110,6,Mostly Positive,84,33,117
612120,5,Mixed,7,5,12
612140,7,Positive,12,1,13
612150,0,6 user reviews,3,3,6
612160,0,5 user reviews,5,0,5
612170,0,9 user reviews,5,4,9
612190,0,9 user reviews,5,4,9
612210,0,8 user reviews,8,0,8
612220,0,5 user reviews,1,4,5
612250,0,8 user reviews,2,6,8
612260,0,1 user reviews,1,0,1
612261,5,Mixed,7,4,11
612300,8,Very Positive,49,11,60
612310,0,8 user reviews,7,1,8
612320,0,2 user reviews,1,1,2
612330,0,1 user reviews,1,0,1
612370,8,Very Positive,169,8,177
612380,0,2 user reviews,1,1,2
612390,8,Very Positive,149,29,178
612470,8,Very Positive,426,72,498
612480,7,Positive,31,1,32
612491,0,3 user reviews,3,0,3
612510,0,5 user reviews,1,4,5
612520,7,Positive,40,7,47
612540,5,Mixed,24,12,36
612570,6,Mostly Positive,189,55,244
612600,7,Positive,12,0,12
612630,0,9 user reviews,4,5,9
612631,0,6 user reviews,4,2,6
612640,7,Positive,18,1,19
612650,0,1 user reviews,1,0,1
612670,7,Positive,14,0,14
612720,6,Mostly Positive,274,79,353
612740,6,Mostly Positive,35,14,49
612810,5,Mixed,8,9,17
612820,7,Positive,16,4,20
612840,0,9 user reviews,8,1,9
612870,0,1 user reviews,1,0,1
612880,6,Mostly Positive,5965,2330,8295
612890,0,6 user reviews,6,0,6
612900,6,Mostly Positive,115,38,153
612930,8,Very Positive,255,48,303
612960,5,Mixed,10,12,22
613010,0,6 user reviews,4,2,6
613020,0,3 user reviews,3,0,3
613040,0,5 user reviews,3,2,5
613100,8,Very Positive,13469,1541,15010
613120,0,6 user reviews,5,1,6
613130,7,Positive,12,0,12
613140,0,4 user reviews,3,1,4
613170,0,4 user reviews,3,1,4
613190,8,Very Positive,178,38,216
613200,7,Positive,9,1,10
613210,0,3 user reviews,3,0,3
613230,0,5 user reviews,2,3,5
613240,7,Positive,35,0,35
613250,0,2 user reviews,1,1,2
613260,7,Positive,14,2,16
613270,5,Mixed,49,45,94
613330,5,Mixed,4,6,10
613350,0,1 user reviews,1,0,1
613390,8,Very Positive,123,10,133
613400,0,3 user reviews,2,1,3
613410,4,Mostly Negative,3,7,10
613420,7,Positive,11,1,12
613430,0,2 user reviews,1,1,2
613450,8,Very Positive,84,6,90
613470,8,Very Positive,70,7,77
613520,0,2 user reviews,2,0,2
613580,0,4 user reviews,2,2,4
613590,0,2 user reviews,2,0,2
613610,0,3 user reviews,3,0,3
613620,0,2 user reviews,2,0,2
613660,0,1 user reviews,1,0,1
613670,0,2 user reviews,1,1,2
613730,6,Mostly Positive,116,49,165
613790,7,Positive,15,3,18
613830,8,Very Positive,1578,323,1901
613850,0,5 user reviews,2,3,5
613860,5,Mixed,11,11,22
613880,5,Mixed,178,164,342
613900,7,Positive,35,1,36
613970,0,6 user reviews,0,6,6
613980,0,5 user reviews,4,1,5
614001,0,1 user reviews,1,0,1
614002,0,1 user reviews,1,0,1
614003,0,1 user reviews,1,0,1
614004,5,Mixed,11,15,26
614005,4,Mostly Negative,3,11,14
614006,0,5 user reviews,3,2,5
614007,0,9 user reviews,4,5,9
614020,0,1 user reviews,1,0,1
614030,5,Mixed,34,17,51
614050,0,4 user reviews,0,4,4
614080,0,1 user reviews,1,0,1
614090,0,4 user reviews,3,1,4
614130,7,Positive,15,2,17
614140,0,7 user reviews,4,3,7
614150,0,5 user reviews,5,0,5
614160,0,2 user reviews,1,1,2
614180,0,3 user reviews,3,0,3
614200,0,1 user reviews,1,0,1
614260,5,Mixed,21,15,36
614380,0,1 user reviews,0,1,1
614450,0,7 user reviews,2,5,7
614460,0,1 user reviews,1,0,1
614530,0,5 user reviews,2,3,5
614550,0,1 user reviews,1,0,1
614560,0,9 user reviews,3,6,9
614570,8,Very Positive,1705,320,2025
614580,6,Mostly Positive,113,38,151
614581,5,Mixed,55,48,103
614582,6,Mostly Positive,26,8,34
614630,6,Mostly Positive,129,53,182
614650,0,1 user reviews,1,0,1
614660,0,9 user reviews,5,4,9
614700,0,3 user reviews,3,0,3
614770,4,Mostly Negative,3,10,13
614830,7,Positive,20,1,21
614850,0,2 user reviews,0,2,2
614860,6,Mostly Positive,28,11,39
614880,0,2 user reviews,0,2,2
614890,6,Mostly Positive,13,4,17
614900,6,Mostly Positive,10,4,14
614910,8,Very Positive,118,23,141
614950,8,Very Positive,59,12,71
614960,0,9 user reviews,7,2,9
614970,5,Mixed,20,16,36
615010,8,Very Positive,62,8,70
615020,7,Positive,23,3,26
615070,0,2 user reviews,1,1,2
615080,0,4 user reviews,4,0,4
615090,7,Positive,20,3,23
615120,9,Overwhelmingly Positive,501,13,514
615150,0,9 user reviews,8,1,9
615160,0,2 user reviews,1,1,2
615180,5,Mixed,27,13,40
615200,0,1 user reviews,1,0,1
615250,7,Positive,30,2,32
615270,7,Positive,9,1,10
615330,7,Positive,16,2,18
615350,8,Very Positive,52,7,59
615380,7,Positive,16,3,19
615390,0,2 user reviews,0,2,2
615420,0,2 user reviews,2,0,2
615490,0,6 user reviews,4,2,6
615540,0,9 user reviews,9,0,9
615550,0,5 user reviews,4,1,5
615590,0,2 user reviews,2,0,2
615610,9,Overwhelmingly Positive,1101,21,1122
615630,5,Mixed,14,11,25
615670,6,Mostly Positive,28,8,36
615680,0,7 user reviews,3,4,7
615690,0,1 user reviews,1,0,1
615700,0,3 user reviews,3,0,3
615720,0,1 user reviews,1,0,1
615730,7,Positive,31,6,37
615770,6,Mostly Positive,36,12,48
615780,7,Positive,35,8,43
615910,6,Mostly Positive,34,14,48
615930,0,4 user reviews,4,0,4
615970,0,8 user reviews,5,3,8
616000,8,Very Positive,46,5,51
616040,0,3 user reviews,3,0,3
616110,8,Very Positive,1009,117,1126
616130,0,4 user reviews,4,0,4
616150,0,2 user reviews,1,1,2
616160,0,2 user reviews,1,1,2
616170,5,Mixed,15,7,22
616180,0,4 user reviews,3,1,4
616190,7,Positive,13,2,15
616191,6,Mostly Positive,29,9,38
616200,6,Mostly Positive,55,16,71
616210,0,7 user reviews,3,4,7
616240,5,Mixed,20,21,41
616250,9,Overwhelmingly Positive,889,40,929
616290,7,Positive,11,0,11
616350,0,5 user reviews,2,3,5
616370,0,5 user reviews,5,0,5
616490,0,5 user reviews,2,3,5
616500,0,4 user reviews,3,1,4
616520,7,Positive,27,1,28
616530,0,1 user reviews,1,0,1
616550,0,1 user reviews,0,1,1
616560,6,Mostly Positive,2619,1101,3720
616620,6,Mostly Positive,49,13,62
616640,0,3 user reviews,3,0,3
616650,0,1 user reviews,0,1,1
616660,0,9 user reviews,6,3,9
616680,0,2 user reviews,2,0,2
616690,7,Positive,13,3,16
616720,8,Very Positive,106,13,119
616740,0,2 user reviews,2,0,2
616750,0,9 user reviews,6,3,9
616840,0,6 user reviews,6,0,6
616850,6,Mostly Positive,62,19,81
616860,0,1 user reviews,0,1,1
616880,0,9 user reviews,8,1,9
616890,7,Positive,9,2,11
616920,8,Very Positive,58,11,69
616950,7,Positive,26,2,28
616960,0,2 user reviews,1,1,2
616970,0,1 user reviews,1,0,1
616980,0,2 user reviews,1,1,2
616990,0,2 user reviews,0,2,2
617000,0,1 user reviews,0,1,1
617001,0,1 user reviews,0,1,1
617020,0,2 user reviews,0,2,2
617030,5,Mixed,73,64,137
617040,0,9 user reviews,9,0,9
617060,0,6 user reviews,5,1,6
617090,0,7 user reviews,4,3,7
617100,0,4 user reviews,2,2,4
617110,0,3 user reviews,2,1,3
617120,0,4 user reviews,3,1,4
617140,0,6 user reviews,6,0,6
617160,8,Very Positive,288,68,356
617190,0,3 user reviews,3,0,3
617210,0,2 user reviews,1,1,2
617211,0,1 user reviews,1,0,1
617212,0,1 user reviews,1,0,1
617213,0,1 user reviews,1,0,1
617214,0,1 user reviews,1,0,1
617215,0,1 user reviews,1,0,1
617216,0,1 user reviews,1,0,1
617217,0,1 user reviews,1,0,1
617218,0,1 user reviews,1,0,1
617219,0,1 user reviews,1,0,1
617220,0,1 user reviews,1,0,1
617230,0,2 user reviews,1,1,2
617270,0,6 user reviews,6,0,6
617290,8,Very Positive,13567,1995,15562
617360,0,3 user reviews,3,0,3
617370,0,1 user reviews,0,1,1
617420,0,9 user reviews,5,4,9
617430,7,Positive,11,1,12
617440,8,Very Positive,47,3,50
617450,5,Mixed,18,9,27
617480,8,Very Positive,808,131,939
617550,0,4 user reviews,3,1,4
617560,0,1 user reviews,1,0,1
617570,0,6 user reviews,6,0,6
617580,0,4 user reviews,3,1,4
617590,5,Mixed,8,11,19
617610,7,Positive,26,2,28
617620,7,Positive,10,0,10
617630,0,5 user reviews,3,2,5
617640,5,Mixed,51,24,75
617660,0,5 user reviews,3,2,5
617670,9,Overwhelmingly Positive,623,20,643
617680,0,9 user reviews,5,4,9
617690,0,1 user reviews,1,0,1
617700,8,Very Positive,294,55,349
617710,5,Mixed,15,9,24
617750,0,2 user reviews,1,1,2
617820,0,3 user reviews,2,1,3
617830,8,Very Positive,2873,365,3238
617850,5,Mixed,29,15,44
617870,8,Very Positive,827,95,922
617960,4,Mostly Negative,4,7,11
617961,0,1 user reviews,1,0,1
617962,0,7 user reviews,3,4,7
617970,5,Mixed,12,8,20
618010,0,8 user reviews,8,0,8
618050,5,Mixed,11,13,24
618070,0,9 user reviews,8,1,9
618100,6,Mostly Positive,60,22,82
618140,6,Mostly Positive,140,40,180
618180,0,3 user reviews,3,0,3
618190,0,3 user reviews,3,0,3
618200,0,7 user reviews,2,5,7
618210,0,7 user reviews,6,1,7
618260,0,1 user reviews,1,0,1
618270,5,Mixed,7,6,13
618280,0,2 user reviews,1,1,2
618310,0,2 user reviews,1,1,2
618350,7,Positive,21,1,22
618360,7,Positive,17,1,18
618370,7,Positive,12,3,15
618430,0,5 user reviews,3,2,5
618470,7,Positive,24,2,26
618490,0,5 user reviews,2,3,5
618500,6,Mostly Positive,9,3,12
618510,8,Very Positive,111,5,116
618520,0,1 user reviews,0,1,1
618550,8,Very Positive,47,6,53
618570,0,8 user reviews,7,1,8
618590,0,9 user reviews,8,1,9
618610,5,Mixed,54,31,85
618630,0,2 user reviews,2,0,2
618640,5,Mixed,10,7,17
618650,0,3 user reviews,2,1,3
618661,0,3 user reviews,2,1,3
618662,0,4 user reviews,2,2,4
618664,0,1 user reviews,1,0,1
618670,0,7 user reviews,3,4,7
618681,0,1 user reviews,0,1,1
618682,0,2 user reviews,1,1,2
618690,7,Positive,17,1,18
618700,0,5 user reviews,4,1,5
618710,7,Positive,20,0,20
618720,8,Very Positive,294,21,315
618740,8,Very Positive,415,28,443
618750,6,Mostly Positive,20,7,27
618760,5,Mixed,7,4,11
618840,0,3 user reviews,0,3,3
618850,8,Very Positive,137,24,161
618920,8,Very Positive,82,15,97
618950,8,Very Positive,65,6,71
618970,8,Very Positive,154,34,188
618990,0,5 user reviews,4,1,5
619000,0,1 user reviews,0,1,1
619010,5,Mixed,7,6,13
619080,4,Mostly Negative,293,806,1099
619100,0,1 user reviews,1,0,1
619140,0,7 user reviews,1,6,7
619150,8,Very Positive,1731,199,1930
619210,8,Very Positive,79,11,90
619220,0,3 user reviews,3,0,3
619230,5,Mixed,8,4,12
619270,0,2 user reviews,2,0,2
619280,8,Very Positive,192,35,227
619290,8,Very Positive,472,74,546
619320,0,9 user reviews,7,2,9
619330,0,7 user reviews,4,3,7
619340,4,Mostly Negative,3,10,13
619350,5,Mixed,5,5,10
619400,0,4 user reviews,1,3,4
619430,5,Mixed,33,42,75
619470,0,5 user reviews,3,2,5
619480,0,1 user reviews,1,0,1
619490,5,Mixed,28,14,42
619500,8,Very Positive,173,16,189
619510,7,Positive,24,3,27
619580,7,Positive,14,1,15
619583,0,6 user reviews,6,0,6
619584,0,5 user reviews,4,1,5
619585,0,4 user reviews,3,1,4
619586,0,3 user reviews,2,1,3
619620,0,2 user reviews,1,1,2
619630,0,2 user reviews,2,0,2
619680,8,Very Positive,71,2,73
619690,0,1 user reviews,1,0,1
619700,5,Mixed,41,19,60
619710,0,2 user reviews,2,0,2
619711,0,1 user reviews,1,0,1
619720,0,4 user reviews,1,3,4
619740,3,Negative,2,9,11
619780,5,Mixed,381,201,582
619810,7,Positive,16,1,17
619870,8,Very Positive,49,4,53
619880,6,Mostly Positive,215,75,290
619890,0,6 user reviews,4,2,6
619930,7,Positive,10,1,11
619940,7,Positive,12,0,12
620040,0,9 user reviews,5,4,9
620050,5,Mixed,9,6,15
620070,0,1 user reviews,1,0,1
620080,7,Positive,12,2,14
620140,0,3 user reviews,2,1,3
620150,5,Mixed,9,7,16
620170,7,Positive,31,5,36
620190,8,Very Positive,384,87,471
620210,8,Very Positive,128,1,129
620220,8,Very Positive,113,21,134
620280,0,9 user reviews,8,1,9
620310,0,1 user reviews,0,1,1
620320,0,1 user reviews,1,0,1
620321,0,1 user reviews,1,0,1
620322,0,2 user reviews,2,0,2
620323,0,1 user reviews,1,0,1
620324,0,1 user reviews,1,0,1
620325,0,1 user reviews,1,0,1
620326,0,2 user reviews,2,0,2
620330,0,4 user reviews,4,0,4
620340,0,9 user reviews,9,0,9
620350,0,6 user reviews,5,1,6
620360,7,Positive,22,0,22
620370,7,Positive,18,0,18
620381,0,1 user reviews,0,1,1
620470,0,1 user reviews,1,0,1
620490,0,1 user reviews,1,0,1
620570,0,9 user reviews,3,6,9
620580,0,7 user reviews,5,2,7
620590,6,Mostly Positive,931,252,1183
620610,8,Very Positive,276,28,304
620630,0,2 user reviews,1,1,2
620640,0,2 user reviews,1,1,2
620650,7,Positive,37,7,44
620660,0,5 user reviews,5,0,5
620670,7,Positive,10,0,10
620680,0,5 user reviews,4,1,5
620700,5,Mixed,16,7,23
620710,7,Positive,14,2,16
620746,0,7 user reviews,6,1,7
620790,0,1 user reviews,1,0,1
620800,0,9 user reviews,9,0,9
620900,7,Positive,41,2,43
620940,7,Positive,15,1,16
620980,9,Overwhelmingly Positive,28675,1087,29762
621000,6,Mostly Positive,17,6,23
621010,7,Positive,17,0,17
621020,6,Mostly Positive,39,16,55
621050,4,Mostly Negative,5,14,19
621060,8,Very Positive,9371,560,9931
621070,6,Mostly Positive,301,124,425
621080,7,Positive,41,6,47
621090,0,3 user reviews,1,2,3
621140,0,1 user reviews,1,0,1
621150,0,2 user reviews,2,0,2
621170,0,6 user reviews,6,0,6
621210,0,1 user reviews,1,0,1
621220,6,Mostly Positive,309,103,412
621290,0,3 user reviews,1,2,3
621300,0,4 user reviews,4,0,4
621420,0,2 user reviews,2,0,2
621500,4,Mostly Negative,8,14,22
621560,0,1 user reviews,1,0,1
621570,0,5 user reviews,5,0,5
621600,0,6 user reviews,6,0,6
621640,0,4 user reviews,4,0,4
621720,0,2 user reviews,1,1,2
621730,0,1 user reviews,1,0,1
621780,5,Mixed,5,5,10
621810,8,Very Positive,97,15,112
621830,5,Mixed,340,185,525
621840,0,4 user reviews,2,2,4
621850,0,9 user reviews,6,3,9
621870,7,Positive,16,0,16
621920,7,Positive,15,1,16
621921,5,Mixed,8,5,13
621922,0,9 user reviews,7,2,9
621923,6,Mostly Positive,11,3,14
621924,0,2 user reviews,2,0,2
621925,7,Positive,9,1,10
621926,0,6 user reviews,5,1,6
621927,0,3 user reviews,2,1,3
621930,8,Very Positive,115,20,135
621940,6,Mostly Positive,16,6,22
621970,6,Mostly Positive,23,6,29
622010,5,Mixed,20,21,41
622020,0,7 user reviews,4,3,7
622030,0,3 user reviews,2,1,3
622040,5,Mixed,86,61,147
622060,0,5 user reviews,5,0,5
622080,0,2 user reviews,1,1,2
622150,0,2 user reviews,2,0,2
622170,5,Mixed,35,18,53
622200,0,9 user reviews,9,0,9
622220,9,Overwhelmingly Positive,736,36,772
622230,0,7 user reviews,7,0,7
622290,0,1 user reviews,1,0,1
622320,0,7 user reviews,2,5,7
622330,5,Mixed,11,5,16
622350,0,1 user reviews,0,1,1
622352,0,3 user reviews,2,1,3
622353,0,5 user reviews,2,3,5
622354,0,6 user reviews,3,3,6
622355,0,1 user reviews,1,0,1
622357,0,2 user reviews,2,0,2
622360,0,7 user reviews,6,1,7
622370,5,Mixed,31,23,54
622390,0,1 user reviews,1,0,1
622420,5,Mixed,43,40,83
622440,5,Mixed,119,68,187
622450,5,Mixed,66,55,121
622460,6,Mostly Positive,97,29,126
622480,0,5 user reviews,4,1,5
622510,0,1 user reviews,1,0,1
622530,5,Mixed,6,5,11
622540,0,2 user reviews,1,1,2
622550,0,2 user reviews,2,0,2
622610,0,5 user reviews,4,1,5
622620,0,8 user reviews,7,1,8
622650,8,Very Positive,2742,432,3174
622660,8,Very Positive,243,41,284
622661,8,Very Positive,351,51,402
622670,0,4 user reviews,4,0,4
622700,0,9 user reviews,5,4,9
622710,0,9 user reviews,9,0,9
622720,8,Very Positive,413,101,514
622760,0,1 user reviews,1,0,1
622770,5,Mixed,64,34,98
622810,0,5 user reviews,5,0,5
622830,7,Positive,20,2,22
622851,0,2 user reviews,2,0,2
622870,8,Very Positive,95,20,115
622880,0,7 user reviews,4,3,7
622890,0,7 user reviews,5,2,7
622920,5,Mixed,6,4,10
622930,0,4 user reviews,4,0,4
623040,0,4 user reviews,3,1,4
623050,0,1 user reviews,1,0,1
623070,6,Mostly Positive,15,6,21
623080,7,Positive,29,2,31
623090,6,Mostly Positive,80,25,105
623100,0,6 user reviews,3,3,6
623110,0,1 user reviews,1,0,1
623140,0,6 user reviews,5,1,6
623150,5,Mixed,34,17,51
623160,6,Mostly Positive,16,5,21
623170,7,Positive,16,2,18
623180,6,Mostly Positive,11,3,14
623190,0,4 user reviews,4,0,4
623193,0,1 user reviews,1,0,1
623194,0,1 user reviews,1,0,1
623196,0,2 user reviews,2,0,2
623198,0,1 user reviews,1,0,1
623200,0,2 user reviews,2,0,2
623262,0,1 user reviews,1,0,1
623263,0,1 user reviews,1,0,1
623264,0,2 user reviews,2,0,2
623265,0,1 user reviews,1,0,1
623266,0,4 user reviews,2,2,4
623267,0,1 user reviews,1,0,1
623270,0,5 user reviews,5,0,5
623310,5,Mixed,29,13,42
623320,0,3 user reviews,3,0,3
623340,5,Mixed,225,101,326
623360,0,7 user reviews,4,3,7
623370,0,2 user reviews,1,1,2
623380,7,Positive,36,9,45
623460,0,2 user reviews,1,1,2
623470,0,2 user reviews,2,0,2
623530,4,Mostly Negative,4,7,11
623540,8,Very Positive,46,5,51
623550,5,Mixed,8,10,18
623570,5,Mixed,8,5,13
623580,5,Mixed,6,5,11
623611,0,3 user reviews,3,0,3
623613,0,2 user reviews,1,1,2
623616,0,3 user reviews,1,2,3
623619,0,5 user reviews,2,3,5
623640,7,Positive,35,2,37
623670,0,7 user reviews,5,2,7
623700,8,Very Positive,104,11,115
623790,0,1 user reviews,1,0,1
623800,7,Positive,11,0,11
623810,6,Mostly Positive,26,9,35
623820,0,4 user reviews,0,4,4
623860,0,5 user reviews,3,2,5
623880,5,Mixed,118,58,176
623890,0,6 user reviews,6,0,6
623900,0,8 user reviews,4,4,8
623920,5,Mixed,11,12,23
623930,5,Mixed,9,12,21
623940,8,Very Positive,2267,122,2389
624050,0,5 user reviews,5,0,5
624060,0,2 user reviews,1,1,2
624070,0,9 user reviews,7,2,9
624080,0,8 user reviews,8,0,8
624090,5,Mixed,1094,606,1700
624120,5,Mixed,34,26,60
624270,8,Very Positive,780,106,886
624280,0,1 user reviews,1,0,1
624320,7,Positive,27,4,31
624330,0,3 user reviews,2,1,3
624410,0,1 user reviews,0,1,1
624430,5,Mixed,8,6,14
624550,6,Mostly Positive,7,3,10
624560,0,7 user reviews,1,6,7
624610,0,3 user reviews,2,1,3
624620,4,Mostly Negative,27,47,74
624621,4,Mostly Negative,14,28,42
624622,4,Mostly Negative,14,22,36
624630,0,6 user reviews,1,5,6
624680,7,Positive,10,2,12
624690,6,Mostly Positive,30,11,41
624700,0,1 user reviews,1,0,1
624710,0,9 user reviews,8,1,9
624780,0,2 user reviews,1,1,2
624830,7,Positive,21,2,23
624840,0,2 user reviews,2,0,2
624890,6,Mostly Positive,20,8,28
624940,0,2 user reviews,1,1,2
624970,8,Very Positive,304,51,355
624990,0,6 user reviews,6,0,6
625000,7,Positive,12,0,12
625010,7,Positive,15,2,17
625030,0,3 user reviews,2,1,3
625040,0,6 user reviews,3,3,6
625050,5,Mixed,60,81,141
625100,0,1 user reviews,1,0,1
625120,7,Positive,16,4,20
625160,0,3 user reviews,2,1,3
625180,0,7 user reviews,1,6,7
625190,0,7 user reviews,4,3,7
625320,0,6 user reviews,4,2,6
625340,5,Mixed,385,207,592
625350,0,3 user reviews,1,2,3
625370,5,Mixed,13,12,25
625410,0,3 user reviews,3,0,3
625430,0,6 user reviews,3,3,6
625460,0,3 user reviews,3,0,3
625480,0,4 user reviews,4,0,4
625500,0,9 user reviews,8,1,9
625560,0,6 user reviews,5,1,6
625630,0,2 user reviews,2,0,2
625680,8,Very Positive,58,12,70
625690,0,3 user reviews,3,0,3
625700,5,Mixed,6,4,10
625730,6,Mostly Positive,13,5,18
625740,8,Very Positive,71,1,72
625770,7,Positive,14,0,14
625780,7,Positive,31,2,33
625800,0,1 user reviews,1,0,1
625820,7,Positive,15,2,17
625830,7,Positive,14,3,17
625900,0,3 user reviews,3,0,3
625910,6,Mostly Positive,27,8,35
625940,7,Positive,15,0,15
625960,6,Mostly Positive,3284,1109,4393
625970,0,1 user reviews,1,0,1
625980,8,Very Positive,70,4,74
625990,6,Mostly Positive,27,8,35
626020,0,6 user reviews,3,3,6
626130,0,2 user reviews,1,1,2
626160,0,5 user reviews,2,3,5
626170,0,8 user reviews,5,3,8
626180,0,6 user reviews,6,0,6
626200,4,Mostly Negative,12,28,40
626250,5,Mixed,9,4,13
626450,7,Positive,28,2,30
626470,5,Mixed,192,133,325
626491,0,2 user reviews,2,0,2
626510,8,Very Positive,45,10,55
626521,0,5 user reviews,5,0,5
626523,0,2 user reviews,2,0,2
626530,0,1 user reviews,1,0,1
626531,0,1 user reviews,1,0,1
626535,0,1 user reviews,1,0,1
626536,0,3 user reviews,3,0,3
626540,0,2 user reviews,2,0,2
626543,0,1 user reviews,1,0,1
626547,0,1 user reviews,1,0,1
626548,0,1 user reviews,1,0,1
626550,5,Mixed,24,32,56
626560,0,1 user reviews,1,0,1
626561,0,3 user reviews,3,0,3
626562,0,2 user reviews,2,0,2
626570,0,1 user reviews,1,0,1
626580,7,Positive,37,4,41
626600,6,Mostly Positive,62,20,82
626610,6,Mostly Positive,252,101,353
626630,4,Mostly Negative,4,8,12
626640,7,Positive,29,2,31
626660,8,Very Positive,50,5,55
626690,8,Very Positive,2908,582,3490
626730,0,4 user reviews,2,2,4
626760,4,Mostly Negative,3,7,10
626790,7,Positive,11,2,13
626830,0,1 user reviews,0,1,1
626840,0,2 user reviews,2,0,2
626864,0,1 user reviews,1,0,1
627010,0,1 user reviews,1,0,1
627013,0,1 user reviews,1,0,1
627050,0,1 user reviews,1,0,1
627070,7,Positive,26,1,27
627220,5,Mixed,9,4,13
627270,8,Very Positive,1616,363,1979
627310,0,4 user reviews,4,0,4
627350,7,Positive,36,6,42
627370,0,1 user reviews,1,0,1
627390,0,5 user reviews,4,1,5
627410,0,5 user reviews,3,2,5
627420,0,1 user reviews,1,0,1
627430,7,Positive,20,4,24
627440,7,Positive,16,3,19
627450,5,Mixed,15,22,37
627460,0,3 user reviews,0,3,3
627510,8,Very Positive,197,18,215
627570,0,3 user reviews,3,0,3
627580,7,Positive,18,2,20
627582,0,8 user reviews,7,1,8
627620,5,Mixed,38,41,79
627659,0,1 user reviews,1,0,1
627670,0,8 user reviews,8,0,8
627690,7,Positive,15,3,18
627771,0,1 user reviews,1,0,1
627820,5,Mixed,42,27,69
627880,0,1 user reviews,0,1,1
627890,7,Positive,9,1,10
627910,5,Mixed,68,45,113
627950,0,3 user reviews,0,3,3
627980,0,1 user reviews,1,0,1
628000,0,6 user reviews,5,1,6
628009,0,1 user reviews,1,0,1
628020,0,1 user reviews,1,0,1
628030,0,6 user reviews,2,4,6
628040,0,6 user reviews,2,4,6
628050,6,Mostly Positive,14,5,19
628060,5,Mixed,16,11,27
628070,6,Mostly Positive,71,22,93
628080,0,6 user reviews,2,4,6
628110,0,1 user reviews,1,0,1
628120,0,1 user reviews,0,1,1
628130,0,4 user reviews,2,2,4
628140,0,4 user reviews,1,3,4
628150,0,5 user reviews,4,1,5
628160,0,1 user reviews,0,1,1
628170,0,6 user reviews,5,1,6
628180,0,1 user reviews,1,0,1
628290,6,Mostly Positive,72,30,102
628320,7,Positive,20,4,24
628330,4,Mostly Negative,7,11,18
628350,7,Positive,22,5,27
628450,0,4 user reviews,3,1,4
628460,7,Positive,38,2,40
628473,0,1 user reviews,1,0,1
628540,0,7 user reviews,7,0,7
628570,0,7 user reviews,5,2,7
628580,0,5 user reviews,5,0,5
628650,0,2 user reviews,0,2,2
628660,7,Positive,32,6,38
628670,8,Very Positive,631,132,763
628710,6,Mostly Positive,32,12,44
628720,7,Positive,19,4,23
628750,8,Very Positive,118,28,146
628760,7,Positive,18,4,22
628770,8,Very Positive,374,45,419
628800,8,Very Positive,66,3,69
628820,0,6 user reviews,2,4,6
628830,0,4 user reviews,4,0,4
628890,5,Mixed,31,21,52
628900,5,Mixed,54,44,98
628920,8,Very Positive,98,12,110
628940,0,1 user reviews,1,0,1
628950,5,Mixed,57,28,85
628960,0,5 user reviews,5,0,5
629000,8,Very Positive,157,14,171
629020,0,5 user reviews,5,0,5
629021,0,4 user reviews,4,0,4
629030,4,Mostly Negative,14,55,69
629040,6,Mostly Positive,14,5,19
629080,0,4 user reviews,4,0,4
629090,8,Very Positive,170,21,191
629100,0,8 user reviews,8,0,8
629110,7,Positive,17,1,18
629210,0,5 user reviews,1,4,5
629220,6,Mostly Positive,162,49,211
629230,7,Positive,10,2,12
629240,6,Mostly Positive,7,3,10
629330,8,Very Positive,238,4,242
629340,0,7 user reviews,7,0,7
629360,0,3 user reviews,1,2,3
629380,0,1 user reviews,1,0,1
629400,0,1 user reviews,1,0,1
629410,0,7 user reviews,6,1,7
629420,0,3 user reviews,3,0,3
629430,7,Positive,32,1,33
629440,8,Very Positive,61,0,61
629520,9,Overwhelmingly Positive,4780,136,4916
629540,6,Mostly Positive,28,8,36
629550,0,1 user reviews,1,0,1
629580,0,7 user reviews,2,5,7
629640,0,7 user reviews,2,5,7
629650,7,Positive,41,8,49
629690,8,Very Positive,311,37,348
629700,7,Positive,14,0,14
629730,8,Very Positive,9605,592,10197
629751,0,6 user reviews,3,3,6
629760,8,Very Positive,36407,6756,43163
629770,8,Very Positive,100,7,107
629780,0,2 user reviews,1,1,2
629810,0,3 user reviews,3,0,3
629830,0,3 user reviews,3,0,3
629840,5,Mixed,238,130,368
629860,7,Positive,20,4,24
629910,5,Mixed,501,297,798
629930,0,5 user reviews,4,1,5
629940,0,8 user reviews,8,0,8
629960,6,Mostly Positive,17,6,23
629970,0,8 user reviews,7,1,8
629990,5,Mixed,6,6,12
630010,6,Mostly Positive,39,12,51
630020,6,Mostly Positive,7,3,10
630030,6,Mostly Positive,85,30,115
630050,6,Mostly Positive,13,5,18
630060,7,Positive,26,2,28
630070,0,7 user reviews,6,1,7
630080,0,8 user reviews,8,0,8
630160,0,9 user reviews,8,1,9
630170,0,4 user reviews,3,1,4
630190,0,3 user reviews,1,2,3
630240,0,1 user reviews,1,0,1
630260,0,6 user reviews,6,0,6
630280,0,7 user reviews,7,0,7
630290,0,1 user reviews,1,0,1
630310,6,Mostly Positive,146,38,184
630360,5,Mixed,6,7,13
630400,0,8 user reviews,7,1,8
630430,0,3 user reviews,2,1,3
630460,7,Positive,26,0,26
630470,0,5 user reviews,4,1,5
630490,4,Mostly Negative,14,27,41
630500,0,6 user reviews,6,0,6
630550,7,Positive,38,5,43
630610,8,Very Positive,120,17,137
630630,7,Positive,24,6,30
630640,7,Positive,47,0,47
630663,0,2 user reviews,1,1,2
630670,0,6 user reviews,3,3,6
630690,5,Mixed,5,6,11
630720,8,Very Positive,126,27,153
630790,0,1 user reviews,1,0,1
630830,7,Positive,23,1,24
630850,0,9 user reviews,2,7,9
630870,7,Positive,13,0,13
630890,0,7 user reviews,4,3,7
630900,8,Very Positive,226,16,242
630910,6,Mostly Positive,11,3,14
630911,0,7 user reviews,7,0,7
630912,0,5 user reviews,3,2,5
630913,0,1 user reviews,1,0,1
630914,0,1 user reviews,0,1,1
630916,0,8 user reviews,5,3,8
630917,0,7 user reviews,7,0,7
630918,0,9 user reviews,7,2,9
630919,0,1 user reviews,1,0,1
630940,5,Mixed,148,124,272
630970,0,1 user reviews,0,1,1
631120,0,4 user reviews,4,0,4
631240,0,3 user reviews,1,2,3
631250,0,3 user reviews,2,1,3
631260,0,1 user reviews,1,0,1
631270,0,3 user reviews,1,2,3
631332,0,1 user reviews,0,1,1
631490,0,6 user reviews,5,1,6
631500,0,4 user reviews,4,0,4
631510,8,Very Positive,793,94,887
631540,4,Mostly Negative,25,42,67
631550,0,3 user reviews,3,0,3
631553,0,1 user reviews,0,1,1
631560,8,Very Positive,73,2,75
631570,8,Very Positive,407,21,428
631610,0,1 user reviews,1,0,1
631690,0,4 user reviews,3,1,4
631770,0,7 user reviews,7,0,7
631780,0,2 user reviews,2,0,2
631791,0,1 user reviews,1,0,1
631810,7,Positive,11,2,13
631830,5,Mixed,24,11,35
631900,7,Positive,44,3,47
631910,0,3 user reviews,1,2,3
631920,0,6 user reviews,3,3,6
631980,8,Very Positive,91,15,106
631990,5,Mixed,16,8,24
632000,8,Very Positive,261,40,301
632020,7,Positive,18,3,21
632040,0,7 user reviews,7,0,7
632050,0,2 user reviews,0,2,2
632070,6,Mostly Positive,350,94,444
632100,7,Positive,8,2,10
632110,0,8 user reviews,4,4,8
632120,0,1 user reviews,1,0,1
632170,5,Mixed,17,9,26
632200,0,5 user reviews,0,5,5
632250,7,Positive,18,3,21
632290,5,Mixed,6,5,11
632300,6,Mostly Positive,291,119,410
632350,8,Very Positive,882,165,1047
632360,9,Overwhelmingly Positive,52718,1411,54129
632380,0,2 user reviews,1,1,2
632470,8,Very Positive,13014,688,13702
632510,6,Mostly Positive,14,6,20
632520,5,Mixed,6,4,10
632590,7,Positive,14,0,14
632620,0,8 user reviews,4,4,8
632710,7,Positive,31,3,34
632750,5,Mixed,8,4,12
632800,8,Very Positive,65,9,74
632820,0,3 user reviews,3,0,3
632840,0,3 user reviews,2,1,3
632870,7,Positive,13,2,15
632880,7,Positive,16,0,16
632900,7,Positive,31,5,36
632910,0,1 user reviews,1,0,1
632920,0,3 user reviews,3,0,3
632930,0,1 user reviews,1,0,1
633060,6,Mostly Positive,487,143,630
633110,6,Mostly Positive,145,61,206
633230,6,Mostly Positive,2090,788,2878
633280,0,4 user reviews,2,2,4
633300,0,2 user reviews,0,2,2
633330,0,1 user reviews,1,0,1
633350,0,8 user reviews,5,3,8
633360,6,Mostly Positive,313,132,445
633440,0,6 user reviews,3,3,6
633460,8,Very Positive,2401,361,2762
633490,0,1 user reviews,1,0,1
633580,5,Mixed,8,4,12
633600,7,Positive,20,2,22
633660,0,3 user reviews,1,2,3
633930,7,Positive,17,0,17
633940,0,8 user reviews,4,4,8
633950,5,Mixed,42,30,72
633960,0,2 user reviews,2,0,2
633961,0,1 user reviews,1,0,1
633970,0,7 user reviews,1,6,7
634010,0,1 user reviews,1,0,1
634014,0,1 user reviews,1,0,1
634030,5,Mixed,9,5,14
634090,0,1 user reviews,1,0,1
634120,5,Mixed,33,29,62
634150,0,5 user reviews,1,4,5
634160,9,Overwhelmingly Positive,853,34,887
634180,6,Mostly Positive,26,8,34
634200,0,4 user reviews,3,1,4
634230,5,Mixed,8,12,20
634250,0,1 user reviews,1,0,1
634340,6,Mostly Positive,27,8,35
634410,8,Very Positive,67,1,68
634420,0,1 user reviews,1,0,1
634700,7,Positive,8,2,10
635000,0,7 user reviews,4,3,7
635010,0,1 user reviews,1,0,1
635020,0,1 user reviews,1,0,1
635030,7,Positive,29,5,34
635040,0,6 user reviews,5,1,6
635050,6,Mostly Positive,8,3,11
635060,5,Mixed,13,11,24
635130,0,2 user reviews,0,2,2
635170,0,2 user reviews,2,0,2
635190,0,8 user reviews,4,4,8
635200,5,Mixed,184,104,288
635220,5,Mixed,9,6,15
635250,6,Mostly Positive,32,11,43
635260,8,Very Positive,2741,362,3103
635270,0,2 user reviews,1,1,2
635290,0,9 user reviews,6,3,9
635310,8,Very Positive,60,14,74
635320,8,Very Positive,432,92,524
635330,5,Mixed,42,28,70
635390,8,Very Positive,49,12,61
635410,0,6 user reviews,3,3,6
635430,0,6 user reviews,4,2,6
635520,0,4 user reviews,4,0,4
635580,0,2 user reviews,1,1,2
635590,0,1 user reviews,1,0,1
635670,6,Mostly Positive,58,21,79
635710,0,1 user reviews,0,1,1
635730,6,Mostly Positive,529,140,669
635750,0,1 user reviews,1,0,1
635751,0,1 user reviews,1,0,1
635780,0,1 user reviews,1,0,1
635790,7,Positive,11,1,12
635800,7,Positive,15,0,15
635830,0,7 user reviews,3,4,7
635850,7,Positive,41,3,44
635880,7,Positive,21,5,26
635900,6,Mostly Positive,12,5,17
635930,0,2 user reviews,2,0,2
635940,8,Very Positive,257,6,263
635980,0,3 user reviews,3,0,3
636010,0,3 user reviews,1,2,3
636020,0,1 user reviews,1,0,1
636030,0,6 user reviews,6,0,6
636050,0,8 user reviews,8,0,8
636070,7,Positive,14,2,16
636100,8,Very Positive,321,25,346
636130,0,7 user reviews,5,2,7
636131,0,4 user reviews,4,0,4
636132,0,3 user reviews,2,1,3
636133,0,5 user reviews,3,2,5
636134,0,1 user reviews,1,0,1
636150,8,Very Positive,152,30,182
636170,6,Mostly Positive,38,14,52
636200,0,7 user reviews,5,2,7
636220,0,7 user reviews,7,0,7
636230,4,Mostly Negative,2,8,10
636310,0,6 user reviews,4,2,6
636320,6,Mostly Positive,74,30,104
636330,0,3 user reviews,3,0,3
636360,0,1 user reviews,0,1,1
636370,0,4 user reviews,3,1,4
636390,7,Positive,35,4,39
636400,6,Mostly Positive,23,9,32
636410,0,9 user reviews,9,0,9
636430,0,4 user reviews,2,2,4
636440,0,3 user reviews,3,0,3
636450,8,Very Positive,514,48,562
636460,6,Mostly Positive,29,9,38
636470,4,Mostly Negative,9,14,23
636480,9,Overwhelmingly Positive,15973,608,16581
636490,3,Negative,1,9,10
636500,0,7 user reviews,6,1,7
636501,7,Positive,10,0,10
636502,0,7 user reviews,6,1,7
636520,5,Mixed,20,21,41
636570,7,Positive,41,6,47
636590,0,5 user reviews,2,3,5
636620,7,Positive,15,3,18
636630,5,Mixed,27,32,59
636690,5,Mixed,49,32,81
636710,0,5 user reviews,5,0,5
636720,5,Mixed,16,7,23
636740,0,3 user reviews,2,1,3
636880,0,1 user reviews,1,0,1
636900,0,9 user reviews,9,0,9
636910,0,6 user reviews,6,0,6
636950,0,9 user reviews,8,1,9
636960,6,Mostly Positive,14,4,18
636970,8,Very Positive,256,60,316
637000,0,3 user reviews,2,1,3
637001,0,2 user reviews,1,1,2
637030,0,2 user reviews,2,0,2
637040,4,Mostly Negative,3,9,12
637060,6,Mostly Positive,23,8,31
637070,0,4 user reviews,2,2,4
637090,8,Very Positive,8830,1919,10749
637100,5,Mixed,1257,755,2012
637110,0,1 user reviews,1,0,1
637120,0,4 user reviews,3,1,4
637130,0,2 user reviews,2,0,2
637310,0,9 user reviews,6,3,9
637330,0,1 user reviews,1,0,1
637370,0,3 user reviews,2,1,3
637380,0,3 user reviews,1,2,3
637410,5,Mixed,36,22,58
637640,0,3 user reviews,1,2,3
637650,6,Mostly Positive,7337,1883,9220
637670,5,Mixed,676,290,966
637692,0,2 user reviews,2,0,2
637703,0,1 user reviews,1,0,1
637712,0,1 user reviews,1,0,1
637715,0,2 user reviews,1,1,2
637720,0,3 user reviews,1,2,3
637762,0,3 user reviews,3,0,3
637766,0,4 user reviews,3,1,4
637767,0,1 user reviews,1,0,1
637770,0,1 user reviews,1,0,1
637772,0,2 user reviews,2,0,2
637775,0,1 user reviews,1,0,1
637787,0,2 user reviews,2,0,2
637788,0,1 user reviews,1,0,1
637805,0,1 user reviews,1,0,1
637825,0,1 user reviews,1,0,1
637826,0,1 user reviews,1,0,1
637827,0,1 user reviews,1,0,1
637830,0,1 user reviews,1,0,1
637839,0,1 user reviews,1,0,1
637844,0,3 user reviews,3,0,3
637860,0,4 user reviews,2,2,4
637870,0,3 user reviews,2,1,3
637880,8,Very Positive,56,4,60
637910,0,1 user reviews,1,0,1
637920,0,4 user reviews,1,3,4
637930,0,2 user reviews,2,0,2
637940,0,3 user reviews,2,1,3
638000,8,Very Positive,164,19,183
638010,0,3 user reviews,1,2,3
638011,0,3 user reviews,3,0,3
638020,0,6 user reviews,1,5,6
638060,0,2 user reviews,1,1,2
638070,5,Mixed,86,45,131
638120,0,2 user reviews,0,2,2
638160,5,Mixed,90,46,136
638180,6,Mostly Positive,27,11,38
638200,8,Very Positive,108,11,119
638230,8,Very Positive,2297,194,2491
638240,0,3 user reviews,0,3,3
638260,0,3 user reviews,2,1,3
638270,0,2 user reviews,2,0,2
638280,7,Positive,19,1,20
638310,0,3 user reviews,2,1,3
638360,0,1 user reviews,1,0,1
638460,0,7 user reviews,7,0,7
638470,0,5 user reviews,4,1,5
638550,0,1 user reviews,1,0,1
638610,0,2 user reviews,2,0,2
638630,0,4 user reviews,4,0,4
638650,8,Very Positive,323,66,389
638720,7,Positive,16,2,18
638740,0,2 user reviews,1,1,2
638780,0,4 user reviews,4,0,4
638830,0,5 user reviews,4,1,5
638850,6,Mostly Positive,294,81,375
638890,0,1 user reviews,0,1,1
638930,7,Positive,38,6,44
638970,9,Overwhelmingly Positive,11442,546,11988
638980,0,3 user reviews,3,0,3
638981,0,3 user reviews,3,0,3
639001,0,2 user reviews,2,0,2
639080,0,1 user reviews,1,0,1
639130,8,Very Positive,236,26,262
639150,0,4 user reviews,3,1,4
639170,8,Very Positive,472,50,522
639220,6,Mostly Positive,15,6,21
639240,0,1 user reviews,0,1,1
639270,8,Very Positive,156,6,162
639280,0,8 user reviews,6,2,8
639300,6,Mostly Positive,41,16,57
639310,5,Mixed,34,21,55
639320,0,1 user reviews,1,0,1
639370,0,3 user reviews,3,0,3
639430,7,Positive,11,0,11
639431,7,Positive,13,3,16
639432,0,4 user reviews,4,0,4
639433,0,1 user reviews,0,1,1
639434,7,Positive,11,0,11
639435,0,8 user reviews,8,0,8
639437,0,1 user reviews,1,0,1
639438,7,Positive,10,1,11
639460,6,Mostly Positive,47,16,63
639470,0,7 user reviews,6,1,7
639490,8,Very Positive,164,1,165
639523,0,1 user reviews,1,0,1
639531,0,2 user reviews,1,1,2
639532,0,3 user reviews,2,1,3
639540,0,9 user reviews,7,2,9
639560,6,Mostly Positive,28,8,36
639570,0,4 user reviews,4,0,4
639600,8,Very Positive,276,26,302
639680,7,Positive,10,0,10
639690,0,2 user reviews,2,0,2
639700,0,1 user reviews,1,0,1
639701,0,1 user reviews,1,0,1
639720,7,Positive,22,4,26
639730,0,6 user reviews,4,2,6
639770,7,Positive,29,0,29
639780,9,Overwhelmingly Positive,930,48,978
639790,9,Overwhelmingly Positive,3542,142,3684
639840,0,6 user reviews,2,4,6
639890,0,1 user reviews,1,0,1
639920,0,2 user reviews,1,1,2
640040,0,2 user reviews,2,0,2
640050,3,Negative,1,11,12
640070,0,7 user reviews,5,2,7
640090,7,Positive,8,2,10
640120,8,Very Positive,68,1,69
640140,5,Mixed,84,40,124
640200,0,2 user reviews,1,1,2
640210,5,Mixed,23,18,41
640250,0,2 user reviews,2,0,2
640290,0,3 user reviews,3,0,3
640300,6,Mostly Positive,23,6,29
640310,4,Mostly Negative,22,36,58
640340,7,Positive,30,5,35
640380,8,Very Positive,118,5,123
640590,8,Very Positive,131,23,154
640600,0,2 user reviews,0,2,2
640670,0,2 user reviews,2,0,2
640690,0,9 user reviews,6,3,9
640700,0,3 user reviews,3,0,3
640720,0,3 user reviews,1,2,3
640740,0,4 user reviews,4,0,4
640746,0,1 user reviews,1,0,1
640760,5,Mixed,9,6,15
640800,6,Mostly Positive,58,24,82
640820,6,Mostly Positive,7475,2226,9701
640850,5,Mixed,40,28,68
640860,5,Mixed,27,13,40
640880,0,9 user reviews,8,1,9
640890,7,Positive,13,2,15
640900,7,Positive,16,1,17
640910,0,2 user reviews,2,0,2
640920,8,Very Positive,74,10,84
640970,6,Mostly Positive,33,10,43
640990,8,Very Positive,128,21,149
641000,7,Positive,41,3,44
641020,0,2 user reviews,2,0,2
641050,0,1 user reviews,1,0,1
641080,5,Mixed,502,250,752
641320,8,Very Positive,2417,515,2932
641360,0,1 user reviews,1,0,1
641380,0,7 user reviews,4,3,7
641382,0,2 user reviews,2,0,2
641384,0,4 user reviews,3,1,4
641390,7,Positive,18,0,18
641393,0,1 user reviews,1,0,1
641396,0,2 user reviews,1,1,2
641397,0,1 user reviews,1,0,1
641399,0,1 user reviews,1,0,1
641450,0,1 user reviews,1,0,1
641480,0,1 user reviews,1,0,1
641520,0,1 user reviews,1,0,1
641590,0,3 user reviews,2,1,3
641752,0,1 user reviews,1,0,1
641780,8,Very Positive,618,64,682
641910,4,Mostly Negative,7,11,18
641950,5,Mixed,9,5,14
641960,8,Very Positive,568,141,709
641970,0,3 user reviews,2,1,3
641980,7,Positive,22,5,27
641990,8,Very Positive,4162,540,4702
642070,5,Mixed,7,6,13
642080,8,Very Positive,164,8,172
642090,8,Very Positive,428,20,448
642120,0,1 user reviews,1,0,1
642170,5,Mixed,14,8,22
642190,5,Mixed,6,9,15
642200,7,Positive,10,0,10
642240,7,Positive,12,0,12
642280,8,Very Positive,595,56,651
642461,0,1 user reviews,0,1,1
642510,0,4 user reviews,2,2,4
642520,0,7 user reviews,2,5,7
642560,8,Very Positive,173,9,182
642570,0,1 user reviews,0,1,1
642580,7,Positive,22,4,26
642600,7,Positive,10,0,10
642610,8,Very Positive,49,7,56
642630,0,3 user reviews,3,0,3
642650,8,Very Positive,52,2,54
642660,0,1 user reviews,0,1,1
642700,0,9 user reviews,3,6,9
642720,0,1 user reviews,1,0,1
642730,7,Positive,21,3,24
642750,6,Mostly Positive,278,96,374
642770,8,Very Positive,71,4,75
642780,0,4 user reviews,3,1,4
642800,0,2 user reviews,1,1,2
642802,0,5 user reviews,2,3,5
642803,0,8 user reviews,6,2,8
642804,7,Positive,25,2,27
642805,0,2 user reviews,2,0,2
642806,5,Mixed,9,4,13
642807,5,Mixed,9,11,20
642830,5,Mixed,7,7,14
643180,0,1 user reviews,1,0,1
643200,6,Mostly Positive,35,13,48
643260,0,4 user reviews,4,0,4
643270,0,1 user reviews,1,0,1
643390,7,Positive,31,0,31
643400,0,1 user reviews,1,0,1
643420,0,8 user reviews,8,0,8
643440,0,1 user reviews,1,0,1
643460,0,1 user reviews,0,1,1
643570,7,Positive,18,0,18
643590,5,Mixed,14,20,34
643610,6,Mostly Positive,21,8,29
643620,6,Mostly Positive,62,16,78
643650,0,2 user reviews,2,0,2
643670,0,1 user reviews,1,0,1
643671,0,1 user reviews,1,0,1
643681,5,Mixed,14,14,28
643682,5,Mixed,5,7,12
643683,0,2 user reviews,0,2,2
643684,0,1 user reviews,1,0,1
643686,0,3 user reviews,2,1,3
643687,0,2 user reviews,1,1,2
643688,0,4 user reviews,3,1,4
643689,0,9 user reviews,6,3,9
643692,0,1 user reviews,1,0,1
643693,0,1 user reviews,1,0,1
643698,0,2 user reviews,2,0,2
643700,7,Positive,13,3,16
643730,0,8 user reviews,7,1,8
643731,0,3 user reviews,3,0,3
643740,0,5 user reviews,2,3,5
643810,8,Very Positive,226,47,273
643820,5,Mixed,48,29,77
643830,6,Mostly Positive,14,4,18
643870,0,2 user reviews,2,0,2
643880,8,Very Positive,235,19,254
643900,8,Very Positive,59,5,64
643910,0,3 user reviews,3,0,3
643940,0,3 user reviews,2,1,3
643950,0,7 user reviews,1,6,7
643960,8,Very Positive,132,30,162
643970,5,Mixed,8,4,12
644000,5,Mixed,9,7,16
644010,5,Mixed,9,6,15
644080,8,Very Positive,47,8,55
644110,5,Mixed,8,6,14
644130,4,Mostly Negative,4,16,20
644150,0,3 user reviews,3,0,3
644160,0,6 user reviews,4,2,6
644200,7,Positive,19,3,22
644290,5,Mixed,256,129,385
644370,7,Positive,19,1,20
644380,0,7 user reviews,3,4,7
644390,8,Very Positive,605,51,656
644400,0,3 user reviews,3,0,3
644420,5,Mixed,26,12,38
644480,5,Mixed,101,46,147
644530,0,8 user reviews,4,4,8
644540,7,Positive,18,0,18
644550,0,9 user reviews,8,1,9
644560,8,Very Positive,4678,357,5035
644570,8,Very Positive,768,140,908
644580,0,5 user reviews,5,0,5
644610,0,8 user reviews,4,4,8
644640,5,Mixed,46,68,114
644670,5,Mixed,65,39,104
644680,0,4 user reviews,4,0,4
644710,7,Positive,39,6,45
644740,0,1 user reviews,1,0,1
644760,0,7 user reviews,4,3,7
644830,8,Very Positive,1335,232,1567
644870,0,3 user reviews,2,1,3
644890,0,5 user reviews,2,3,5
644930,8,Very Positive,9908,2237,12145
644960,0,1 user reviews,1,0,1
644961,0,1 user reviews,1,0,1
644962,0,2 user reviews,2,0,2
645090,8,Very Positive,444,47,491
645150,0,4 user reviews,1,3,4
645170,0,2 user reviews,2,0,2
645180,0,3 user reviews,3,0,3
645220,0,1 user reviews,1,0,1
645240,0,2 user reviews,2,0,2
645250,0,2 user reviews,2,0,2
645270,6,Mostly Positive,11,3,14
645280,0,6 user reviews,5,1,6
645290,5,Mixed,14,10,24
645310,0,4 user reviews,4,0,4
645330,0,3 user reviews,0,3,3
645340,5,Mixed,7,6,13
645360,0,2 user reviews,1,1,2
645380,7,Positive,13,2,15
645400,5,Mixed,82,91,173
645401,5,Mixed,68,66,134
645402,5,Mixed,527,386,913
645410,5,Mixed,6,4,10
645420,0,7 user reviews,6,1,7
645430,0,6 user reviews,5,1,6
645440,0,6 user reviews,2,4,6
645450,5,Mixed,9,4,13
645460,6,Mostly Positive,19,8,27
645500,7,Positive,14,3,17
645510,0,2 user reviews,2,0,2
645610,0,3 user reviews,3,0,3
645630,8,Very Positive,11470,1784,13254
645650,0,9 user reviews,6,3,9
645670,0,6 user reviews,4,2,6
645671,0,6 user reviews,4,2,6
645690,7,Positive,10,0,10
645700,0,3 user reviews,2,1,3
645730,8,Very Positive,244,39,283
645750,7,Positive,15,0,15
645780,0,1 user reviews,1,0,1
645790,5,Mixed,333,147,480
645820,6,Mostly Positive,20,6,26
645860,0,6 user reviews,4,2,6
645890,0,2 user reviews,2,0,2
645910,0,1 user reviews,1,0,1
645911,0,2 user reviews,2,0,2
645920,7,Positive,30,4,34
645930,5,Mixed,13,7,20
645940,0,1 user reviews,1,0,1
645970,0,6 user reviews,5,1,6
646010,5,Mixed,7,5,12
646050,5,Mixed,4,6,10
646100,0,9 user reviews,2,7,9
646150,0,3 user reviews,2,1,3
646180,0,2 user reviews,1,1,2
646200,8,Very Positive,574,122,696
646210,7,Positive,24,1,25
646270,8,Very Positive,314,56,370
646280,6,Mostly Positive,12,5,17
646300,0,4 user reviews,2,2,4
646310,6,Mostly Positive,20,7,27
646330,7,Positive,21,2,23
646350,0,7 user reviews,3,4,7
646370,0,3 user reviews,3,0,3
646380,0,8 user reviews,7,1,8
646420,0,3 user reviews,3,0,3
646430,0,2 user reviews,0,2,2
646440,0,1 user reviews,0,1,1
646460,0,5 user reviews,5,0,5
646470,6,Mostly Positive,23,6,29
646490,0,1 user reviews,1,0,1
646500,8,Very Positive,201,37,238
646530,7,Positive,16,3,19
646550,0,3 user reviews,3,0,3
646570,9,Overwhelmingly Positive,31440,620,32060
646600,5,Mixed,40,19,59
646610,0,1 user reviews,1,0,1
646660,0,2 user reviews,1,1,2
646661,0,1 user reviews,1,0,1
646662,0,5 user reviews,5,0,5
646663,0,2 user reviews,2,0,2
646664,0,1 user reviews,1,0,1
646665,0,2 user reviews,2,0,2
646666,0,3 user reviews,3,0,3
646667,0,2 user reviews,2,0,2
646668,6,Mostly Positive,18,5,23
646669,7,Positive,13,2,15
646670,7,Positive,13,0,13
646671,0,4 user reviews,4,0,4
646672,0,6 user reviews,4,2,6
646673,0,4 user reviews,4,0,4
646680,0,9 user reviews,8,1,9
646730,7,Positive,23,4,27
646780,7,Positive,12,1,13
646800,0,1 user reviews,1,0,1
646890,0,2 user reviews,1,1,2
646910,6,Mostly Positive,5459,1394,6853
646930,0,2 user reviews,2,0,2
647020,0,7 user reviews,7,0,7
647040,5,Mixed,19,9,28
647050,0,2 user reviews,0,2,2
647070,0,3 user reviews,3,0,3
647071,0,2 user reviews,2,0,2
647080,0,8 user reviews,8,0,8
647090,0,4 user reviews,4,0,4
647150,0,1 user reviews,1,0,1
647200,0,1 user reviews,1,0,1
647240,0,1 user reviews,1,0,1
647260,0,1 user reviews,1,0,1
647280,0,6 user reviews,3,3,6
647290,0,1 user reviews,1,0,1
647310,0,1 user reviews,1,0,1
647320,0,1 user reviews,1,0,1
647371,0,3 user reviews,2,1,3
647400,0,1 user reviews,1,0,1
647500,5,Mixed,11,8,19
647530,0,6 user reviews,2,4,6
647560,5,Mixed,18,17,35
647570,6,Mostly Positive,95,28,123
647630,0,3 user reviews,0,3,3
647632,0,1 user reviews,1,0,1
647640,5,Mixed,6,4,10
647650,0,4 user reviews,2,2,4
647740,8,Very Positive,141,24,165
647790,0,1 user reviews,1,0,1
647810,7,Positive,9,2,11
647820,4,Mostly Negative,4,13,17
647830,6,Mostly Positive,738,192,930
647840,0,8 user reviews,8,0,8
647850,0,3 user reviews,3,0,3
647860,5,Mixed,7,5,12
647890,0,4 user reviews,2,2,4
647900,0,2 user reviews,2,0,2
647910,0,3 user reviews,3,0,3
647930,0,4 user reviews,3,1,4
647960,9,Overwhelmingly Positive,666,23,689
647980,4,Mostly Negative,7,11,18
647990,7,Positive,14,2,16
648020,5,Mixed,7,4,11
648050,8,Very Positive,53,5,58
648060,0,5 user reviews,2,3,5
648070,0,6 user reviews,1,5,6
648100,8,Very Positive,96,8,104
648113,0,1 user reviews,0,1,1
648120,7,Positive,22,5,27
648190,0,3 user reviews,3,0,3
648200,0,1 user reviews,0,1,1
648290,7,Positive,20,4,24
648292,7,Positive,29,1,30
648293,6,Mostly Positive,16,6,22
648301,5,Mixed,11,11,22
648350,8,Very Positive,11819,2644,14463
648400,7,Positive,9,2,11
648420,7,Positive,10,1,11
648440,0,5 user reviews,4,1,5
648510,0,8 user reviews,7,1,8
648530,0,3 user reviews,1,2,3
648550,0,6 user reviews,3,3,6
648570,0,5 user reviews,2,3,5
648580,8,Very Positive,243,9,252
648630,5,Mixed,8,9,17
648640,0,7 user reviews,5,2,7
648660,0,6 user reviews,4,2,6
648710,0,5 user reviews,5,0,5
648730,0,3 user reviews,3,0,3
648750,5,Mixed,25,15,40
648780,6,Mostly Positive,48,14,62
648800,8,Very Positive,23131,2288,25419
648810,0,4 user reviews,2,2,4
648820,0,5 user reviews,5,0,5
648880,0,7 user reviews,7,0,7
648890,8,Very Positive,87,10,97
648930,7,Positive,23,0,23
648980,7,Positive,28,0,28
649120,0,6 user reviews,6,0,6
649150,0,6 user reviews,2,4,6
649160,0,2 user reviews,1,1,2
649170,0,4 user reviews,1,3,4
649190,5,Mixed,6,5,11
649240,6,Mostly Positive,11,4,15
649250,0,1 user reviews,1,0,1
649270,5,Mixed,23,11,34
649271,0,6 user reviews,4,2,6
649272,7,Positive,13,1,14
649280,7,Positive,9,2,11
649300,0,3 user reviews,0,3,3
649310,0,6 user reviews,6,0,6
649330,0,6 user reviews,5,1,6
649360,0,1 user reviews,0,1,1
649390,0,1 user reviews,1,0,1
649410,5,Mixed,71,49,120
649450,7,Positive,19,4,23
649460,5,Mixed,6,5,11
649480,0,4 user reviews,4,0,4
649481,0,3 user reviews,3,0,3
649482,0,7 user reviews,7,0,7
649483,0,4 user reviews,3,1,4
649484,0,4 user reviews,1,3,4
649485,7,Positive,9,1,10
649486,6,Mostly Positive,13,4,17
649487,0,1 user reviews,1,0,1
649488,0,7 user reviews,5,2,7
649489,0,3 user reviews,3,0,3
649490,0,4 user reviews,4,0,4
649491,0,3 user reviews,3,0,3
649510,0,4 user reviews,2,2,4
649570,0,2 user reviews,1,1,2
649580,6,Mostly Positive,36,12,48
649600,5,Mixed,94,44,138
649620,7,Positive,15,0,15
649630,0,2 user reviews,1,1,2
649640,8,Very Positive,251,59,310
649660,0,3 user reviews,1,2,3
649670,5,Mixed,7,7,14
649690,0,3 user reviews,2,1,3
649730,0,3 user reviews,1,2,3
649740,0,7 user reviews,2,5,7
649790,5,Mixed,40,52,92
649810,5,Mixed,16,8,24
649870,5,Mixed,6,7,13
649880,5,Mixed,11,6,17
649940,0,6 user reviews,6,0,6
649950,6,Mostly Positive,291,124,415
649970,0,1 user reviews,1,0,1
649990,7,Positive,11,1,12
650000,5,Mixed,629,481,1110
650010,0,4 user reviews,2,2,4
650070,5,Mixed,17,8,25
650110,5,Mixed,46,30,76
650220,8,Very Positive,193,33,226
650230,0,3 user reviews,3,0,3
650231,0,2 user reviews,2,0,2
650232,0,1 user reviews,1,0,1
650233,0,1 user reviews,1,0,1
650234,0,1 user reviews,1,0,1
650235,0,1 user reviews,0,1,1
650236,0,1 user reviews,1,0,1
650237,0,1 user reviews,1,0,1
650238,0,1 user reviews,1,0,1
650239,0,1 user reviews,0,1,1
650240,0,1 user reviews,0,1,1
650241,0,2 user reviews,2,0,2
650242,0,1 user reviews,1,0,1
650243,0,2 user reviews,1,1,2
650290,0,4 user reviews,2,2,4
650291,0,2 user reviews,0,2,2
650300,0,2 user reviews,2,0,2
650310,0,3 user reviews,0,3,3
650330,7,Positive,16,3,19
650340,0,1 user reviews,0,1,1
650350,5,Mixed,71,54,125
650360,0,3 user reviews,0,3,3
650410,4,Mostly Negative,26,49,75
650440,6,Mostly Positive,151,60,211
650490,5,Mixed,17,25,42
650500,6,Mostly Positive,5967,2330,8297
650510,6,Mostly Positive,170,62,232
650524,4,Mostly Negative,26,49,75
650570,7,Positive,43,3,46
650580,0,3 user reviews,1,2,3
650600,0,3 user reviews,2,1,3
650610,7,Positive,9,1,10
650611,8,Very Positive,50,3,53
650670,6,Mostly Positive,290,121,411
650680,7,Positive,13,1,14
650720,0,1 user reviews,0,1,1
650730,0,9 user reviews,4,5,9
650750,6,Mostly Positive,24,7,31
650760,6,Mostly Positive,75,22,97
650780,6,Mostly Positive,15,5,20
650810,0,8 user reviews,2,6,8
650820,0,3 user reviews,1,2,3
650840,0,4 user reviews,3,1,4
650860,5,Mixed,22,13,35
650880,0,2 user reviews,1,1,2
650940,8,Very Positive,154,31,185
650980,0,2 user reviews,1,1,2
650990,0,1 user reviews,0,1,1
651010,0,4 user reviews,3,1,4
651020,5,Mixed,5,6,11
651120,0,8 user reviews,4,4,8
651130,0,8 user reviews,8,0,8
651131,0,2 user reviews,2,0,2
651132,0,1 user reviews,1,0,1
651150,8,Very Positive,380,79,459
651170,0,1 user reviews,0,1,1
651280,0,3 user reviews,3,0,3
651340,6,Mostly Positive,14,4,18
651360,0,5 user reviews,5,0,5
651380,7,Positive,31,0,31
651440,4,Mostly Negative,33,65,98
651470,0,1 user reviews,1,0,1
651480,0,1 user reviews,1,0,1
651481,0,2 user reviews,2,0,2
651500,8,Very Positive,45,5,50
651510,0,1 user reviews,1,0,1
651520,0,3 user reviews,1,2,3
651550,7,Positive,9,2,11
651640,0,8 user reviews,8,0,8
651650,0,4 user reviews,2,2,4
651660,8,Very Positive,283,56,339
651670,8,Very Positive,393,75,468
651680,5,Mixed,11,6,17
651690,0,3 user reviews,2,1,3
651820,0,1 user reviews,1,0,1
651970,0,3 user reviews,2,1,3
652000,0,4 user reviews,3,1,4
652040,0,3 user reviews,3,0,3
652050,7,Positive,11,2,13
652060,0,1 user reviews,0,1,1
652070,0,1 user reviews,0,1,1
652090,0,3 user reviews,3,0,3
652120,0,4 user reviews,3,1,4
652130,0,3 user reviews,3,0,3
652150,8,Very Positive,61,2,63
652180,0,2 user reviews,0,2,2
652190,8,Very Positive,75,11,86
652200,0,3 user reviews,3,0,3
652230,0,5 user reviews,1,4,5
652280,0,2 user reviews,0,2,2
652310,0,1 user reviews,1,0,1
652340,7,Positive,28,0,28
652360,7,Positive,12,2,14
652390,0,1 user reviews,0,1,1
652410,8,Very Positive,83,6,89
652460,0,3 user reviews,2,1,3
652470,0,2 user reviews,1,1,2
652490,0,1 user reviews,1,0,1
652491,0,1 user reviews,0,1,1
652510,0,7 user reviews,7,0,7
652530,0,4 user reviews,4,0,4
652540,0,6 user reviews,3,3,6
652550,0,2 user reviews,0,2,2
652560,0,5 user reviews,3,2,5
652570,7,Positive,23,2,25
652600,5,Mixed,11,6,17
652610,0,3 user reviews,3,0,3
652660,4,Mostly Negative,12,27,39
652700,7,Positive,10,0,10
652750,0,7 user reviews,4,3,7
652760,0,5 user reviews,5,0,5
652800,7,Positive,18,1,19
652810,7,Positive,21,0,21
652830,0,9 user reviews,5,4,9
652880,0,9 user reviews,8,1,9
652890,7,Positive,13,2,15
652910,0,2 user reviews,2,0,2
652950,8,Very Positive,82,3,85
652960,8,Very Positive,143,19,162
653050,0,6 user reviews,3,3,6
653080,0,5 user reviews,4,1,5
653100,0,1 user reviews,1,0,1
653190,7,Positive,10,2,12
653200,0,1 user reviews,1,0,1
653210,0,6 user reviews,3,3,6
653230,0,4 user reviews,4,0,4
653530,9,Overwhelmingly Positive,6195,215,6410
653580,7,Positive,11,0,11
653720,0,3 user reviews,1,2,3
653721,0,1 user reviews,1,0,1
653722,0,2 user reviews,2,0,2
653723,0,1 user reviews,1,0,1
653724,0,5 user reviews,3,2,5
653725,0,2 user reviews,2,0,2
653726,0,2 user reviews,2,0,2
653727,0,1 user reviews,1,0,1
653728,0,8 user reviews,2,6,8
653760,0,9 user reviews,4,5,9
653770,0,2 user reviews,2,0,2
653780,0,4 user reviews,2,2,4
653870,0,1 user reviews,0,1,1
653890,0,2 user reviews,1,1,2
653892,0,1 user reviews,1,0,1
653920,0,1 user reviews,1,0,1
653930,8,Very Positive,174,11,185
653940,6,Mostly Positive,56,19,75
653950,8,Very Positive,59,2,61
653960,0,1 user reviews,1,0,1
653970,0,5 user reviews,4,1,5
654000,0,4 user reviews,4,0,4
654010,0,3 user reviews,3,0,3
654020,0,8 user reviews,6,2,8
654050,8,Very Positive,187,25,212
654070,0,9 user reviews,5,4,9
654080,0,1 user reviews,1,0,1
654090,6,Mostly Positive,24,8,32
654100,7,Positive,20,1,21
654120,0,8 user reviews,5,3,8
654140,0,1 user reviews,1,0,1
654172,8,Very Positive,55,4,59
654181,7,Positive,14,2,16
654183,0,3 user reviews,3,0,3
654185,0,2 user reviews,2,0,2
654186,0,2 user reviews,2,0,2
654188,0,1 user reviews,1,0,1
654190,0,1 user reviews,1,0,1
654220,8,Very Positive,55,9,64
654240,0,2 user reviews,1,1,2
654250,5,Mixed,9,6,15
654260,0,5 user reviews,5,0,5
654300,4,Mostly Negative,12,20,32
654350,4,Mostly Negative,10,16,26
654390,0,1 user reviews,0,1,1
654400,7,Positive,18,1,19
654430,7,Positive,19,2,21
654440,6,Mostly Positive,45,14,59
654450,0,2 user reviews,0,2,2
654470,5,Mixed,23,14,37
654500,7,Positive,21,0,21
654520,0,5 user reviews,5,0,5
654540,0,1 user reviews,1,0,1
654550,8,Very Positive,82,10,92
654570,0,7 user reviews,5,2,7
654580,7,Positive,14,0,14
654600,0,9 user reviews,8,1,9
654610,5,Mixed,14,8,22
654640,0,2 user reviews,2,0,2
654660,5,Mixed,6,7,13
654670,0,7 user reviews,7,0,7
654690,5,Mixed,144,75,219
654700,0,4 user reviews,2,2,4
654710,5,Mixed,5,6,11
654740,0,8 user reviews,5,3,8
654750,0,4 user reviews,2,2,4
654770,7,Positive,17,0,17
654800,0,4 user reviews,2,2,4
654810,7,Positive,20,0,20
654820,0,1 user reviews,1,0,1
654840,0,1 user reviews,1,0,1
654850,6,Mostly Positive,107,43,150
654880,8,Very Positive,2965,312,3277
654890,6,Mostly Positive,269,84,353
654900,8,Very Positive,149,17,166
654910,7,Positive,25,0,25
654940,0,3 user reviews,0,3,3
654950,0,4 user reviews,0,4,4
654970,0,3 user reviews,1,2,3
654980,0,1 user reviews,0,1,1
654990,5,Mixed,203,212,415
655000,5,Mixed,14,7,21
655020,5,Mixed,18,9,27
655030,0,5 user reviews,5,0,5
655040,0,5 user reviews,3,2,5
655080,8,Very Positive,56,12,68
655100,6,Mostly Positive,77,24,101
655120,3,Negative,2,9,11
655180,0,3 user reviews,3,0,3
655200,0,3 user reviews,3,0,3
655220,0,1 user reviews,1,0,1
655250,0,1 user reviews,0,1,1
655270,6,Mostly Positive,22,9,31
655280,0,3 user reviews,3,0,3
655290,5,Mixed,117,74,191
655360,0,2 user reviews,2,0,2
655370,7,Positive,13,1,14
655380,7,Positive,30,4,34
655420,7,Positive,9,1,10
655430,0,7 user reviews,4,3,7
655440,0,2 user reviews,1,1,2
655460,5,Mixed,6,7,13
655480,8,Very Positive,168,6,174
655490,0,2 user reviews,2,0,2
655500,8,Very Positive,358,35,393
655560,0,1 user reviews,1,0,1
655571,0,1 user reviews,1,0,1
655580,0,3 user reviews,3,0,3
655610,3,Negative,1,9,10
655620,0,1 user reviews,1,0,1
655630,0,1 user reviews,1,0,1
655650,0,1 user reviews,1,0,1
655660,0,8 user reviews,6,2,8
655710,0,9 user reviews,2,7,9
655730,8,Very Positive,132,32,164
655760,0,6 user reviews,5,1,6
655770,8,Very Positive,172,6,178
655780,5,Mixed,142,71,213
655790,5,Mixed,85,45,130
655800,0,3 user reviews,3,0,3
655801,0,1 user reviews,1,0,1
655910,7,Positive,21,1,22
655930,0,2 user reviews,1,1,2
655940,0,5 user reviews,3,2,5
655950,0,1 user reviews,1,0,1
655980,0,5 user reviews,2,3,5
656020,0,1 user reviews,1,0,1
656030,5,Mixed,42,22,64
656040,7,Positive,21,5,26
656060,0,4 user reviews,2,2,4
656140,5,Mixed,14,7,21
656190,0,6 user reviews,5,1,6
656200,5,Mixed,72,48,120
656210,5,Mixed,25,15,40
656220,0,3 user reviews,0,3,3
656240,5,Mixed,617,635,1252
656260,0,5 user reviews,4,1,5
656300,0,2 user reviews,0,2,2
656320,0,1 user reviews,1,0,1
656340,0,3 user reviews,1,2,3
656350,8,Very Positive,2229,165,2394
656360,0,4 user reviews,2,2,4
656400,6,Mostly Positive,10,4,14
656440,5,Mixed,5,5,10
656450,5,Mixed,9,6,15
656460,5,Mixed,30,20,50
656480,0,6 user reviews,4,2,6
656490,5,Mixed,14,9,23
656510,5,Mixed,26,22,48
656530,2,Very Negative,11,82,93
656550,7,Positive,24,2,26
656560,5,Mixed,8,6,14
656570,6,Mostly Positive,9,3,12
656580,0,2 user reviews,1,1,2
656590,5,Mixed,27,13,40
656600,5,Mixed,78,37,115
656610,4,Mostly Negative,11,31,42
656630,0,5 user reviews,4,1,5
656660,0,4 user reviews,4,0,4
656680,0,3 user reviews,2,1,3
656690,0,4 user reviews,3,1,4
656700,5,Mixed,122,56,178
656730,0,2 user reviews,0,2,2
656740,7,Positive,34,4,38
656780,0,2 user reviews,0,2,2
656810,0,5 user reviews,4,1,5
656870,0,1 user reviews,0,1,1
656880,7,Positive,22,5,27
656890,0,1 user reviews,1,0,1
656900,7,Positive,20,3,23
656910,0,2 user reviews,1,1,2
656940,0,1 user reviews,0,1,1
656970,8,Very Positive,70,7,77
657000,7,Positive,41,2,43
657020,0,2 user reviews,2,0,2
657040,7,Positive,32,4,36
657070,5,Mixed,13,8,21
657090,5,Mixed,54,31,85
657110,0,2 user reviews,1,1,2
657120,7,Positive,22,5,27
657170,0,1 user reviews,1,0,1
657180,0,2 user reviews,2,0,2
657200,8,Very Positive,5366,1118,6484
657230,0,2 user reviews,1,1,2
657240,8,Very Positive,422,31,453
657260,7,Positive,12,0,12
657280,8,Very Positive,71,13,84
657290,7,Positive,25,6,31
657300,7,Positive,10,0,10
657320,0,1 user reviews,1,0,1
657350,7,Positive,12,0,12
657400,0,1 user reviews,1,0,1
657422,0,6 user reviews,4,2,6
657423,0,4 user reviews,4,0,4
657424,0,8 user reviews,7,1,8
657430,7,Positive,12,1,13
657431,0,5 user reviews,5,0,5
657440,6,Mostly Positive,15,4,19
657470,4,Mostly Negative,10,19,29
657500,0,7 user reviews,4,3,7
657510,7,Positive,23,1,24
657530,5,Mixed,7,10,17
657550,0,5 user reviews,4,1,5
657560,0,2 user reviews,1,1,2
657590,5,Mixed,8,10,18
657610,0,8 user reviews,8,0,8
657612,0,2 user reviews,2,0,2
657619,0,1 user reviews,1,0,1
657621,0,1 user reviews,1,0,1
657630,8,Very Positive,205,30,235
657690,8,Very Positive,180,8,188
657700,5,Mixed,9,4,13
657730,7,Positive,42,6,48
657780,0,4 user reviews,2,2,4
657790,0,8 user reviews,3,5,8
657810,5,Mixed,15,7,22
657900,7,Positive,30,7,37
657930,7,Positive,25,1,26
657990,5,Mixed,36,37,73
658000,6,Mostly Positive,9,3,12
658001,0,8 user reviews,3,5,8
658050,7,Positive,25,1,26
658060,5,Mixed,12,6,18
658090,0,3 user reviews,1,2,3
658120,5,Mixed,7,8,15
658140,7,Positive,11,2,13
658150,7,Positive,42,1,43
658160,8,Very Positive,140,28,168
658210,0,3 user reviews,3,0,3
658230,7,Positive,9,1,10
658260,8,Very Positive,169,35,204
658277,0,1 user reviews,1,0,1
658330,7,Positive,10,1,11
658390,0,1 user reviews,0,1,1
658400,0,6 user reviews,6,0,6
658420,0,3 user reviews,2,1,3
658430,5,Mixed,6,7,13
658450,0,4 user reviews,2,2,4
658470,6,Mostly Positive,38,16,54
658490,5,Mixed,28,13,41
658500,7,Positive,24,1,25
658530,7,Positive,18,0,18
658550,8,Very Positive,116,11,127
658560,8,Very Positive,299,18,317
658570,6,Mostly Positive,354,109,463
658590,8,Very Positive,46,9,55
658600,8,Very Positive,112,14,126
658610,0,1 user reviews,0,1,1
658620,8,Very Positive,237,11,248
658630,0,5 user reviews,4,1,5
658660,6,Mostly Positive,8,3,11
658670,0,1 user reviews,0,1,1
658690,7,Positive,29,1,30
658700,5,Mixed,39,17,56
658720,0,1 user reviews,1,0,1
658760,0,2 user reviews,2,0,2
658770,0,4 user reviews,3,1,4
658780,8,Very Positive,54,10,64
658790,0,9 user reviews,6,3,9
658800,0,9 user reviews,8,1,9
658810,0,5 user reviews,5,0,5
658830,5,Mixed,18,11,29
658850,8,Very Positive,718,82,800
658870,0,1 user reviews,1,0,1
658900,0,2 user reviews,2,0,2
658910,0,5 user reviews,4,1,5
658980,5,Mixed,166,148,314
658990,0,8 user reviews,8,0,8
659040,0,9 user reviews,8,1,9
659060,0,2 user reviews,2,0,2
659110,6,Mostly Positive,24,7,31
659120,4,Mostly Negative,9,19,28
659130,5,Mixed,10,8,18
659160,0,2 user reviews,0,2,2
659170,0,1 user reviews,1,0,1
659180,0,4 user reviews,4,0,4
659190,5,Mixed,77,34,111
659220,0,4 user reviews,4,0,4
659260,0,7 user reviews,7,0,7
659290,5,Mixed,7,6,13
659390,0,1 user reviews,1,0,1
659460,0,1 user reviews,1,0,1
659480,6,Mostly Positive,74,26,100
659490,0,7 user reviews,5,2,7
659510,0,1 user reviews,1,0,1
659540,8,Very Positive,362,12,374
659560,0,1 user reviews,1,0,1
659570,0,1 user reviews,1,0,1
659610,0,2 user reviews,0,2,2
659650,0,1 user reviews,1,0,1
659680,0,1 user reviews,1,0,1
659710,0,5 user reviews,5,0,5
659720,0,3 user reviews,3,0,3
659810,0,3 user reviews,1,2,3
659830,0,3 user reviews,3,0,3
659860,0,1 user reviews,1,0,1
659870,0,3 user reviews,2,1,3
659890,0,6 user reviews,6,0,6
659910,0,1 user reviews,1,0,1
659920,5,Mixed,27,14,41
659930,7,Positive,9,2,11
659940,0,5 user reviews,4,1,5
659950,0,6 user reviews,4,2,6
659970,0,4 user reviews,4,0,4
659990,0,1 user reviews,0,1,1
660030,0,4 user reviews,4,0,4
660040,0,4 user reviews,4,0,4
660060,0,1 user reviews,1,0,1
660070,0,1 user reviews,1,0,1
660080,6,Mostly Positive,42,16,58
660120,0,6 user reviews,0,6,6
660160,8,Very Positive,272,34,306
660170,0,2 user reviews,0,2,2
660180,4,Mostly Negative,8,25,33
660250,0,1 user reviews,0,1,1
660270,0,3 user reviews,2,1,3
660280,0,1 user reviews,0,1,1
660290,0,9 user reviews,5,4,9
660320,0,8 user reviews,4,4,8
660560,0,5 user reviews,3,2,5
660570,5,Mixed,8,4,12
660730,0,8 user reviews,5,3,8
660760,0,1 user reviews,1,0,1
660820,0,1 user reviews,0,1,1
660850,7,Positive,15,2,17
660900,0,2 user reviews,0,2,2
660920,5,Mixed,68,49,117
660930,0,2 user reviews,2,0,2
660940,0,1 user reviews,0,1,1
660990,4,Mostly Negative,5,15,20
661000,5,Mixed,15,12,27
661030,7,Positive,11,0,11
661040,5,Mixed,27,17,44
661050,0,2 user reviews,2,0,2
661070,0,1 user reviews,1,0,1
661100,0,1 user reviews,1,0,1
661110,0,2 user reviews,1,1,2
661120,7,Positive,26,0,26
661140,0,3 user reviews,2,1,3
661180,0,1 user reviews,0,1,1
661190,0,1 user reviews,0,1,1
661200,0,6 user reviews,6,0,6
661220,0,9 user reviews,9,0,9
661230,7,Positive,23,2,25
661240,0,4 user reviews,4,0,4
661270,0,2 user reviews,2,0,2
661280,6,Mostly Positive,51,14,65
661290,6,Mostly Positive,83,30,113
661300,0,7 user reviews,6,1,7
661313,0,1 user reviews,1,0,1
661330,0,3 user reviews,3,0,3
661340,0,3 user reviews,3,0,3
661360,0,5 user reviews,5,0,5
661380,0,2 user reviews,2,0,2
661410,0,1 user reviews,0,1,1
661430,8,Very Positive,108,10,118
661440,0,2 user reviews,1,1,2
661450,7,Positive,10,0,10
661460,0,4 user reviews,3,1,4
661470,5,Mixed,10,5,15
661480,0,6 user reviews,5,1,6
661490,3,Negative,1,9,10
661500,7,Positive,14,2,16
661520,0,6 user reviews,1,5,6
661550,0,1 user reviews,1,0,1
661560,0,2 user reviews,0,2,2
661610,0,1 user reviews,0,1,1
661650,0,2 user reviews,1,1,2
661660,7,Positive,8,2,10
661670,0,6 user reviews,3,3,6
661730,0,1 user reviews,1,0,1
661740,6,Mostly Positive,33,13,46
661790,8,Very Positive,615,75,690
661820,0,2 user reviews,2,0,2
661900,0,3 user reviews,2,1,3
661920,5,Mixed,67,38,105
661940,8,Very Positive,107,9,116
661970,0,7 user reviews,3,4,7
661990,7,Positive,32,4,36
662190,7,Positive,37,2,39
662200,0,9 user reviews,6,3,9
662210,8,Very Positive,199,6,205
662230,5,Mixed,24,11,35
662240,6,Mostly Positive,43,12,55
662250,0,4 user reviews,0,4,4
662260,0,1 user reviews,1,0,1
662290,0,8 user reviews,8,0,8
662320,5,Mixed,14,7,21
662350,6,Mostly Positive,150,41,191
662352,5,Mixed,21,13,34
662353,4,Mostly Negative,37,69,106
662380,0,5 user reviews,1,4,5
662400,0,2 user reviews,2,0,2
662410,7,Positive,12,0,12
662500,0,4 user reviews,1,3,4
662540,8,Very Positive,67,11,78
662550,0,3 user reviews,3,0,3
662600,0,2 user reviews,1,1,2
662620,0,4 user reviews,3,1,4
662660,0,2 user reviews,2,0,2
662680,7,Positive,17,3,20
662690,0,5 user reviews,4,1,5
662740,0,1 user reviews,1,0,1
662760,0,2 user reviews,2,0,2
662772,0,1 user reviews,1,0,1
662780,0,1 user reviews,1,0,1
662840,6,Mostly Positive,17,6,23
662860,0,2 user reviews,2,0,2
662864,0,1 user reviews,0,1,1
662865,0,1 user reviews,0,1,1
662910,6,Mostly Positive,20,8,28
662920,7,Positive,20,3,23
662930,0,9 user reviews,9,0,9
662950,3,Negative,0,13,13
662960,6,Mostly Positive,95,33,128
662970,5,Mixed,15,7,22
662990,0,1 user reviews,1,0,1
663020,0,2 user reviews,0,2,2
663060,0,1 user reviews,0,1,1
663090,5,Mixed,14,16,30
663100,0,9 user reviews,8,1,9
663110,4,Mostly Negative,13,20,33
663120,0,1 user reviews,1,0,1
663130,7,Positive,12,2,14
663140,0,1 user reviews,1,0,1
663160,0,4 user reviews,1,3,4
663170,0,1 user reviews,1,0,1
663190,5,Mixed,17,10,27
663200,5,Mixed,17,17,34
663210,7,Positive,32,3,35
663230,0,1 user reviews,1,0,1
663240,8,Very Positive,61,11,72
663250,0,1 user reviews,0,1,1
663280,0,3 user reviews,2,1,3
663290,0,7 user reviews,1,6,7
663300,5,Mixed,25,20,45
663370,7,Positive,22,2,24
663380,6,Mostly Positive,765,279,1044
663390,5,Mixed,110,52,162
663430,0,2 user reviews,1,1,2
663480,0,1 user reviews,1,0,1
663530,0,1 user reviews,0,1,1
663540,0,5 user reviews,5,0,5
663580,0,8 user reviews,5,3,8
663590,7,Positive,16,1,17
663670,8,Very Positive,288,25,313
663730,0,9 user reviews,6,3,9
663820,0,3 user reviews,3,0,3
663830,6,Mostly Positive,23,8,31
663920,0,2 user reviews,2,0,2
664000,8,Very Positive,86,18,104
664040,0,4 user reviews,4,0,4
664060,0,6 user reviews,5,1,6
664080,0,1 user reviews,0,1,1
664090,8,Very Positive,112,28,140
664110,0,1 user reviews,1,0,1
664120,0,7 user reviews,1,6,7
664140,0,4 user reviews,4,0,4
664160,0,3 user reviews,3,0,3
664180,8,Very Positive,52,2,54
664190,0,3 user reviews,3,0,3
664210,0,1 user reviews,1,0,1
664240,0,8 user reviews,8,0,8
664250,0,7 user reviews,4,3,7
664290,5,Mixed,14,13,27
664320,5,Mixed,22,20,42
664330,0,1 user reviews,1,0,1
664340,0,2 user reviews,0,2,2
664350,5,Mixed,6,9,15
664360,0,1 user reviews,1,0,1
664420,0,1 user reviews,1,0,1
664430,5,Mixed,376,417,793
664450,7,Positive,32,5,37
664510,0,8 user reviews,6,2,8
664530,6,Mostly Positive,13,4,17
664560,0,3 user reviews,2,1,3
664590,0,1 user reviews,1,0,1
664600,0,1 user reviews,0,1,1
664610,7,Positive,8,2,10
664620,5,Mixed,9,7,16
664630,0,2 user reviews,1,1,2
664650,5,Mixed,12,9,21
664660,0,1 user reviews,1,0,1
664710,0,1 user reviews,1,0,1
664720,0,2 user reviews,0,2,2
664750,8,Very Positive,215,13,228
664780,5,Mixed,20,10,30
664820,0,6 user reviews,6,0,6
664830,8,Very Positive,298,39,337
664850,7,Positive,20,0,20
664870,0,2 user reviews,1,1,2
664890,0,4 user reviews,2,2,4
664950,7,Positive,17,3,20
665030,6,Mostly Positive,28,10,38
665040,0,1 user reviews,1,0,1
665060,0,1 user reviews,0,1,1
665070,0,1 user reviews,1,0,1
665080,0,9 user reviews,6,3,9
665090,5,Mixed,111,53,164
665100,7,Positive,15,1,16
665120,6,Mostly Positive,28,8,36
665140,5,Mixed,5,7,12
665180,6,Mostly Positive,331,117,448
665210,0,3 user reviews,3,0,3
665240,0,4 user reviews,2,2,4
665270,7,Positive,20,1,21
665300,8,Very Positive,225,11,236
665310,0,6 user reviews,6,0,6
665330,8,Very Positive,178,29,207
665340,0,6 user reviews,4,2,6
665350,0,5 user reviews,5,0,5
665360,6,Mostly Positive,2943,902,3845
665370,8,Very Positive,307,13,320
665380,7,Positive,20,1,21
665440,0,7 user reviews,5,2,7
665450,0,4 user reviews,2,2,4
665460,0,3 user reviews,3,0,3
665500,0,4 user reviews,4,0,4
665510,0,5 user reviews,3,2,5
665590,5,Mixed,9,4,13
665620,0,6 user reviews,4,2,6
665630,0,1 user reviews,1,0,1
665640,0,4 user reviews,3,1,4
665650,0,5 user reviews,5,0,5
665670,0,5 user reviews,3,2,5
665680,0,6 user reviews,1,5,6
665730,0,6 user reviews,3,3,6
665780,0,1 user reviews,1,0,1
665790,0,1 user reviews,1,0,1
665830,0,8 user reviews,6,2,8
665880,0,4 user reviews,2,2,4
665920,0,6 user reviews,5,1,6
665930,0,6 user reviews,4,2,6
665950,0,2 user reviews,1,1,2
665960,5,Mixed,9,13,22
666010,0,7 user reviews,5,2,7
666020,8,Very Positive,491,49,540
666030,0,1 user reviews,0,1,1
666040,0,4 user reviews,1,3,4
666050,0,3 user reviews,3,0,3
666060,0,1 user reviews,0,1,1
666080,0,1 user reviews,0,1,1
666090,0,3 user reviews,2,1,3
666100,8,Very Positive,70,6,76
666110,0,1 user reviews,0,1,1
666120,0,4 user reviews,0,4,4
666140,8,Very Positive,6893,447,7340
666230,7,Positive,24,1,25
666231,0,5 user reviews,4,1,5
666232,0,5 user reviews,5,0,5
666233,0,7 user reviews,6,1,7
666250,0,7 user reviews,1,6,7
666260,0,7 user reviews,3,4,7
666290,0,2 user reviews,0,2,2
666310,0,2 user reviews,0,2,2
666320,0,2 user reviews,2,0,2
666330,8,Very Positive,150,33,183
666340,7,Positive,15,2,17
666350,7,Positive,31,3,34
666370,0,1 user reviews,1,0,1
666560,0,8 user reviews,4,4,8
666570,6,Mostly Positive,203,67,270
666590,0,3 user reviews,3,0,3
666600,0,7 user reviews,4,3,7
666610,8,Very Positive,84,1,85
666620,3,Negative,2,10,12
666630,7,Positive,11,0,11
666640,0,3 user reviews,1,2,3
666660,0,7 user reviews,3,4,7
666670,0,7 user reviews,7,0,7
666730,6,Mostly Positive,68,19,87
666790,0,1 user reviews,1,0,1
666800,5,Mixed,6,7,13
666810,0,1 user reviews,1,0,1
666820,8,Very Positive,124,14,138
666850,0,3 user reviews,2,1,3
666870,0,5 user reviews,0,5,5
666910,0,3 user reviews,3,0,3
666930,0,3 user reviews,1,2,3
666940,5,Mixed,11,7,18
666960,5,Mixed,7,5,12
667000,0,1 user reviews,0,1,1
667010,7,Positive,14,2,16
667030,0,6 user reviews,3,3,6
667040,7,Positive,9,2,11
667050,0,7 user reviews,3,4,7
667060,0,1 user reviews,1,0,1
667090,0,2 user reviews,2,0,2
667130,6,Mostly Positive,14,4,18
667170,0,7 user reviews,1,6,7
667220,0,7 user reviews,4,3,7
667240,0,3 user reviews,3,0,3
667250,0,1 user reviews,1,0,1
667290,0,6 user reviews,2,4,6
667291,0,5 user reviews,2,3,5
667300,5,Mixed,8,11,19
667310,0,1 user reviews,1,0,1
667340,0,6 user reviews,2,4,6
667360,4,Mostly Negative,4,7,11
667410,0,1 user reviews,0,1,1
667420,0,4 user reviews,1,3,4
667450,0,1 user reviews,0,1,1
667510,0,1 user reviews,1,0,1
667520,4,Mostly Negative,4,8,12
667550,0,5 user reviews,5,0,5
667600,8,Very Positive,448,29,477
667620,5,Mixed,16,7,23
667630,0,1 user reviews,0,1,1
667670,0,4 user reviews,3,1,4
667690,0,4 user reviews,4,0,4
667720,6,Mostly Positive,862,218,1080
667750,0,6 user reviews,6,0,6
667760,7,Positive,10,0,10
667770,0,9 user reviews,5,4,9
667780,7,Positive,12,1,13
667790,7,Positive,12,0,12
667800,7,Positive,26,1,27
667810,5,Mixed,25,14,39
667820,7,Positive,27,1,28
667840,0,3 user reviews,0,3,3
667870,7,Positive,11,0,11
667880,0,2 user reviews,2,0,2
667900,0,1 user reviews,0,1,1
667920,0,9 user reviews,5,4,9
667930,0,1 user reviews,1,0,1
667970,9,Overwhelmingly Positive,1759,60,1819
667980,0,1 user reviews,1,0,1
668010,0,2 user reviews,2,0,2
668030,0,3 user reviews,2,1,3
668040,0,5 user reviews,4,1,5
668050,0,2 user reviews,0,2,2
668060,0,3 user reviews,0,3,3
668190,0,1 user reviews,0,1,1
668200,0,2 user reviews,2,0,2
668210,8,Very Positive,418,49,467
668220,0,2 user reviews,2,0,2
668230,0,2 user reviews,2,0,2
668280,0,2 user reviews,2,0,2
668290,0,4 user reviews,2,2,4
668300,0,3 user reviews,1,2,3
668320,7,Positive,24,3,27
668350,8,Very Positive,132,1,133
668360,7,Positive,25,5,30
668430,8,Very Positive,109,12,121
668510,0,3 user reviews,3,0,3
668520,0,3 user reviews,3,0,3
668560,0,2 user reviews,1,1,2
668590,8,Very Positive,98,18,116
668610,0,4 user reviews,3,1,4
668630,8,Very Positive,490,117,607
668650,0,3 user reviews,3,0,3
668660,7,Positive,16,2,18
668670,0,6 user reviews,2,4,6
668680,0,2 user reviews,2,0,2
668710,7,Positive,12,1,13
668714,0,2 user reviews,1,1,2
668730,0,6 user reviews,4,2,6
668780,0,6 user reviews,6,0,6
668790,0,3 user reviews,2,1,3
668800,0,2 user reviews,2,0,2
668830,0,1 user reviews,0,1,1
668840,0,6 user reviews,4,2,6
668850,0,1 user reviews,0,1,1
668890,4,Mostly Negative,7,12,19
668910,0,5 user reviews,2,3,5
668960,0,2 user reviews,2,0,2
668970,0,3 user reviews,3,0,3
668980,8,Very Positive,60,13,73
669000,0,3 user reviews,0,3,3
669050,8,Very Positive,113,14,127
669150,0,1 user reviews,1,0,1
669190,0,4 user reviews,1,3,4
669290,5,Mixed,111,102,213
669310,0,2 user reviews,2,0,2
669320,0,6 user reviews,4,2,6
669340,0,9 user reviews,8,1,9
669350,0,6 user reviews,4,2,6
669360,0,2 user reviews,1,1,2
669380,7,Positive,33,6,39
669390,0,5 user reviews,4,1,5
669410,0,1 user reviews,0,1,1
669480,0,5 user reviews,5,0,5
669490,0,2 user reviews,2,0,2
669500,8,Very Positive,48,4,52
669520,0,1 user reviews,0,1,1
669570,0,5 user reviews,1,4,5
669590,0,1 user reviews,1,0,1
669600,0,1 user reviews,1,0,1
669650,0,3 user reviews,0,3,3
669660,5,Mixed,36,19,55
669700,0,1 user reviews,0,1,1
669710,0,2 user reviews,2,0,2
669730,0,7 user reviews,2,5,7
669740,0,3 user reviews,3,0,3
669750,0,5 user reviews,4,1,5
669770,5,Mixed,25,20,45
669830,7,Positive,10,1,11
669910,7,Positive,22,1,23
669950,8,Very Positive,263,30,293
669960,0,3 user reviews,2,1,3
669970,7,Positive,27,3,30
669990,0,1 user reviews,1,0,1
670020,0,1 user reviews,1,0,1
670060,7,Positive,13,0,13
670090,0,1 user reviews,1,0,1
670100,0,4 user reviews,1,3,4
670130,0,6 user reviews,5,1,6
670140,0,4 user reviews,4,0,4
670160,8,Very Positive,217,18,235
670180,5,Mixed,7,4,11
670210,0,1 user reviews,1,0,1
670230,0,2 user reviews,2,0,2
670240,0,3 user reviews,2,1,3
670260,8,Very Positive,166,25,191
670270,0,5 user reviews,3,2,5
670280,0,4 user reviews,3,1,4
670320,0,2 user reviews,2,0,2
670330,0,5 user reviews,2,3,5
670340,0,3 user reviews,3,0,3
670350,6,Mostly Positive,152,45,197
670370,0,4 user reviews,1,3,4
670410,0,4 user reviews,2,2,4
670430,0,5 user reviews,0,5,5
670450,0,5 user reviews,4,1,5
670460,5,Mixed,7,4,11
670470,0,9 user reviews,4,5,9
670490,4,Mostly Negative,14,51,65
670570,0,3 user reviews,2,1,3
670610,7,Positive,27,0,27
670620,0,3 user reviews,2,1,3
670630,0,5 user reviews,5,0,5
670720,0,5 user reviews,5,0,5
670730,0,3 user reviews,3,0,3
670750,8,Very Positive,98,14,112
670780,0,2 user reviews,0,2,2
670820,5,Mixed,31,14,45
670840,0,5 user reviews,5,0,5
670850,0,4 user reviews,3,1,4
670870,0,2 user reviews,2,0,2
670900,5,Mixed,147,106,253
670910,0,6 user reviews,0,6,6
670930,6,Mostly Positive,10,3,13
670940,0,1 user reviews,1,0,1
670950,0,4 user reviews,4,0,4
670960,0,1 user reviews,1,0,1
670961,0,1 user reviews,1,0,1
671050,0,1 user reviews,1,0,1
671090,7,Positive,37,6,43
671100,7,Positive,17,1,18
671120,0,4 user reviews,4,0,4
671150,0,3 user reviews,3,0,3
671160,7,Positive,24,2,26
671170,8,Very Positive,51,9,60
671180,0,4 user reviews,3,1,4
671190,7,Positive,41,3,44
671200,0,2 user reviews,1,1,2
671230,0,1 user reviews,1,0,1
671240,5,Mixed,17,10,27
671260,6,Mostly Positive,22,9,31
671270,7,Positive,8,2,10
671330,0,2 user reviews,2,0,2
671390,6,Mostly Positive,67,21,88
671440,6,Mostly Positive,1082,298,1380
671470,0,2 user reviews,2,0,2
671480,0,2 user reviews,2,0,2
671490,0,1 user reviews,0,1,1
671510,5,Mixed,1082,472,1554
671540,0,1 user reviews,1,0,1
671550,7,Positive,37,1,38
671560,0,9 user reviews,9,0,9
671580,0,3 user reviews,1,2,3
671600,5,Mixed,8,10,18
671620,8,Very Positive,344,66,410
671630,6,Mostly Positive,8,3,11
671650,7,Positive,25,4,29
671670,5,Mixed,6,4,10
671740,7,Positive,25,3,28
671750,0,1 user reviews,1,0,1
671800,5,Mixed,9,7,16
671810,0,1 user reviews,0,1,1
671820,0,1 user reviews,1,0,1
671840,6,Mostly Positive,8,3,11
671850,0,1 user reviews,0,1,1
671880,0,2 user reviews,2,0,2
671900,5,Mixed,23,22,45
671920,6,Mostly Positive,27,9,36
671980,7,Positive,29,4,33
672010,0,1 user reviews,1,0,1
672020,7,Positive,31,3,34
672030,0,4 user reviews,2,2,4
672040,0,8 user reviews,6,2,8
672050,0,3 user reviews,0,3,3
672100,0,4 user reviews,4,0,4
672130,0,2 user reviews,0,2,2
672140,0,8 user reviews,2,6,8
672150,7,Positive,35,3,38
672160,5,Mixed,16,8,24
672180,0,6 user reviews,5,1,6
672230,6,Mostly Positive,28,8,36
672250,0,9 user reviews,4,5,9
672270,6,Mostly Positive,34,11,45
672271,5,Mixed,28,22,50
672290,0,8 user reviews,5,3,8
672310,0,5 user reviews,4,1,5
672320,0,1 user reviews,1,0,1
672380,0,3 user reviews,0,3,3
672410,0,1 user reviews,1,0,1
672460,5,Mixed,9,6,15
672480,0,1 user reviews,0,1,1
672570,0,2 user reviews,1,1,2
672590,7,Positive,34,8,42
672630,8,Very Positive,635,114,749
672670,0,2 user reviews,1,1,2
672680,0,4 user reviews,2,2,4
672690,0,9 user reviews,9,0,9
672710,5,Mixed,12,9,21
672720,0,5 user reviews,4,1,5
672760,0,2 user reviews,1,1,2
672770,0,1 user reviews,0,1,1
672790,6,Mostly Positive,10,4,14
672830,6,Mostly Positive,24,8,32
672840,8,Very Positive,108,8,116
672860,5,Mixed,25,29,54
672910,0,3 user reviews,2,1,3
672920,0,5 user reviews,5,0,5
672940,0,5 user reviews,0,5,5
672970,0,8 user reviews,6,2,8
673000,8,Very Positive,412,65,477
673010,0,2 user reviews,0,2,2
673040,0,2 user reviews,2,0,2
673050,0,1 user reviews,1,0,1
673060,7,Positive,39,4,43
673120,0,1 user reviews,0,1,1
673130,9,Overwhelmingly Positive,2267,76,2343
673140,0,3 user reviews,3,0,3
673190,6,Mostly Positive,33,12,45
673210,5,Mixed,192,86,278
673220,0,6 user reviews,3,3,6
673230,0,4 user reviews,4,0,4
673260,6,Mostly Positive,119,41,160
673280,0,4 user reviews,4,0,4
673300,8,Very Positive,49,3,52
673310,0,3 user reviews,0,3,3
673360,0,1 user reviews,1,0,1
673380,0,3 user reviews,3,0,3
673400,0,5 user reviews,0,5,5
673450,5,Mixed,54,32,86
673480,0,2 user reviews,2,0,2
673500,5,Mixed,7,6,13
673530,0,1 user reviews,1,0,1
673540,0,1 user reviews,1,0,1
673550,0,3 user reviews,3,0,3
673570,0,5 user reviews,2,3,5
673580,0,1 user reviews,0,1,1
673600,8,Very Positive,90,14,104
673610,8,Very Positive,2003,408,2411
673630,0,1 user reviews,0,1,1
673660,5,Mixed,8,10,18
673720,0,2 user reviews,0,2,2
673730,0,1 user reviews,1,0,1
673740,7,Positive,33,5,38
673750,8,Very Positive,205,22,227
673800,8,Very Positive,122,27,149
673820,0,3 user reviews,0,3,3
673830,5,Mixed,6,4,10
673840,6,Mostly Positive,10,3,13
673850,8,Very Positive,91,14,105
673880,8,Very Positive,3082,213,3295
673920,0,1 user reviews,1,0,1
673950,8,Very Positive,2314,186,2500
673970,0,9 user reviews,8,1,9
673980,7,Positive,25,1,26
674000,0,1 user reviews,1,0,1
674010,0,2 user reviews,0,2,2
674020,5,Mixed,4752,2558,7310
674100,0,1 user reviews,1,0,1
674120,0,1 user reviews,0,1,1
674150,5,Mixed,10,8,18
674160,0,6 user reviews,3,3,6
674170,5,Mixed,22,10,32
674180,0,3 user reviews,2,1,3
674190,7,Positive,20,1,21
674210,7,Positive,12,2,14
674220,4,Mostly Negative,7,11,18
674230,0,4 user reviews,4,0,4
674250,7,Positive,15,1,16
674310,7,Positive,27,4,31
674330,7,Positive,21,0,21
674360,0,1 user reviews,0,1,1
674370,5,Mixed,15,12,27
674380,0,9 user reviews,6,3,9
674420,0,4 user reviews,1,3,4
674440,0,9 user reviews,8,1,9
674450,0,1 user reviews,1,0,1
674480,0,2 user reviews,1,1,2
674500,8,Very Positive,802,191,993
674520,8,Very Positive,605,44,649
674530,0,2 user reviews,0,2,2
674550,0,2 user reviews,0,2,2
674570,7,Positive,14,3,17
674670,0,1 user reviews,1,0,1
674750,8,Very Positive,252,62,314
674800,0,6 user reviews,3,3,6
674840,0,4 user reviews,2,2,4
674850,8,Very Positive,117,9,126
674860,0,8 user reviews,2,6,8
674890,7,Positive,8,2,10
674910,0,1 user reviews,1,0,1
674920,0,1 user reviews,0,1,1
674940,8,Very Positive,23661,1725,25386
674960,8,Very Positive,56,12,68
674980,0,3 user reviews,1,2,3
675010,8,Very Positive,5236,622,5858
675030,7,Positive,20,2,22
675080,0,2 user reviews,2,0,2
675120,0,4 user reviews,4,0,4
675130,0,5 user reviews,2,3,5
675140,0,3 user reviews,2,1,3
675170,5,Mixed,67,56,123
675180,0,4 user reviews,0,4,4
675210,5,Mixed,16,23,39
675220,0,5 user reviews,2,3,5
675240,8,Very Positive,121,8,129
675260,8,Very Positive,1669,117,1786
675270,0,3 user reviews,3,0,3
675280,8,Very Positive,46,8,54
675290,8,Very Positive,324,31,355
675340,0,7 user reviews,7,0,7
675351,0,1 user reviews,1,0,1
675354,0,4 user reviews,4,0,4
675355,0,5 user reviews,4,1,5
675356,0,1 user reviews,1,0,1
675357,0,2 user reviews,1,1,2
675358,0,1 user reviews,0,1,1
675360,0,8 user reviews,3,5,8
675370,0,1 user reviews,0,1,1
675480,0,6 user reviews,4,2,6
675490,7,Positive,17,3,20
675500,0,8 user reviews,4,4,8
675510,4,Mostly Negative,4,7,11
675530,0,1 user reviews,1,0,1
675590,8,Very Positive,79,1,80
675620,0,7 user reviews,5,2,7
675630,7,Positive,15,0,15
675640,0,6 user reviews,2,4,6
675660,0,4 user reviews,0,4,4
675720,4,Mostly Negative,5,8,13
675730,6,Mostly Positive,10,3,13
675750,0,1 user reviews,1,0,1
675770,0,2 user reviews,1,1,2
675830,0,2 user reviews,1,1,2
675870,0,3 user reviews,2,1,3
675890,7,Positive,15,1,16
675910,7,Positive,10,1,11
675940,5,Mixed,13,8,21
675950,5,Mixed,8,5,13
675960,0,5 user reviews,1,4,5
675970,0,6 user reviews,6,0,6
675980,0,2 user reviews,2,0,2
675990,7,Positive,10,2,12
676000,5,Mixed,16,7,23
676080,7,Positive,18,2,20
676090,6,Mostly Positive,10,4,14
676120,5,Mixed,9,4,13
676130,7,Positive,17,1,18
676170,0,2 user reviews,2,0,2
676180,0,7 user reviews,7,0,7
676210,0,2 user reviews,1,1,2
676240,7,Positive,25,3,28
676310,0,5 user reviews,1,4,5
676320,0,2 user reviews,1,1,2
676340,0,6 user reviews,4,2,6
676410,0,3 user reviews,1,2,3
676420,8,Very Positive,171,12,183
676430,8,Very Positive,186,36,222
676440,7,Positive,26,3,29
676450,7,Positive,11,0,11
676460,0,5 user reviews,1,4,5
676500,8,Very Positive,215,23,238
676510,7,Positive,26,1,27
676520,0,2 user reviews,2,0,2
676550,4,Mostly Negative,2,8,10
676570,0,1 user reviews,0,1,1
676580,0,5 user reviews,5,0,5
676600,0,1 user reviews,1,0,1
676620,0,6 user reviews,6,0,6
676630,7,Positive,45,2,47
676660,0,2 user reviews,2,0,2
676680,0,1 user reviews,1,0,1
676690,0,5 user reviews,3,2,5
676700,6,Mostly Positive,11,4,15
676720,0,8 user reviews,2,6,8
676730,5,Mixed,11,12,23
676740,6,Mostly Positive,296,96,392
676760,4,Mostly Negative,8,14,22
676820,9,Overwhelmingly Positive,955,46,1001
676830,7,Positive,23,4,27
676840,5,Mixed,242,104,346
676850,0,4 user reviews,2,2,4
676880,0,2 user reviews,0,2,2
676910,0,9 user reviews,7,2,9
676930,7,Positive,22,2,24
676960,0,8 user reviews,7,1,8
676990,0,3 user reviews,0,3,3
677010,0,2 user reviews,0,2,2
677020,6,Mostly Positive,35,11,46
677030,0,2 user reviews,2,0,2
677040,5,Mixed,14,8,22
677060,6,Mostly Positive,15,6,21
677080,0,1 user reviews,1,0,1
677090,0,2 user reviews,2,0,2
677120,8,Very Positive,2098,271,2369
677150,0,5 user reviews,4,1,5
677160,6,Mostly Positive,904,228,1132
677180,5,Mixed,50,68,118
677190,7,Positive,9,1,10
677210,0,4 user reviews,4,0,4
677220,0,3 user reviews,2,1,3
677230,0,4 user reviews,1,3,4
677240,0,7 user reviews,3,4,7
677250,0,1 user reviews,1,0,1
677280,6,Mostly Positive,15,5,20
677300,7,Positive,19,2,21
677330,7,Positive,17,4,21
677340,8,Very Positive,307,68,375
677380,0,4 user reviews,4,0,4
677450,5,Mixed,55,29,84
677480,5,Mixed,187,133,320
677520,0,9 user reviews,7,2,9
677590,0,1 user reviews,1,0,1
677610,0,4 user reviews,3,1,4
677620,8,Very Positive,54,9,63
677640,0,3 user reviews,1,2,3
677650,5,Mixed,7,6,13
677680,0,2 user reviews,1,1,2
677690,0,1 user reviews,1,0,1
677691,0,1 user reviews,1,0,1
677692,0,1 user reviews,1,0,1
677700,0,3 user reviews,3,0,3
677710,0,5 user reviews,4,1,5
677720,0,8 user reviews,6,2,8
677730,5,Mixed,6,4,10
677790,6,Mostly Positive,10,3,13
677820,4,Mostly Negative,3,9,12
677850,5,Mixed,12,6,18
677870,0,5 user reviews,1,4,5
677880,0,5 user reviews,3,2,5
677900,6,Mostly Positive,8,3,11
677910,7,Positive,15,2,17
677920,0,5 user reviews,1,4,5
677940,0,8 user reviews,6,2,8
677950,7,Positive,26,5,31
677951,0,4 user reviews,1,3,4
677960,7,Positive,10,0,10
677990,0,4 user reviews,3,1,4
677991,7,Positive,8,2,10
677992,0,1 user reviews,1,0,1
677993,0,3 user reviews,1,2,3
677995,0,2 user reviews,0,2,2
677996,0,1 user reviews,0,1,1
677997,0,1 user reviews,1,0,1
677998,0,1 user reviews,0,1,1
677999,0,3 user reviews,3,0,3
678000,0,4 user reviews,2,2,4
678001,5,Mixed,14,18,32
678002,7,Positive,12,1,13
678003,0,8 user reviews,4,4,8
678004,4,Mostly Negative,9,17,26
678005,7,Positive,16,1,17
678008,0,4 user reviews,2,2,4
678009,0,1 user reviews,0,1,1
678010,0,5 user reviews,4,1,5
678030,4,Mostly Negative,8,21,29
678060,5,Mixed,4,6,10
678100,0,3 user reviews,3,0,3
678182,0,1 user reviews,1,0,1
678183,0,1 user reviews,0,1,1
678185,0,1 user reviews,1,0,1
678186,0,3 user reviews,2,1,3
678188,0,1 user reviews,1,0,1
678190,5,Mixed,30,32,62
678200,0,6 user reviews,5,1,6
678220,6,Mostly Positive,12,4,16
678240,0,2 user reviews,2,0,2
678290,0,5 user reviews,4,1,5
678310,7,Positive,48,1,49
678400,0,3 user reviews,3,0,3
678410,0,2 user reviews,1,1,2
678430,0,2 user reviews,2,0,2
678440,0,8 user reviews,8,0,8
678450,0,5 user reviews,1,4,5
678470,0,1 user reviews,1,0,1
678480,0,1 user reviews,0,1,1
678500,0,1 user reviews,0,1,1
678520,8,Very Positive,164,18,182
678530,7,Positive,11,0,11
678540,0,3 user reviews,3,0,3
678560,7,Positive,20,1,21
678570,0,1 user reviews,0,1,1
678620,0,4 user reviews,3,1,4
678760,0,6 user reviews,2,4,6
678820,6,Mostly Positive,22,6,28
678830,0,3 user reviews,3,0,3
678850,5,Mixed,12,6,18
678870,0,3 user reviews,3,0,3
678880,0,2 user reviews,2,0,2
678890,4,Mostly Negative,8,26,34
678900,6,Mostly Positive,466,180,646
678930,0,1 user reviews,1,0,1
678950,8,Very Positive,8915,1038,9953
678960,8,Very Positive,7303,682,7985
678970,8,Very Positive,64,4,68
679030,0,2 user reviews,2,0,2
679070,0,8 user reviews,4,4,8
679080,0,3 user reviews,1,2,3
679090,0,5 user reviews,5,0,5
679100,0,1 user reviews,1,0,1
679120,6,Mostly Positive,25,8,33
679160,0,2 user reviews,1,1,2
679190,5,Mixed,23,11,34
679230,7,Positive,10,0,10
679260,5,Mixed,70,88,158
679270,6,Mostly Positive,113,45,158
679290,0,1 user reviews,1,0,1
679300,7,Positive,13,0,13
679310,7,Positive,15,3,18
679390,0,2 user reviews,1,1,2
679410,0,5 user reviews,5,0,5
679430,0,1 user reviews,1,0,1
679470,0,7 user reviews,3,4,7
679480,0,3 user reviews,1,2,3
679490,0,2 user reviews,1,1,2
679500,7,Positive,19,0,19
679510,0,2 user reviews,1,1,2
679530,5,Mixed,5,7,12
679550,0,3 user reviews,2,1,3
679560,0,8 user reviews,8,0,8
679570,0,2 user reviews,2,0,2
679620,5,Mixed,5,5,10
679640,0,2 user reviews,1,1,2
679660,8,Very Positive,53,7,60
679670,0,5 user reviews,2,3,5
679690,0,4 user reviews,2,2,4
679720,0,2 user reviews,2,0,2
679740,0,9 user reviews,5,4,9
679750,8,Very Positive,195,20,215
679770,7,Positive,19,2,21
679780,0,1 user reviews,0,1,1
679820,4,Mostly Negative,5,8,13
679830,0,9 user reviews,9,0,9
679860,0,4 user reviews,0,4,4
679900,8,Very Positive,833,85,918
679930,0,4 user reviews,3,1,4
679990,0,3 user reviews,2,1,3
680030,7,Positive,11,1,12
680070,0,5 user reviews,3,2,5
680100,0,1 user reviews,1,0,1
680140,0,2 user reviews,0,2,2
680190,0,4 user reviews,4,0,4
680210,0,1 user reviews,1,0,1
680250,0,1 user reviews,1,0,1
680320,6,Mostly Positive,113,37,150
680330,5,Mixed,19,10,29
680340,6,Mostly Positive,45,12,57
680350,0,6 user reviews,5,1,6
680360,8,Very Positive,855,137,992
680380,5,Mixed,46,21,67
680390,7,Positive,13,2,15
680400,0,5 user reviews,4,1,5
680440,0,3 user reviews,1,2,3
680450,0,1 user reviews,1,0,1
680480,8,Very Positive,115,21,136
680500,0,1 user reviews,1,0,1
680550,0,6 user reviews,2,4,6
680560,0,1 user reviews,0,1,1
680590,8,Very Positive,73,4,77
680620,7,Positive,14,1,15
680640,4,Mostly Negative,9,25,34
680680,0,5 user reviews,4,1,5
680690,5,Mixed,6,6,12
680700,7,Positive,45,2,47
680750,7,Positive,15,3,18
680780,5,Mixed,8,5,13
680830,0,6 user reviews,6,0,6
680860,5,Mixed,16,11,27
680890,0,6 user reviews,6,0,6
680910,7,Positive,17,0,17
680930,0,6 user reviews,5,1,6
680940,0,6 user reviews,1,5,6
680950,6,Mostly Positive,19,8,27
680970,0,2 user reviews,2,0,2
680980,6,Mostly Positive,273,76,349
680990,5,Mixed,6,5,11
681000,0,6 user reviews,5,1,6
681020,0,2 user reviews,1,1,2
681030,0,1 user reviews,0,1,1
681040,0,6 user reviews,6,0,6
681060,7,Positive,25,4,29
681090,0,3 user reviews,2,1,3
681100,0,3 user reviews,2,1,3
681110,5,Mixed,34,15,49
681140,5,Mixed,9,9,18
681150,5,Mixed,4,6,10
681160,0,2 user reviews,0,2,2
681190,0,8 user reviews,8,0,8
681240,8,Very Positive,96,8,104
681260,0,1 user reviews,0,1,1
681280,8,Very Positive,1940,126,2066
681290,0,3 user reviews,3,0,3
681330,6,Mostly Positive,110,29,139
681340,0,1 user reviews,1,0,1
681350,0,2 user reviews,1,1,2
681360,0,2 user reviews,1,1,2
681380,0,3 user reviews,3,0,3
681390,8,Very Positive,313,52,365
681410,0,4 user reviews,4,0,4
681460,6,Mostly Positive,13,4,17
681480,0,7 user reviews,2,5,7
681490,0,2 user reviews,0,2,2
681520,5,Mixed,18,10,28
681530,7,Positive,21,0,21
681550,5,Mixed,7,5,12
681560,0,3 user reviews,2,1,3
681570,0,3 user reviews,2,1,3
681620,7,Positive,11,1,12
681630,0,5 user reviews,3,2,5
681640,7,Positive,35,1,36
681660,4,Mostly Negative,1801,2967,4768
681690,0,1 user reviews,1,0,1
681720,5,Mixed,27,39,66
681730,8,Very Positive,275,65,340
681750,0,8 user reviews,2,6,8
681760,0,2 user reviews,0,2,2
681780,0,8 user reviews,0,8,8
681790,7,Positive,9,1,10
681800,0,1 user reviews,1,0,1
681810,0,2 user reviews,0,2,2
681820,7,Positive,18,2,20
681830,0,4 user reviews,1,3,4
681840,7,Positive,8,2,10
681900,0,1 user reviews,1,0,1
681950,0,2 user reviews,2,0,2
681980,5,Mixed,6,5,11
681990,0,3 user reviews,3,0,3
682010,0,1 user reviews,0,1,1
682020,0,7 user reviews,7,0,7
682070,0,7 user reviews,5,2,7
682080,7,Positive,21,4,25
682100,0,5 user reviews,0,5,5
682130,8,Very Positive,593,103,696
682140,6,Mostly Positive,157,40,197
682150,6,Mostly Positive,20,8,28
682160,0,2 user reviews,2,0,2
682170,7,Positive,10,1,11
682180,0,5 user reviews,4,1,5
682230,7,Positive,25,1,26
682270,0,4 user reviews,2,2,4
682280,0,2 user reviews,2,0,2
682350,0,4 user reviews,2,2,4
682360,0,4 user reviews,2,2,4
682370,0,2 user reviews,1,1,2
682380,0,9 user reviews,5,4,9
682390,0,2 user reviews,1,1,2
682400,0,6 user reviews,4,2,6
682410,0,2 user reviews,2,0,2
682450,8,Very Positive,121,17,138
682470,0,6 user reviews,5,1,6
682480,0,5 user reviews,5,0,5
682490,0,1 user reviews,0,1,1
682500,0,8 user reviews,3,5,8
682510,0,7 user reviews,3,4,7
682520,0,1 user reviews,0,1,1
682530,6,Mostly Positive,206,69,275
682570,5,Mixed,87,39,126
682590,6,Mostly Positive,9,3,12
682600,0,1 user reviews,1,0,1
682610,6,Mostly Positive,9,3,12
682630,0,6 user reviews,4,2,6
682730,4,Mostly Negative,5,8,13
682780,7,Positive,9,2,11
682790,0,9 user reviews,4,5,9
682810,0,3 user reviews,3,0,3
682870,0,6 user reviews,6,0,6
682880,0,1 user reviews,1,0,1
682910,5,Mixed,8,7,15
682990,8,Very Positive,2703,431,3134
683000,6,Mostly Positive,14,6,20
683070,0,1 user reviews,1,0,1
683080,0,6 user reviews,1,5,6
683090,0,2 user reviews,2,0,2
683100,5,Mixed,59,48,107
683130,0,3 user reviews,3,0,3
683150,0,6 user reviews,2,4,6
683180,5,Mixed,7,4,11
683210,0,2 user reviews,0,2,2
683220,5,Mixed,9,6,15
683230,5,Mixed,5,7,12
683240,0,4 user reviews,4,0,4
683270,0,2 user reviews,1,1,2
683280,6,Mostly Positive,55,18,73
683310,0,4 user reviews,3,1,4
683320,9,Overwhelmingly Positive,9770,428,10198
683340,0,2 user reviews,2,0,2
683420,7,Positive,13,0,13
683430,0,1 user reviews,1,0,1
683440,0,7 user reviews,4,3,7
683490,0,1 user reviews,1,0,1
683530,0,9 user reviews,4,5,9
683600,4,Mostly Negative,3,12,15
683610,0,3 user reviews,3,0,3
683620,0,1 user reviews,1,0,1
683630,0,1 user reviews,1,0,1
683690,5,Mixed,10,11,21
683730,0,4 user reviews,3,1,4
683740,0,1 user reviews,0,1,1
683760,6,Mostly Positive,9,3,12
683770,6,Mostly Positive,23,8,31
683790,0,9 user reviews,6,3,9
683810,0,3 user reviews,0,3,3
683830,5,Mixed,18,11,29
683840,0,1 user reviews,1,0,1
683850,6,Mostly Positive,29,9,38
683870,7,Positive,10,0,10
683880,7,Positive,10,0,10
683890,7,Positive,10,0,10
683900,8,Very Positive,464,84,548
683910,0,5 user reviews,4,1,5
683940,6,Mostly Positive,99,28,127
683970,0,8 user reviews,7,1,8
683990,0,1 user reviews,1,0,1
683991,0,1 user reviews,1,0,1
683992,0,1 user reviews,1,0,1
683993,0,1 user reviews,1,0,1
683994,0,2 user reviews,2,0,2
684000,7,Positive,10,1,11
684040,5,Mixed,11,8,19
684050,6,Mostly Positive,52,21,73
684060,7,Positive,10,2,12
684130,0,9 user reviews,4,5,9
684170,0,1 user reviews,0,1,1
684200,5,Mixed,8,4,12
684230,0,7 user reviews,6,1,7
684260,0,1 user reviews,1,0,1
684270,8,Very Positive,142,11,153
684300,5,Mixed,15,15,30
684320,7,Positive,11,1,12
684330,0,3 user reviews,3,0,3
684340,0,2 user reviews,1,1,2
684410,8,Very Positive,1019,116,1135
684420,0,8 user reviews,3,5,8
684430,0,9 user reviews,9,0,9
684450,5,Mixed,78,50,128
684470,0,1 user reviews,1,0,1
684510,0,4 user reviews,2,2,4
684530,7,Positive,28,0,28
684560,0,4 user reviews,1,3,4
684570,0,4 user reviews,3,1,4
684580,5,Mixed,390,212,602
684590,7,Positive,11,1,12
684620,6,Mostly Positive,8,3,11
684630,8,Very Positive,300,15,315
684650,0,3 user reviews,2,1,3
684680,7,Positive,40,2,42
684690,7,Positive,12,0,12
684700,5,Mixed,8,7,15
684720,5,Mixed,29,13,42
684770,0,3 user reviews,2,1,3
684820,0,2 user reviews,1,1,2
684850,5,Mixed,10,12,22
684851,0,9 user reviews,5,4,9
684870,0,3 user reviews,3,0,3
684930,0,4 user reviews,1,3,4
684940,6,Mostly Positive,8,3,11
684970,0,3 user reviews,1,2,3
684980,0,5 user reviews,4,1,5
685050,0,8 user reviews,6,2,8
685060,0,7 user reviews,7,0,7
685080,0,2 user reviews,0,2,2
685120,0,1 user reviews,1,0,1
685130,0,3 user reviews,2,1,3
685230,0,2 user reviews,1,1,2
685240,8,Very Positive,79,6,85
685300,7,Positive,36,2,38
685340,8,Very Positive,61,12,73
685370,0,8 user reviews,3,5,8
685400,8,Very Positive,150,7,157
685430,0,4 user reviews,1,3,4
685500,0,2 user reviews,1,1,2
685680,8,Very Positive,90,17,107
685690,8,Very Positive,118,20,138
685730,0,1 user reviews,0,1,1
685750,5,Mixed,9,13,22
685760,0,2 user reviews,1,1,2
685770,0,4 user reviews,2,2,4
685790,4,Mostly Negative,3,11,14
685800,0,6 user reviews,5,1,6
685820,0,2 user reviews,2,0,2
685840,0,3 user reviews,3,0,3
685850,0,2 user reviews,2,0,2
685910,0,5 user reviews,5,0,5
685920,0,3 user reviews,3,0,3
685970,0,1 user reviews,0,1,1
685990,3,Negative,5,22,27
686000,0,1 user reviews,1,0,1
686010,0,3 user reviews,3,0,3
686030,7,Positive,12,0,12
686040,0,3 user reviews,2,1,3
686090,5,Mixed,11,6,17
686100,0,1 user reviews,0,1,1
686110,0,2 user reviews,1,1,2
686130,0,1 user reviews,1,0,1
686180,5,Mixed,38,37,75
686190,5,Mixed,70,40,110
686200,8,Very Positive,931,63,994
686240,0,1 user reviews,0,1,1
686260,5,Mixed,247,162,409
686280,0,8 user reviews,6,2,8
686300,0,1 user reviews,1,0,1
686360,6,Mostly Positive,24,8,32
686380,0,5 user reviews,1,4,5
686390,0,2 user reviews,1,1,2
686400,0,1 user reviews,1,0,1
686401,0,4 user reviews,3,1,4
686402,0,2 user reviews,2,0,2
686403,0,2 user reviews,2,0,2
686404,0,1 user reviews,1,0,1
686405,0,3 user reviews,3,0,3
686410,0,3 user reviews,2,1,3
686430,0,4 user reviews,4,0,4
686440,6,Mostly Positive,59,16,75
686450,7,Positive,18,0,18
686490,0,6 user reviews,0,6,6
686500,5,Mixed,16,10,26
686510,0,6 user reviews,6,0,6
686520,7,Positive,10,0,10
686550,5,Mixed,6,7,13
686570,5,Mixed,17,10,27
686580,0,4 user reviews,4,0,4
686600,4,Mostly Negative,51,87,138
686610,0,1 user reviews,0,1,1
686620,0,4 user reviews,2,2,4
686630,0,1 user reviews,1,0,1
686640,0,8 user reviews,3,5,8
686680,6,Mostly Positive,237,64,301
686710,5,Mixed,13,17,30
686711,5,Mixed,10,7,17
686720,7,Positive,25,6,31
686740,0,5 user reviews,4,1,5
686760,8,Very Positive,53,7,60
686770,7,Positive,38,0,38
686790,4,Mostly Negative,6,10,16
686800,5,Mixed,12,6,18
686810,8,Very Positive,9867,1558,11425
686880,0,1 user reviews,1,0,1
686900,6,Mostly Positive,40,11,51
686910,0,3 user reviews,2,1,3
686970,0,1 user reviews,1,0,1
686980,0,1 user reviews,1,0,1
686990,0,1 user reviews,1,0,1
687000,0,1 user reviews,1,0,1
687010,0,1 user reviews,1,0,1
687020,0,1 user reviews,1,0,1
687030,0,1 user reviews,1,0,1
687040,0,1 user reviews,1,0,1
687050,0,1 user reviews,1,0,1
687060,0,1 user reviews,1,0,1
687070,0,1 user reviews,1,0,1
687080,0,1 user reviews,1,0,1
687100,0,1 user reviews,1,0,1
687110,0,1 user reviews,1,0,1
687120,0,1 user reviews,1,0,1
687130,0,1 user reviews,1,0,1
687150,0,1 user reviews,1,0,1
687160,0,1 user reviews,1,0,1
687170,0,1 user reviews,1,0,1
687180,0,1 user reviews,1,0,1
687190,0,1 user reviews,1,0,1
687200,0,1 user reviews,1,0,1
687210,0,1 user reviews,1,0,1
687220,0,1 user reviews,1,0,1
687230,0,1 user reviews,1,0,1
687251,4,Mostly Negative,3,7,10
687260,8,Very Positive,335,38,373
687270,0,2 user reviews,1,1,2
687310,6,Mostly Positive,7,3,10
687360,7,Positive,11,0,11
687390,0,2 user reviews,0,2,2
687480,5,Mixed,10,9,19
687490,5,Mixed,11,9,20
687500,5,Mixed,22,18,40
687510,0,5 user reviews,4,1,5
687540,6,Mostly Positive,39,14,53
687560,0,9 user reviews,8,1,9
687570,0,4 user reviews,4,0,4
687590,0,1 user reviews,1,0,1
687600,0,4 user reviews,2,2,4
687610,0,3 user reviews,3,0,3
687640,0,3 user reviews,0,3,3
687720,0,5 user reviews,4,1,5
687750,5,Mixed,49,36,85
687760,0,7 user reviews,3,4,7
687830,8,Very Positive,57,7,64
687850,0,8 user reviews,5,3,8
687890,0,7 user reviews,5,2,7
687900,5,Mixed,5,5,10
687910,0,2 user reviews,2,0,2
687920,6,Mostly Positive,124,46,170
688000,0,9 user reviews,5,4,9
688020,0,8 user reviews,4,4,8
688050,0,1 user reviews,1,0,1
688060,8,Very Positive,296,29,325
688070,7,Positive,12,2,14
688090,0,6 user reviews,2,4,6
688110,0,2 user reviews,2,0,2
688120,0,1 user reviews,1,0,1
688130,8,Very Positive,1008,174,1182
688140,5,Mixed,54,27,81
688150,0,2 user reviews,0,2,2
688170,0,1 user reviews,1,0,1
688180,0,1 user reviews,0,1,1
688200,0,1 user reviews,0,1,1
688260,5,Mixed,25,12,37
688273,0,1 user reviews,1,0,1
688280,0,1 user reviews,1,0,1
688290,0,1 user reviews,1,0,1
688310,0,1 user reviews,1,0,1
688350,0,7 user reviews,0,7,7
688370,0,1 user reviews,1,0,1
688380,7,Positive,12,2,14
688400,7,Positive,11,1,12
688410,7,Positive,30,2,32
688420,8,Very Positive,1268,143,1411
688450,0,3 user reviews,1,2,3
688470,6,Mostly Positive,29,12,41
688480,5,Mixed,118,79,197
688570,5,Mixed,9,10,19
688620,0,2 user reviews,1,1,2
688630,0,1 user reviews,0,1,1
688660,5,Mixed,29,32,61
688680,6,Mostly Positive,12,4,16
688690,0,5 user reviews,4,1,5
688700,7,Positive,13,0,13
688720,0,5 user reviews,5,0,5
688740,8,Very Positive,61,2,63
688750,0,1 user reviews,0,1,1
688770,8,Very Positive,47,3,50
688780,0,1 user reviews,1,0,1
688790,0,3 user reviews,3,0,3
688800,0,9 user reviews,7,2,9
688860,0,3 user reviews,3,0,3
688880,5,Mixed,6,8,14
688900,0,1 user reviews,1,0,1
688930,0,7 user reviews,6,1,7
689000,0,7 user reviews,5,2,7
689020,0,5 user reviews,4,1,5
689030,0,1 user reviews,0,1,1
689040,0,9 user reviews,8,1,9
689050,0,2 user reviews,1,1,2
689100,0,3 user reviews,2,1,3
689120,0,1 user reviews,1,0,1
689170,0,9 user reviews,7,2,9
689180,5,Mixed,11,5,16
689210,0,1 user reviews,1,0,1
689270,0,1 user reviews,0,1,1
689290,7,Positive,13,1,14
689340,0,6 user reviews,4,2,6
689350,4,Mostly Negative,7,19,26
689360,4,Mostly Negative,5,10,15
689470,7,Positive,12,0,12
689480,0,2 user reviews,0,2,2
689520,4,Mostly Negative,6,15,21
689550,0,1 user reviews,1,0,1
689570,7,Positive,9,1,10
689610,0,2 user reviews,0,2,2
689620,5,Mixed,32,28,60
689650,5,Mixed,31,41,72
689660,0,1 user reviews,0,1,1
689700,5,Mixed,8,5,13
689710,7,Positive,20,1,21
689740,0,4 user reviews,4,0,4
689790,5,Mixed,69,43,112
689800,5,Mixed,9,13,22
689810,5,Mixed,9,5,14
689860,6,Mostly Positive,13,5,18
689870,7,Positive,8,2,10
689900,8,Very Positive,86,14,100
689910,8,Very Positive,152,12,164
689920,6,Mostly Positive,7,3,10
689950,7,Positive,10,0,10
690000,0,2 user reviews,1,1,2
690040,8,Very Positive,1952,419,2371
690080,0,3 user reviews,2,1,3
690120,7,Positive,23,3,26
690130,0,3 user reviews,3,0,3
690140,6,Mostly Positive,78,30,108
690150,6,Mostly Positive,19,5,24
690180,7,Positive,29,1,30
690200,0,6 user reviews,6,0,6
690220,0,1 user reviews,1,0,1
690240,5,Mixed,10,6,16
690250,0,5 user reviews,2,3,5
690260,0,1 user reviews,1,0,1
690280,0,7 user reviews,4,3,7
690310,0,7 user reviews,6,1,7
690330,0,2 user reviews,2,0,2
690350,0,5 user reviews,3,2,5
690400,7,Positive,13,1,14
690410,0,1 user reviews,1,0,1
690420,7,Positive,49,0,49
690430,0,2 user reviews,1,1,2
690440,0,2 user reviews,2,0,2
690460,0,6 user reviews,2,4,6
690530,5,Mixed,115,74,189
690550,7,Positive,12,1,13
690560,8,Very Positive,65,12,77
690570,0,1 user reviews,1,0,1
690580,0,4 user reviews,0,4,4
690610,0,1 user reviews,0,1,1
690620,8,Very Positive,47,10,57
690630,7,Positive,11,0,11
690640,8,Very Positive,1234,108,1342
690660,0,1 user reviews,1,0,1
690670,0,4 user reviews,1,3,4
690710,0,9 user reviews,9,0,9
690730,0,2 user reviews,1,1,2
690740,5,Mixed,24,17,41
690790,8,Very Positive,3556,846,4402
690810,5,Mixed,175,137,312
690820,0,2 user reviews,0,2,2
690830,8,Very Positive,2621,436,3057
690840,0,1 user reviews,0,1,1
690850,0,2 user reviews,2,0,2
690950,0,3 user reviews,3,0,3
691020,0,1 user reviews,0,1,1
691080,4,Mostly Negative,7,22,29
691110,7,Positive,9,1,10
691120,0,2 user reviews,2,0,2
691140,0,4 user reviews,3,1,4
691150,8,Very Positive,46,4,50
691160,8,Very Positive,212,18,230
691190,5,Mixed,14,8,22
691220,0,2 user reviews,1,1,2
691240,7,Positive,8,2,10
691250,0,9 user reviews,8,1,9
691260,8,Very Positive,378,38,416
691280,5,Mixed,85,41,126
691300,0,3 user reviews,3,0,3
691310,0,3 user reviews,2,1,3
691320,6,Mostly Positive,182,57,239
691390,6,Mostly Positive,16,6,22
691420,0,2 user reviews,0,2,2
691430,7,Positive,20,0,20
691440,0,2 user reviews,2,0,2
691441,0,5 user reviews,5,0,5
691450,8,Very Positive,459,10,469
691480,0,2 user reviews,2,0,2
691490,0,6 user reviews,6,0,6
691500,0,1 user reviews,1,0,1
691510,0,3 user reviews,1,2,3
691570,0,2 user reviews,2,0,2
691580,0,4 user reviews,4,0,4
691590,5,Mixed,6,6,12
691600,0,4 user reviews,4,0,4
691620,0,5 user reviews,4,1,5
691630,5,Mixed,34,22,56
691650,0,2 user reviews,2,0,2
691680,0,2 user reviews,2,0,2
691690,5,Mixed,328,161,489
691700,0,2 user reviews,1,1,2
691720,0,6 user reviews,4,2,6
691750,0,6 user reviews,4,2,6
691770,8,Very Positive,108,6,114
691820,0,4 user reviews,3,1,4
691830,8,Very Positive,96,18,114
691860,0,5 user reviews,3,2,5
691890,0,5 user reviews,4,1,5
691910,0,1 user reviews,1,0,1
691980,0,7 user reviews,0,7,7
692010,0,4 user reviews,2,2,4
692030,5,Mixed,27,35,62
692080,7,Positive,18,1,19
692100,8,Very Positive,130,32,162
692110,0,1 user reviews,1,0,1
692120,0,6 user reviews,5,1,6
692140,0,1 user reviews,1,0,1
692150,0,2 user reviews,2,0,2
692151,7,Positive,11,0,11
692152,0,1 user reviews,1,0,1
692153,0,4 user reviews,4,0,4
692170,0,4 user reviews,0,4,4
692190,0,6 user reviews,5,1,6
692200,5,Mixed,19,9,28
692240,0,1 user reviews,0,1,1
692310,0,1 user reviews,0,1,1
692360,6,Mostly Positive,18,6,24
692500,0,1 user reviews,1,0,1
692510,7,Positive,12,0,12
692530,0,2 user reviews,1,1,2
692590,0,7 user reviews,3,4,7
692630,0,2 user reviews,0,2,2
692660,0,2 user reviews,2,0,2
692680,0,3 user reviews,3,0,3
692690,7,Positive,41,7,48
692770,0,3 user reviews,3,0,3
692780,4,Mostly Negative,3,9,12
692790,0,7 user reviews,3,4,7
692830,5,Mixed,9,8,17
692840,5,Mixed,153,204,357
692850,9,Overwhelmingly Positive,6665,294,6959
692890,8,Very Positive,338,15,353
692930,6,Mostly Positive,31,8,39
692950,0,6 user reviews,6,0,6
693000,0,2 user reviews,1,1,2
693030,0,5 user reviews,5,0,5
693050,0,6 user reviews,1,5,6
693090,0,6 user reviews,3,3,6
693160,0,9 user reviews,2,7,9
693170,8,Very Positive,95,1,96
693180,5,Mixed,7,6,13
693190,0,4 user reviews,1,3,4
693210,6,Mostly Positive,15,5,20
693240,0,8 user reviews,4,4,8
693250,5,Mixed,16,10,26
693280,0,2 user reviews,0,2,2
693300,0,2 user reviews,1,1,2
693310,0,2 user reviews,1,1,2
693320,0,3 user reviews,2,1,3
693330,0,2 user reviews,2,0,2
693380,0,5 user reviews,5,0,5
693400,0,3 user reviews,0,3,3
693430,0,1 user reviews,0,1,1
693450,7,Positive,11,0,11
693470,0,8 user reviews,7,1,8
693500,0,1 user reviews,0,1,1
693510,0,2 user reviews,2,0,2
693560,0,4 user reviews,4,0,4
693580,5,Mixed,47,33,80
693650,0,5 user reviews,5,0,5
693670,6,Mostly Positive,19,8,27
693700,8,Very Positive,89,15,104
693710,0,1 user reviews,1,0,1
693750,5,Mixed,39,26,65
693790,0,8 user reviews,4,4,8
693800,5,Mixed,15,13,28
693820,0,1 user reviews,0,1,1
693830,0,3 user reviews,2,1,3
693880,4,Mostly Negative,5,10,15
693890,5,Mixed,7,5,12
693910,0,2 user reviews,1,1,2
693950,0,5 user reviews,5,0,5
693960,6,Mostly Positive,17,7,24
694050,0,2 user reviews,1,1,2
694070,0,5 user reviews,3,2,5
694090,5,Mixed,59,34,93
694140,0,4 user reviews,2,2,4
694150,0,2 user reviews,2,0,2
694190,0,8 user reviews,4,4,8
694210,0,1 user reviews,1,0,1
694370,8,Very Positive,64,4,68
694380,0,1 user reviews,1,0,1
694390,0,6 user reviews,6,0,6
694420,0,1 user reviews,1,0,1
694430,0,3 user reviews,0,3,3
694440,0,6 user reviews,0,6,6
694470,0,5 user reviews,1,4,5
694480,6,Mostly Positive,10,4,14
694490,3,Negative,3,13,16
694500,8,Very Positive,239,49,288
694510,0,1 user reviews,1,0,1
694520,0,7 user reviews,6,1,7
694630,0,1 user reviews,1,0,1
694653,0,1 user reviews,1,0,1
694660,0,2 user reviews,2,0,2
694670,0,1 user reviews,1,0,1
694680,6,Mostly Positive,19,7,26
694730,5,Mixed,6,6,12
694760,0,7 user reviews,7,0,7
694770,8,Very Positive,200,18,218
694790,7,Positive,16,2,18
694830,0,3 user reviews,3,0,3
694870,7,Positive,19,2,21
694880,5,Mixed,221,139,360
694930,0,7 user reviews,4,3,7
694950,7,Positive,11,0,11
694980,0,6 user reviews,5,1,6
695050,8,Very Positive,85,17,102
695100,8,Very Positive,61,13,74
695110,0,7 user reviews,7,0,7
695290,6,Mostly Positive,846,316,1162
695320,0,2 user reviews,2,0,2
695360,0,4 user reviews,0,4,4
695370,0,2 user reviews,2,0,2
695371,0,2 user reviews,1,1,2
695420,0,2 user reviews,2,0,2
695440,0,2 user reviews,1,1,2
695450,6,Mostly Positive,11,4,15
695490,0,6 user reviews,4,2,6
695510,7,Positive,8,2,10
695520,0,3 user reviews,1,2,3
695570,7,Positive,10,0,10
695600,6,Mostly Positive,112,39,151
695630,5,Mixed,6,7,13
695660,7,Positive,18,3,21
695680,6,Mostly Positive,92,25,117
695690,5,Mixed,26,34,60
695740,0,9 user reviews,1,8,9
695743,0,2 user reviews,1,1,2
695760,5,Mixed,13,10,23
695810,0,5 user reviews,2,3,5
695820,0,1 user reviews,1,0,1
695860,0,8 user reviews,4,4,8
695910,0,5 user reviews,3,2,5
695920,8,Very Positive,290,49,339
695940,0,3 user reviews,2,1,3
695950,0,3 user reviews,3,0,3
695960,0,5 user reviews,5,0,5
695970,8,Very Positive,51,4,55
695980,0,4 user reviews,3,1,4
695990,0,1 user reviews,1,0,1
696000,0,6 user reviews,5,1,6
696010,0,2 user reviews,2,0,2
696020,0,2 user reviews,2,0,2
696030,0,1 user reviews,1,0,1
696040,0,3 user reviews,2,1,3
696060,7,Positive,11,0,11
696110,0,8 user reviews,4,4,8
696140,8,Very Positive,72,12,84
696150,7,Positive,10,0,10
696170,8,Very Positive,628,134,762
696180,5,Mixed,104,48,152
696190,0,5 user reviews,3,2,5
696200,7,Positive,18,0,18
696220,8,Very Positive,268,33,301
696230,0,6 user reviews,6,0,6
696250,0,9 user reviews,3,6,9
696280,6,Mostly Positive,9,3,12
696310,0,1 user reviews,1,0,1
696360,5,Mixed,21,10,31
696370,6,Mostly Positive,329,118,447
696400,0,8 user reviews,3,5,8
696410,0,3 user reviews,2,1,3
696440,0,3 user reviews,2,1,3
696460,7,Positive,20,4,24
696470,0,3 user reviews,1,2,3
696480,8,Very Positive,217,5,222
696490,7,Positive,10,1,11
696500,3,Negative,1,10,11
696510,0,6 user reviews,5,1,6
696530,6,Mostly Positive,83,23,106
696540,0,2 user reviews,1,1,2
696560,7,Positive,26,6,32
696580,0,4 user reviews,3,1,4
696590,8,Very Positive,59,11,70
696650,5,Mixed,105,55,160
696680,5,Mixed,257,168,425
696710,0,5 user reviews,5,0,5
696740,0,1 user reviews,1,0,1
696760,0,6 user reviews,5,1,6
696790,5,Mixed,253,139,392
696810,5,Mixed,6,4,10
696840,0,9 user reviews,5,4,9
696860,0,3 user reviews,3,0,3
696880,0,4 user reviews,3,1,4
696910,0,4 user reviews,4,0,4
696940,6,Mostly Positive,34,13,47
697000,0,2 user reviews,0,2,2
697010,5,Mixed,8,9,17
697020,5,Mixed,6,8,14
697040,0,1 user reviews,1,0,1
697130,0,3 user reviews,0,3,3
697160,0,1 user reviews,0,1,1
697250,5,Mixed,5,7,12
697320,0,4 user reviews,1,3,4
697340,0,3 user reviews,1,2,3
697350,0,3 user reviews,3,0,3
697370,0,5 user reviews,4,1,5
697380,0,1 user reviews,0,1,1
697430,0,2 user reviews,2,0,2
697440,8,Very Positive,194,5,199
697490,0,3 user reviews,0,3,3
697550,8,Very Positive,694,100,794
697580,5,Mixed,8,5,13
697600,0,6 user reviews,6,0,6
697630,5,Mixed,9,11,20
697650,8,Very Positive,54,4,58
697660,5,Mixed,6,4,10
697670,0,7 user reviews,6,1,7
697710,0,9 user reviews,9,0,9
697730,0,2 user reviews,1,1,2
697760,7,Positive,13,1,14
697800,7,Positive,14,0,14
697850,5,Mixed,6,4,10
697860,7,Positive,34,6,40
697870,0,2 user reviews,1,1,2
697880,0,6 user reviews,2,4,6
697910,0,3 user reviews,3,0,3
697930,5,Mixed,9,5,14
697950,0,3 user reviews,2,1,3
697960,0,9 user reviews,7,2,9
698030,0,1 user reviews,0,1,1
698040,0,9 user reviews,6,3,9
698050,0,2 user reviews,1,1,2
698060,0,1 user reviews,1,0,1
698080,0,3 user reviews,1,2,3
698110,6,Mostly Positive,10,4,14
698160,0,4 user reviews,0,4,4
698240,7,Positive,14,0,14
698250,0,7 user reviews,7,0,7
698260,8,Very Positive,212,47,259
698280,6,Mostly Positive,19,6,25
698300,7,Positive,22,2,24
698330,6,Mostly Positive,19,6,25
698360,0,5 user reviews,4,1,5
698410,0,4 user reviews,1,3,4
698440,0,2 user reviews,2,0,2
698450,7,Positive,13,0,13
698480,0,1 user reviews,1,0,1
698500,0,8 user reviews,6,2,8
698520,7,Positive,11,2,13
698540,8,Very Positive,259,23,282
698570,0,4 user reviews,4,0,4
698590,0,9 user reviews,8,1,9
698600,0,2 user reviews,0,2,2
698610,0,2 user reviews,1,1,2
698620,7,Positive,8,2,10
698640,6,Mostly Positive,484,158,642
698650,7,Positive,10,0,10
698710,5,Mixed,8,11,19
698740,0,5 user reviews,5,0,5
698760,0,8 user reviews,7,1,8
698770,7,Positive,19,1,20
698780,8,Very Positive,147,4,151
698790,7,Positive,16,3,19
698830,5,Mixed,15,11,26
698870,7,Positive,34,7,41
698890,0,6 user reviews,6,0,6
698910,7,Positive,9,1,10
698950,0,1 user reviews,1,0,1
698980,0,3 user reviews,2,1,3
699010,0,8 user reviews,2,6,8
699060,0,2 user reviews,1,1,2
699080,7,Positive,33,7,40
699090,0,2 user reviews,2,0,2
699100,5,Mixed,9,6,15
699150,7,Positive,35,3,38
699160,0,4 user reviews,2,2,4
699170,8,Very Positive,1892,162,2054
699180,8,Very Positive,199,18,217
699200,0,2 user reviews,2,0,2
699230,0,3 user reviews,3,0,3
699240,5,Mixed,9,4,13
699290,0,7 user reviews,7,0,7
699350,7,Positive,22,0,22
699370,0,1 user reviews,0,1,1
699390,7,Positive,18,3,21
699410,0,8 user reviews,6,2,8
699470,0,1 user reviews,0,1,1
699480,5,Mixed,4,6,10
699510,0,1 user reviews,0,1,1
699540,7,Positive,30,1,31
699550,0,7 user reviews,1,6,7
699570,0,2 user reviews,0,2,2
699590,5,Mixed,10,6,16
699600,8,Very Positive,71,3,74
699670,5,Mixed,75,37,112
699680,5,Mixed,8,5,13
699700,5,Mixed,8,11,19
699740,5,Mixed,48,35,83
699750,0,6 user reviews,4,2,6
699760,4,Mostly Negative,3,9,12
699770,5,Mixed,33,27,60
699780,7,Positive,26,3,29
699790,0,1 user reviews,1,0,1
699820,0,6 user reviews,2,4,6
699830,0,4 user reviews,3,1,4
699850,0,4 user reviews,3,1,4
699860,0,3 user reviews,1,2,3
699870,5,Mixed,20,23,43
699920,6,Mostly Positive,147,49,196
699930,0,1 user reviews,1,0,1
699940,5,Mixed,24,12,36
699970,0,2 user reviews,1,1,2
699990,0,5 user reviews,3,2,5
700010,0,9 user reviews,5,4,9
700030,5,Mixed,553,771,1324
700060,5,Mixed,6,7,13
700100,0,9 user reviews,7,2,9
700140,0,5 user reviews,5,0,5
700160,8,Very Positive,60,8,68
700180,0,2 user reviews,2,0,2
700200,7,Positive,16,4,20
700230,0,5 user reviews,5,0,5
700240,0,8 user reviews,4,4,8
700280,8,Very Positive,377,89,466
700282,5,Mixed,418,327,745
700290,0,1 user reviews,1,0,1
700320,0,8 user reviews,7,1,8
700360,0,6 user reviews,4,2,6
700400,0,3 user reviews,3,0,3
700440,5,Mixed,6,5,11
700460,0,1 user reviews,1,0,1
700470,4,Mostly Negative,3,8,11
700520,7,Positive,13,0,13
700540,0,2 user reviews,1,1,2
700560,0,3 user reviews,1,2,3
700590,0,6 user reviews,4,2,6
700620,6,Mostly Positive,14,4,18
700650,0,6 user reviews,4,2,6
700660,5,Mixed,27,14,41
700730,0,1 user reviews,1,0,1
700740,5,Mixed,14,14,28
700750,0,9 user reviews,7,2,9
700770,0,9 user reviews,3,6,9
700800,0,3 user reviews,0,3,3
700830,0,9 user reviews,8,1,9
700850,0,7 user reviews,6,1,7
700851,0,1 user reviews,0,1,1
700870,0,4 user reviews,4,0,4
700880,0,1 user reviews,1,0,1
700910,0,2 user reviews,2,0,2
700920,0,5 user reviews,3,2,5
700940,0,1 user reviews,0,1,1
700960,0,1 user reviews,1,0,1
700990,0,9 user reviews,4,5,9
701040,7,Positive,30,0,30
701080,7,Positive,13,0,13
701160,8,Very Positive,1725,292,2017
701180,7,Positive,18,0,18
701270,0,6 user reviews,6,0,6
701280,0,5 user reviews,3,2,5
701290,0,9 user reviews,6,3,9
701370,0,1 user reviews,0,1,1
701380,7,Positive,35,1,36
701420,7,Positive,12,0,12
701440,7,Positive,12,0,12
701460,0,7 user reviews,3,4,7
701470,7,Positive,35,2,37
701531,8,Very Positive,126,2,128
701540,5,Mixed,7,5,12
701610,7,Positive,9,2,11
701720,5,Mixed,17,9,26
701730,8,Very Positive,48,8,56
701740,0,6 user reviews,3,3,6
701760,7,Positive,11,2,13
701800,0,2 user reviews,2,0,2
701810,7,Positive,13,0,13
701820,0,2 user reviews,2,0,2
701860,7,Positive,16,3,19
701870,7,Positive,30,3,33
701880,0,1 user reviews,1,0,1
701910,0,3 user reviews,3,0,3
701930,0,2 user reviews,2,0,2
701940,0,4 user reviews,4,0,4
701950,7,Positive,8,2,10
701960,0,4 user reviews,2,2,4
701970,0,4 user reviews,3,1,4
701980,0,3 user reviews,2,1,3
701990,0,1 user reviews,1,0,1
702030,7,Positive,10,1,11
702040,0,2 user reviews,2,0,2
702050,8,Very Positive,312,31,343
702080,0,1 user reviews,0,1,1
702110,8,Very Positive,58,5,63
702120,6,Mostly Positive,47,13,60
702150,0,4 user reviews,3,1,4
702180,0,1 user reviews,0,1,1
702190,4,Mostly Negative,4,10,14
702200,0,6 user reviews,0,6,6
702210,5,Mixed,10,6,16
702220,0,7 user reviews,5,2,7
702270,0,1 user reviews,1,0,1
702300,0,3 user reviews,3,0,3
702310,0,2 user reviews,1,1,2
702330,0,1 user reviews,1,0,1
702350,6,Mostly Positive,486,193,679
702360,0,3 user reviews,3,0,3
702430,5,Mixed,8,8,16
702510,4,Mostly Negative,7,13,20
702540,6,Mostly Positive,126,42,168
702550,0,2 user reviews,2,0,2
702600,7,Positive,8,2,10
702660,8,Very Positive,124,10,134
702670,8,Very Positive,2007,341,2348
702700,5,Mixed,35,41,76
702790,0,4 user reviews,3,1,4
702820,0,1 user reviews,1,0,1
702890,8,Very Positive,1045,221,1266
702940,0,3 user reviews,3,0,3
702950,5,Mixed,7,9,16
702960,5,Mixed,11,6,17
702961,0,4 user reviews,3,1,4
702962,0,1 user reviews,0,1,1
702964,0,4 user reviews,3,1,4
702965,0,7 user reviews,5,2,7
702967,0,6 user reviews,3,3,6
702968,0,1 user reviews,0,1,1
702980,7,Positive,24,1,25
702990,7,Positive,38,7,45
703000,0,1 user reviews,1,0,1
703050,0,2 user reviews,2,0,2
703080,8,Very Positive,13039,1599,14638
703120,0,5 user reviews,3,2,5
703140,0,2 user reviews,2,0,2
703180,6,Mostly Positive,28,11,39
703200,0,3 user reviews,2,1,3
703210,0,5 user reviews,2,3,5
703250,0,1 user reviews,1,0,1
703300,5,Mixed,6,6,12
703310,5,Mixed,14,7,21
703320,8,Very Positive,149,11,160
703360,0,2 user reviews,0,2,2
703400,0,7 user reviews,5,2,7
703440,0,1 user reviews,1,0,1
703460,0,1 user reviews,1,0,1
703461,0,1 user reviews,1,0,1
703490,0,5 user reviews,3,2,5
703500,7,Positive,28,3,31
703510,6,Mostly Positive,130,46,176
703530,0,8 user reviews,2,6,8
703540,0,6 user reviews,4,2,6
703560,0,6 user reviews,6,0,6
703600,4,Mostly Negative,8,14,22
703620,8,Very Positive,44,7,51
703630,7,Positive,20,0,20
703700,6,Mostly Positive,41,11,52
703720,0,9 user reviews,9,0,9
703730,7,Positive,17,3,20
703800,0,1 user reviews,1,0,1
703840,8,Very Positive,215,27,242
703860,5,Mixed,514,289,803
703870,5,Mixed,7,4,11
703880,7,Positive,35,5,40
703920,4,Mostly Negative,4,9,13
703940,0,3 user reviews,1,2,3
703960,0,2 user reviews,2,0,2
704010,6,Mostly Positive,35,11,46
704020,0,2 user reviews,2,0,2
704030,6,Mostly Positive,120,50,170
704060,0,4 user reviews,3,1,4
704070,0,4 user reviews,2,2,4
704110,5,Mixed,5,7,12
704140,0,2 user reviews,0,2,2
704150,0,4 user reviews,3,1,4
704180,7,Positive,22,1,23
704190,5,Mixed,8,5,13
704200,7,Positive,16,1,17
704210,5,Mixed,50,70,120
704230,5,Mixed,40,33,73
704250,5,Mixed,9,6,15
704260,0,3 user reviews,3,0,3
704270,5,Mixed,3842,1662,5504
704282,0,4 user reviews,3,1,4
704283,5,Mixed,16,10,26
704285,0,5 user reviews,4,1,5
704286,0,9 user reviews,4,5,9
704300,6,Mostly Positive,39,14,53
704310,0,8 user reviews,5,3,8
704360,8,Very Positive,106,17,123
704370,0,5 user reviews,2,3,5
704430,0,2 user reviews,1,1,2
704440,0,5 user reviews,5,0,5
704450,8,Very Positive,1911,318,2229
704470,8,Very Positive,64,0,64
704480,7,Positive,13,1,14
704510,8,Very Positive,73,10,83
704540,0,4 user reviews,2,2,4
704630,0,1 user reviews,1,0,1
704640,8,Very Positive,171,23,194
704670,0,1 user reviews,1,0,1
704680,6,Mostly Positive,19,5,24
704690,6,Mostly Positive,27,7,34
704700,0,1 user reviews,1,0,1
704710,8,Very Positive,77,4,81
704720,0,1 user reviews,1,0,1
704730,0,1 user reviews,1,0,1
704740,8,Very Positive,75,18,93
704760,0,7 user reviews,6,1,7
704810,0,8 user reviews,7,1,8
704830,5,Mixed,30,39,69
704840,7,Positive,48,1,49
704850,8,Very Positive,2644,430,3074
704860,8,Very Positive,58,14,72
704880,5,Mixed,19,11,30
704910,7,Positive,21,2,23
704920,0,4 user reviews,4,0,4
704940,0,1 user reviews,0,1,1
704950,5,Mixed,9,5,14
704990,0,1 user reviews,1,0,1
705020,6,Mostly Positive,16,5,21
705050,0,6 user reviews,2,4,6
705060,6,Mostly Positive,10,4,14
705070,4,Mostly Negative,12,20,32
705090,5,Mixed,9,6,15
705100,8,Very Positive,49,10,59
705120,8,Very Positive,283,50,333
705150,0,3 user reviews,1,2,3
705160,5,Mixed,5,5,10
705210,0,2 user reviews,1,1,2
705230,0,3 user reviews,1,2,3
705240,0,2 user reviews,1,1,2
705250,6,Mostly Positive,10,3,13
705260,0,1 user reviews,1,0,1
705280,8,Very Positive,127,25,152
705290,8,Very Positive,90,18,108
705300,5,Mixed,11,12,23
705340,7,Positive,12,2,14
705380,6,Mostly Positive,9,3,12
705390,5,Mixed,6,6,12
705440,0,3 user reviews,2,1,3
705450,7,Positive,28,5,33
705500,7,Positive,19,1,20
705520,0,1 user reviews,0,1,1
705530,0,4 user reviews,4,0,4
705540,0,2 user reviews,1,1,2
705550,7,Positive,12,2,14
705560,0,1 user reviews,1,0,1
705610,6,Mostly Positive,20,6,26
705620,7,Positive,12,3,15
705640,5,Mixed,6,4,10
705670,7,Positive,12,1,13
705700,0,8 user reviews,4,4,8
705710,4,Mostly Negative,11,34,45
705740,5,Mixed,20,11,31
705750,7,Positive,33,4,37
705770,0,3 user reviews,3,0,3
705780,0,4 user reviews,4,0,4
705800,0,3 user reviews,2,1,3
705870,7,Positive,42,5,47
705920,0,1 user reviews,1,0,1
705930,0,1 user reviews,0,1,1
705950,0,2 user reviews,1,1,2
706010,0,2 user reviews,0,2,2
706020,5,Mixed,266,139,405
706030,0,8 user reviews,6,2,8
706060,0,4 user reviews,1,3,4
706070,0,1 user reviews,0,1,1
706080,0,4 user reviews,0,4,4
706090,0,4 user reviews,4,0,4
706100,0,1 user reviews,1,0,1
706110,0,1 user reviews,1,0,1
706130,7,Positive,44,5,49
706180,0,8 user reviews,1,7,8
706200,0,2 user reviews,1,1,2
706220,6,Mostly Positive,13342,5202,18544
706230,0,6 user reviews,4,2,6
706240,0,4 user reviews,3,1,4
706260,5,Mixed,9,6,15
706261,0,2 user reviews,2,0,2
706280,7,Positive,15,2,17
706290,0,1 user reviews,0,1,1
706320,5,Mixed,7,9,16
706330,0,9 user reviews,5,4,9
706350,0,2 user reviews,1,1,2
706370,0,6 user reviews,5,1,6
706380,0,1 user reviews,1,0,1
706390,0,8 user reviews,7,1,8
706400,0,3 user reviews,3,0,3
706440,5,Mixed,9,5,14
706450,0,8 user reviews,6,2,8
706490,5,Mixed,43,29,72
706510,0,8 user reviews,8,0,8
706520,5,Mixed,15,8,23
706560,8,Very Positive,218,13,231
706570,0,5 user reviews,3,2,5
706580,0,3 user reviews,3,0,3
706690,0,1 user reviews,0,1,1
706710,7,Positive,15,2,17
706770,7,Positive,19,1,20
706850,7,Positive,16,0,16
706870,0,3 user reviews,3,0,3
706880,6,Mostly Positive,11,4,15
706910,0,1 user reviews,1,0,1
706950,0,6 user reviews,2,4,6
706960,6,Mostly Positive,18,6,24
707000,0,4 user reviews,1,3,4
707010,6,Mostly Positive,457,195,652
707030,8,Very Positive,2406,273,2679
707040,0,1 user reviews,0,1,1
707060,0,9 user reviews,3,6,9
707080,5,Mixed,7,6,13
707110,7,Positive,15,2,17
707140,0,9 user reviews,1,8,9
707172,0,1 user reviews,0,1,1
707173,0,1 user reviews,0,1,1
707174,0,1 user reviews,0,1,1
707175,0,1 user reviews,0,1,1
707176,0,1 user reviews,0,1,1
707177,0,1 user reviews,0,1,1
707178,0,1 user reviews,0,1,1
707179,0,1 user reviews,0,1,1
707180,0,1 user reviews,0,1,1
707181,0,2 user reviews,1,1,2
707182,0,2 user reviews,1,1,2
707183,0,2 user reviews,1,1,2
707185,0,2 user reviews,2,0,2
707186,0,1 user reviews,0,1,1
707187,0,1 user reviews,0,1,1
707188,0,1 user reviews,0,1,1
707190,0,1 user reviews,0,1,1
707191,0,1 user reviews,0,1,1
707192,0,1 user reviews,0,1,1
707193,0,1 user reviews,0,1,1
707194,0,1 user reviews,0,1,1
707195,0,1 user reviews,0,1,1
707220,0,4 user reviews,2,2,4
707230,0,2 user reviews,2,0,2
707240,0,7 user reviews,6,1,7
707280,0,4 user reviews,1,3,4
707300,5,Mixed,94,54,148
707320,0,3 user reviews,1,2,3
707350,0,7 user reviews,4,3,7
707390,0,6 user reviews,5,1,6
707400,7,Positive,10,0,10
707410,0,3 user reviews,2,1,3
707450,4,Mostly Negative,6,10,16
707480,0,2 user reviews,2,0,2
707490,0,2 user reviews,2,0,2
707560,0,1 user reviews,1,0,1
707580,6,Mostly Positive,66,17,83
707590,6,Mostly Positive,37,13,50
707610,0,7 user reviews,4,3,7
707670,0,8 user reviews,1,7,8
707680,0,7 user reviews,7,0,7
707720,0,5 user reviews,1,4,5
707740,0,1 user reviews,1,0,1
707750,0,7 user reviews,1,6,7
707770,0,6 user reviews,2,4,6
707850,0,6 user reviews,3,3,6
707860,0,5 user reviews,2,3,5
707870,7,Positive,20,5,25
707920,0,3 user reviews,1,2,3
707960,0,6 user reviews,2,4,6
708120,0,7 user reviews,3,4,7
708140,0,1 user reviews,1,0,1
708150,7,Positive,19,3,22
708172,0,5 user reviews,4,1,5
708173,5,Mixed,13,10,23
708190,5,Mixed,12,6,18
708260,0,5 user reviews,5,0,5
708280,0,1 user reviews,1,0,1
708300,0,7 user reviews,5,2,7
708310,0,6 user reviews,3,3,6
708340,7,Positive,12,1,13
708370,5,Mixed,24,12,36
708430,0,6 user reviews,3,3,6
708450,5,Mixed,16,11,27
708490,0,1 user reviews,1,0,1
708510,0,9 user reviews,3,6,9
708521,0,1 user reviews,0,1,1
708580,6,Mostly Positive,130,39,169
708590,0,1 user reviews,1,0,1
708630,0,4 user reviews,0,4,4
708640,0,5 user reviews,3,2,5
708710,5,Mixed,12,8,20
708760,6,Mostly Positive,32,9,41
708770,6,Mostly Positive,713,298,1011
708780,7,Positive,12,0,12
708820,7,Positive,18,3,21
708830,0,4 user reviews,2,2,4
708850,7,Positive,15,2,17
708870,0,5 user reviews,5,0,5
708880,7,Positive,32,1,33
708890,7,Positive,17,1,18
708920,0,4 user reviews,4,0,4
708930,0,1 user reviews,1,0,1
708950,7,Positive,25,1,26
708970,0,4 user reviews,2,2,4
709020,0,1 user reviews,0,1,1
709050,0,1 user reviews,0,1,1
709140,0,5 user reviews,4,1,5
709150,8,Very Positive,99,10,109
709170,7,Positive,22,0,22
709174,0,1 user reviews,1,0,1
709190,0,9 user reviews,3,6,9
709280,0,3 user reviews,1,2,3
709290,0,1 user reviews,1,0,1
709300,0,1 user reviews,1,0,1
709340,0,1 user reviews,1,0,1
709350,0,1 user reviews,1,0,1
709370,0,1 user reviews,1,0,1
709380,5,Mixed,11,6,17
709400,0,3 user reviews,3,0,3
709410,5,Mixed,30,23,53
709440,8,Very Positive,214,27,241
709450,0,1 user reviews,1,0,1
709470,0,5 user reviews,5,0,5
709490,0,4 user reviews,2,2,4
709510,7,Positive,20,1,21
709520,0,1 user reviews,1,0,1
709550,0,4 user reviews,4,0,4
709560,0,5 user reviews,0,5,5
709600,0,1 user reviews,1,0,1
709610,0,2 user reviews,0,2,2
709620,0,5 user reviews,4,1,5
709670,7,Positive,18,2,20
709700,5,Mixed,6,7,13
709710,7,Positive,16,3,19
709720,0,2 user reviews,0,2,2
709780,4,Mostly Negative,9,17,26
709790,0,2 user reviews,2,0,2
709800,3,Negative,2,9,11
709820,5,Mixed,11,7,18
709830,0,3 user reviews,3,0,3
709840,4,Mostly Negative,17,39,56
709870,5,Mixed,12,9,21
709880,6,Mostly Positive,16,6,22
709890,0,1 user reviews,0,1,1
709900,5,Mixed,21,14,35
709920,8,Very Positive,179,5,184
709940,0,5 user reviews,5,0,5
710030,8,Very Positive,45,5,50
710070,7,Positive,9,2,11
710110,5,Mixed,7,5,12
710120,5,Mixed,8,4,12
710130,0,2 user reviews,1,1,2
710170,8,Very Positive,49,5,54
710190,0,2 user reviews,1,1,2
710220,0,9 user reviews,9,0,9
710240,0,2 user reviews,1,1,2
710250,0,7 user reviews,4,3,7
710300,0,8 user reviews,7,1,8
710350,0,4 user reviews,4,0,4
710360,0,5 user reviews,4,1,5
710460,0,3 user reviews,2,1,3
710470,6,Mostly Positive,160,43,203
710480,0,3 user reviews,3,0,3
710490,8,Very Positive,69,15,84
710520,0,2 user reviews,1,1,2
710580,0,2 user reviews,2,0,2
710600,7,Positive,19,1,20
710610,8,Very Positive,84,19,103
710630,0,4 user reviews,4,0,4
710640,0,2 user reviews,0,2,2
710650,0,1 user reviews,0,1,1
710690,0,4 user reviews,3,1,4
710700,6,Mostly Positive,15,6,21
710710,8,Very Positive,183,4,187
710740,0,6 user reviews,5,1,6
710760,6,Mostly Positive,27,10,37
710780,7,Positive,28,7,35
710800,7,Positive,14,3,17
710820,0,3 user reviews,3,0,3
710830,0,6 user reviews,5,1,6
710880,0,1 user reviews,0,1,1
710890,0,4 user reviews,3,1,4
710920,8,Very Positive,1484,198,1682
710940,0,1 user reviews,1,0,1
710950,7,Positive,20,3,23
710970,0,7 user reviews,1,6,7
711000,0,1 user reviews,0,1,1
711010,5,Mixed,7,8,15
711020,0,3 user reviews,3,0,3
711021,0,4 user reviews,3,1,4
711022,0,4 user reviews,4,0,4
711023,0,1 user reviews,1,0,1
711050,0,6 user reviews,4,2,6
711064,0,1 user reviews,1,0,1
711070,0,7 user reviews,2,5,7
711130,0,8 user reviews,8,0,8
711140,0,2 user reviews,1,1,2
711150,0,2 user reviews,1,1,2
711172,5,Mixed,21,13,34
711210,7,Positive,16,3,19
711230,0,1 user reviews,0,1,1
711240,6,Mostly Positive,11,4,15
711260,0,1 user reviews,1,0,1
711300,0,5 user reviews,5,0,5
711310,0,1 user reviews,0,1,1
711320,5,Mixed,9,4,13
711330,0,5 user reviews,2,3,5
711350,0,3 user reviews,0,3,3
711380,0,9 user reviews,4,5,9
711430,7,Positive,20,3,23
711440,5,Mixed,79,40,119
711450,0,1 user reviews,1,0,1
711460,0,1 user reviews,0,1,1
711480,0,8 user reviews,6,2,8
711500,0,1 user reviews,1,0,1
711530,0,6 user reviews,4,2,6
711540,8,Very Positive,383,37,420
711550,0,2 user reviews,2,0,2
711560,0,7 user reviews,3,4,7
711570,5,Mixed,9,6,15
711660,6,Mostly Positive,532,154,686
711680,5,Mixed,12,13,25
711681,6,Mostly Positive,12,5,17
711720,0,6 user reviews,5,1,6
711730,4,Mostly Negative,11,17,28
711734,0,1 user reviews,0,1,1
711741,0,1 user reviews,0,1,1
711742,0,1 user reviews,0,1,1
711750,6,Mostly Positive,167,66,233
711770,0,6 user reviews,3,3,6
711810,0,1 user reviews,1,0,1
711860,0,1 user reviews,1,0,1
711890,7,Positive,10,0,10
711920,0,5 user reviews,4,1,5
711930,4,Mostly Negative,2,8,10
711980,8,Very Positive,166,24,190
711990,8,Very Positive,116,19,135
712000,5,Mixed,6,7,13
712010,5,Mixed,16,13,29
712050,6,Mostly Positive,199,60,259
712070,0,4 user reviews,3,1,4
712100,5,Mixed,2971,1693,4664
712130,0,4 user reviews,3,1,4
712150,5,Mixed,7,5,12
712160,0,7 user reviews,6,1,7
712180,6,Mostly Positive,20,6,26
712190,5,Mixed,233,107,340
712210,0,1 user reviews,1,0,1
712240,7,Positive,12,1,13
712260,7,Positive,12,0,12
712330,0,1 user reviews,1,0,1
712340,7,Positive,10,1,11
712380,0,5 user reviews,5,0,5
712410,0,2 user reviews,1,1,2
712430,0,1 user reviews,1,0,1
712530,5,Mixed,12,9,21
712540,0,1 user reviews,1,0,1
712610,0,1 user reviews,1,0,1
712620,0,3 user reviews,3,0,3
712630,0,6 user reviews,5,1,6
712640,8,Very Positive,236,47,283
712650,0,7 user reviews,4,3,7
712660,0,1 user reviews,1,0,1
712670,0,4 user reviews,4,0,4
712700,0,1 user reviews,1,0,1
712720,0,5 user reviews,5,0,5
712730,8,Very Positive,988,53,1041
712760,0,1 user reviews,1,0,1
712790,5,Mixed,14,17,31
712810,5,Mixed,21,12,33
712840,6,Mostly Positive,115,37,152
712870,0,1 user reviews,0,1,1
712890,0,5 user reviews,4,1,5
712920,0,1 user reviews,1,0,1
712970,7,Positive,14,0,14
712980,5,Mixed,9,4,13
713010,0,9 user reviews,7,2,9
713030,0,9 user reviews,8,1,9
713050,6,Mostly Positive,8,3,11
713070,0,1 user reviews,0,1,1
713080,0,3 user reviews,0,3,3
713090,7,Positive,12,0,12
713100,0,7 user reviews,1,6,7
713110,0,1 user reviews,0,1,1
713150,0,1 user reviews,1,0,1
713160,7,Positive,31,1,32
713170,0,1 user reviews,1,0,1
713180,7,Positive,24,3,27
713220,7,Positive,9,2,11
713230,0,8 user reviews,2,6,8
713260,0,4 user reviews,4,0,4
713270,0,2 user reviews,1,1,2
713310,0,8 user reviews,8,0,8
713340,0,1 user reviews,1,0,1
713370,0,1 user reviews,1,0,1
713380,0,1 user reviews,1,0,1
713390,0,1 user reviews,0,1,1
713400,0,4 user reviews,3,1,4
713420,5,Mixed,15,9,24
713430,0,8 user reviews,8,0,8
713450,0,4 user reviews,2,2,4
713460,8,Very Positive,84,16,100
713500,0,6 user reviews,3,3,6
713530,8,Very Positive,72,14,86
713540,0,2 user reviews,2,0,2
713550,0,1 user reviews,1,0,1
713560,7,Positive,9,2,11
713570,0,2 user reviews,1,1,2
713580,4,Mostly Negative,4,10,14
713590,0,8 user reviews,1,7,8
713600,0,8 user reviews,3,5,8
713610,0,9 user reviews,4,5,9
713680,4,Mostly Negative,11,18,29
713690,0,5 user reviews,5,0,5
713700,0,1 user reviews,1,0,1
713760,0,2 user reviews,1,1,2
713800,0,6 user reviews,4,2,6
713840,0,5 user reviews,3,2,5
713860,6,Mostly Positive,26,8,34
714010,5,Mixed,24,14,38
714050,0,5 user reviews,2,3,5
714060,0,1 user reviews,1,0,1
714080,8,Very Positive,104,26,130
714120,8,Very Positive,983,160,1143
714170,0,1 user reviews,0,1,1
714230,0,1 user reviews,1,0,1
714240,7,Positive,32,4,36
714250,5,Mixed,11,10,21
714280,0,6 user reviews,4,2,6
714290,0,4 user reviews,3,1,4
714300,5,Mixed,13,8,21
714331,0,1 user reviews,1,0,1
714360,0,5 user reviews,2,3,5
714370,4,Mostly Negative,52,179,231
714510,0,3 user reviews,2,1,3
714530,0,1 user reviews,0,1,1
714570,0,5 user reviews,3,2,5
714620,5,Mixed,5,5,10
714640,5,Mixed,9,6,15
714730,0,1 user reviews,1,0,1
714760,0,1 user reviews,1,0,1
714770,0,5 user reviews,3,2,5
714800,8,Very Positive,104,5,109
714830,0,1 user reviews,1,0,1
714840,0,2 user reviews,1,1,2
714850,0,1 user reviews,1,0,1
714861,0,1 user reviews,1,0,1
714960,0,8 user reviews,6,2,8
714980,0,7 user reviews,4,3,7
715010,8,Very Positive,197,8,205
715020,5,Mixed,7,4,11
715050,6,Mostly Positive,97,36,133
715060,0,3 user reviews,1,2,3
715070,7,Positive,24,1,25
715080,0,2 user reviews,2,0,2
715090,0,3 user reviews,3,0,3
715110,5,Mixed,17,10,27
715190,8,Very Positive,53,9,62
715191,8,Very Positive,103,24,127
715193,7,Positive,32,5,37
715194,5,Mixed,141,77,218
715270,0,4 user reviews,4,0,4
715280,0,6 user reviews,3,3,6
715290,0,1 user reviews,0,1,1
715370,7,Positive,26,1,27
715380,5,Mixed,62,30,92
715410,0,4 user reviews,1,3,4
715420,0,1 user reviews,1,0,1
715430,0,2 user reviews,2,0,2
715440,7,Positive,12,1,13
715460,7,Positive,14,0,14
715470,0,3 user reviews,1,2,3
715480,0,1 user reviews,0,1,1
715490,0,3 user reviews,2,1,3
715510,0,4 user reviews,3,1,4
715520,4,Mostly Negative,10,19,29
715560,8,Very Positive,1661,167,1828
715580,7,Positive,34,0,34
715650,7,Positive,11,2,13
715660,0,5 user reviews,3,2,5
715670,0,5 user reviews,5,0,5
715690,6,Mostly Positive,28,8,36
715760,0,9 user reviews,8,1,9
715840,5,Mixed,9,6,15
715850,6,Mostly Positive,19,6,25
715870,0,8 user reviews,6,2,8
715900,0,3 user reviews,3,0,3
715920,0,5 user reviews,5,0,5
715940,0,5 user reviews,1,4,5
715950,8,Very Positive,75,7,82
715980,4,Mostly Negative,5,15,20
715990,0,2 user reviews,2,0,2
716000,0,6 user reviews,5,1,6
716010,7,Positive,12,1,13
716030,7,Positive,21,0,21
716040,0,7 user reviews,5,2,7
716050,6,Mostly Positive,10,3,13
716070,7,Positive,24,1,25
716090,0,9 user reviews,6,3,9
716100,0,8 user reviews,3,5,8
716140,0,2 user reviews,2,0,2
716150,7,Positive,13,1,14
716190,0,4 user reviews,3,1,4
716220,0,1 user reviews,0,1,1
716230,0,7 user reviews,6,1,7
716240,0,6 user reviews,4,2,6
716250,7,Positive,10,1,11
716270,5,Mixed,31,17,48
716310,0,1 user reviews,0,1,1
716330,6,Mostly Positive,11,4,15
716340,8,Very Positive,89,2,91
716360,0,6 user reviews,6,0,6
716380,5,Mixed,37,24,61
716390,0,1 user reviews,0,1,1
716400,0,8 user reviews,4,4,8
716410,0,5 user reviews,1,4,5
716480,0,1 user reviews,0,1,1
716490,9,Overwhelmingly Positive,648,24,672
716500,8,Very Positive,371,25,396
716560,0,6 user reviews,5,1,6
716580,7,Positive,11,0,11
716600,0,9 user reviews,4,5,9
716630,5,Mixed,46,30,76
716640,6,Mostly Positive,193,68,261
716650,8,Very Positive,132,4,136
716660,6,Mostly Positive,16,6,22
716670,5,Mixed,409,202,611
716680,8,Very Positive,53,10,63
716710,8,Very Positive,254,10,264
716750,5,Mixed,9,4,13
716760,0,9 user reviews,5,4,9
716770,0,6 user reviews,5,1,6
716790,0,1 user reviews,1,0,1
716840,0,3 user reviews,1,2,3
716850,0,1 user reviews,0,1,1
716870,0,1 user reviews,1,0,1
716890,5,Mixed,6,6,12
716920,0,4 user reviews,2,2,4
716930,0,6 user reviews,6,0,6
716940,5,Mixed,7,4,11
716960,0,1 user reviews,1,0,1
716970,0,1 user reviews,1,0,1
716980,0,2 user reviews,2,0,2
717000,0,1 user reviews,1,0,1
717020,0,5 user reviews,4,1,5
717031,0,3 user reviews,2,1,3
717032,0,1 user reviews,1,0,1
717040,0,3 user reviews,1,2,3
717060,0,3 user reviews,3,0,3
717070,7,Positive,16,1,17
717120,5,Mixed,8,6,14
717200,0,3 user reviews,2,1,3
717240,0,2 user reviews,1,1,2
717250,9,Overwhelmingly Positive,899,4,903
717280,0,1 user reviews,1,0,1
717310,6,Mostly Positive,69,18,87
717330,0,2 user reviews,1,1,2
717340,7,Positive,35,1,36
717400,0,1 user reviews,1,0,1
717490,6,Mostly Positive,26,9,35
717540,0,3 user reviews,3,0,3
717560,6,Mostly Positive,73,30,103
717610,8,Very Positive,113,17,130
717640,8,Very Positive,181,38,219
717670,0,2 user reviews,1,1,2
717690,5,Mixed,700,721,1421
717720,0,3 user reviews,2,1,3
717760,0,2 user reviews,2,0,2
717780,7,Positive,18,2,20
717790,6,Mostly Positive,161,68,229
717820,5,Mixed,8,5,13
717830,0,6 user reviews,6,0,6
717840,0,4 user reviews,4,0,4
717850,8,Very Positive,68,2,70
717950,8,Very Positive,46,11,57
717960,0,1 user reviews,1,0,1
718010,7,Positive,21,1,22
718020,0,4 user reviews,4,0,4
718030,0,6 user reviews,6,0,6
718070,0,3 user reviews,1,2,3
718080,0,9 user reviews,7,2,9
718100,0,1 user reviews,1,0,1
718120,0,4 user reviews,4,0,4
718130,0,1 user reviews,1,0,1
718140,0,3 user reviews,1,2,3
718180,5,Mixed,32,14,46
718200,8,Very Positive,90,7,97
718210,0,7 user reviews,6,1,7
718220,0,4 user reviews,2,2,4
718240,0,5 user reviews,4,1,5
718250,7,Positive,13,1,14
718320,5,Mixed,10,12,22
718330,8,Very Positive,60,6,66
718350,0,3 user reviews,0,3,3
718370,5,Mixed,39,42,81
718380,5,Mixed,7,7,14
718410,0,1 user reviews,1,0,1
718470,0,1 user reviews,1,0,1
718490,0,2 user reviews,2,0,2
718530,0,3 user reviews,3,0,3
718540,5,Mixed,5,5,10
718560,8,Very Positive,1095,115,1210
718570,7,Positive,12,0,12
718590,6,Mostly Positive,306,87,393
718600,0,6 user reviews,5,1,6
718650,6,Mostly Positive,360,124,484
718660,5,Mixed,5,5,10
718670,8,Very Positive,2054,506,2560
718680,0,4 user reviews,3,1,4
718690,0,1 user reviews,1,0,1
718710,0,1 user reviews,1,0,1
718720,7,Positive,15,3,18
718730,7,Positive,24,1,25
718800,0,1 user reviews,1,0,1
718830,0,4 user reviews,2,2,4
718850,6,Mostly Positive,1225,313,1538
718910,0,3 user reviews,1,2,3
718920,0,2 user reviews,0,2,2
718960,0,4 user reviews,2,2,4
718970,0,6 user reviews,4,2,6
718980,0,1 user reviews,0,1,1
718990,0,2 user reviews,0,2,2
719040,8,Very Positive,2725,621,3346
719070,0,2 user reviews,2,0,2
719080,7,Positive,18,2,20
719090,0,5 user reviews,4,1,5
719100,0,1 user reviews,0,1,1
719110,0,5 user reviews,4,1,5
719120,3,Negative,1,9,10
719130,0,5 user reviews,4,1,5
719140,0,9 user reviews,8,1,9
719180,6,Mostly Positive,35,9,44
719200,6,Mostly Positive,104,37,141
719210,7,Positive,11,0,11
719220,0,1 user reviews,1,0,1
719250,0,8 user reviews,6,2,8
719260,0,2 user reviews,1,1,2
719290,0,1 user reviews,1,0,1
719300,0,1 user reviews,1,0,1
719310,0,1 user reviews,1,0,1
719320,0,4 user reviews,2,2,4
719330,7,Positive,45,4,49
719350,0,1 user reviews,1,0,1
719410,5,Mixed,8,5,13
719430,7,Positive,35,8,43
719470,0,1 user reviews,1,0,1
719480,0,1 user reviews,1,0,1
719520,7,Positive,28,5,33
719540,0,4 user reviews,1,3,4
719550,0,8 user reviews,7,1,8
719590,4,Mostly Negative,63,241,304
719600,0,4 user reviews,1,3,4
719610,5,Mixed,25,21,46
719660,8,Very Positive,56,1,57
719670,0,2 user reviews,1,1,2
719690,6,Mostly Positive,17,5,22
719710,0,3 user reviews,3,0,3
719740,0,1 user reviews,1,0,1
719750,8,Very Positive,160,14,174
719800,7,Positive,13,2,15
719820,0,1 user reviews,0,1,1
719830,0,1 user reviews,0,1,1
719840,0,2 user reviews,2,0,2
719890,6,Mostly Positive,779,294,1073
719930,0,5 user reviews,5,0,5
719970,0,3 user reviews,0,3,3
720000,0,6 user reviews,3,3,6
720020,0,1 user reviews,1,0,1
720030,8,Very Positive,115,21,136
720040,3,Negative,2,16,18
720060,0,3 user reviews,1,2,3
720130,0,1 user reviews,1,0,1
720150,7,Positive,37,3,40
720180,0,1 user reviews,1,0,1
720200,6,Mostly Positive,10,4,14
720240,5,Mixed,8,9,17
720250,8,Very Positive,734,162,896
720270,5,Mixed,11,9,20
720280,8,Very Positive,365,82,447
720290,5,Mixed,8,5,13
720310,0,2 user reviews,0,2,2
720330,0,1 user reviews,0,1,1
720400,0,1 user reviews,1,0,1
720450,0,1 user reviews,0,1,1
720470,0,9 user reviews,1,8,9
720480,0,3 user reviews,3,0,3
720510,0,7 user reviews,6,1,7
720530,7,Positive,16,2,18
720560,8,Very Positive,193,29,222
720590,0,2 user reviews,2,0,2
720600,0,6 user reviews,5,1,6
720640,0,1 user reviews,1,0,1
720680,7,Positive,20,5,25
720690,0,2 user reviews,2,0,2
720700,0,2 user reviews,2,0,2
720710,0,6 user reviews,5,1,6
720730,4,Mostly Negative,5,8,13
720740,0,6 user reviews,6,0,6
720750,0,5 user reviews,1,4,5
720760,0,5 user reviews,3,2,5
720770,0,5 user reviews,5,0,5
720780,6,Mostly Positive,7,3,10
720790,0,3 user reviews,2,1,3
720800,0,5 user reviews,1,4,5
720850,0,2 user reviews,2,0,2
720860,0,9 user reviews,9,0,9
720940,7,Positive,27,3,30
720950,0,1 user reviews,1,0,1
720960,6,Mostly Positive,8,3,11
721010,8,Very Positive,48,5,53
721050,0,1 user reviews,1,0,1
721051,0,1 user reviews,1,0,1
721052,0,2 user reviews,1,1,2
721060,4,Mostly Negative,4,7,11
721080,0,4 user reviews,1,3,4
721090,5,Mixed,9,5,14
721100,0,2 user reviews,2,0,2
721101,0,1 user reviews,1,0,1
721104,0,3 user reviews,2,1,3
721105,0,2 user reviews,2,0,2
721106,0,1 user reviews,1,0,1
721107,0,1 user reviews,1,0,1
721108,0,1 user reviews,1,0,1
721114,0,1 user reviews,1,0,1
721118,0,1 user reviews,1,0,1
721132,0,5 user reviews,5,0,5
721133,0,2 user reviews,2,0,2
721145,0,1 user reviews,1,0,1
721149,0,1 user reviews,0,1,1
721150,0,1 user reviews,1,0,1
721260,0,3 user reviews,3,0,3
721270,0,5 user reviews,4,1,5
721280,0,4 user reviews,4,0,4
721300,0,2 user reviews,1,1,2
721340,5,Mixed,65,28,93
721341,5,Mixed,6,6,12
721350,0,1 user reviews,1,0,1
721380,0,5 user reviews,5,0,5
721390,7,Positive,38,1,39
721400,0,5 user reviews,4,1,5
721410,0,5 user reviews,4,1,5
721420,0,3 user reviews,1,2,3
721430,6,Mostly Positive,17,5,22
721470,0,2 user reviews,1,1,2
721480,0,4 user reviews,4,0,4
721540,0,1 user reviews,0,1,1
721620,8,Very Positive,40,10,50
721670,0,2 user reviews,1,1,2
721740,0,6 user reviews,5,1,6
721760,6,Mostly Positive,14,4,18
721890,0,6 user reviews,4,2,6
721940,5,Mixed,13,6,19
721950,5,Mixed,7,7,14
721960,0,3 user reviews,2,1,3
722010,0,3 user reviews,0,3,3
722020,0,6 user reviews,0,6,6
722040,0,9 user reviews,7,2,9
722050,0,3 user reviews,3,0,3
722060,8,Very Positive,889,52,941
722090,0,1 user reviews,1,0,1
722180,8,Very Positive,244,49,293
722190,0,5 user reviews,3,2,5
722230,5,Mixed,244,201,445
722250,5,Mixed,18,8,26
722290,0,5 user reviews,2,3,5
722330,7,Positive,15,1,16
722340,0,1 user reviews,0,1,1
722350,0,5 user reviews,3,2,5
722370,0,1 user reviews,1,0,1
722400,0,1 user reviews,1,0,1
722410,0,2 user reviews,0,2,2
722490,0,1 user reviews,0,1,1
722540,5,Mixed,4,6,10
722560,6,Mostly Positive,220,58,278
722570,0,7 user reviews,3,4,7
722600,0,5 user reviews,5,0,5
722620,0,3 user reviews,3,0,3
722660,5,Mixed,16,11,27
722670,7,Positive,9,2,11
722680,0,2 user reviews,1,1,2
722730,9,Overwhelmingly Positive,556,20,576
722760,0,2 user reviews,2,0,2
722800,0,2 user reviews,2,0,2
722810,0,4 user reviews,1,3,4
722850,0,1 user reviews,1,0,1
722851,0,4 user reviews,3,1,4
722870,7,Positive,35,2,37
722890,0,6 user reviews,6,0,6
722910,0,1 user reviews,1,0,1
722920,7,Positive,24,6,30
722960,6,Mostly Positive,140,48,188
722990,7,Positive,9,1,10
723020,0,3 user reviews,0,3,3
723070,0,3 user reviews,2,1,3
723080,0,1 user reviews,1,0,1
723090,9,Overwhelmingly Positive,598,14,612
723100,6,Mostly Positive,10,3,13
723110,0,8 user reviews,6,2,8
723180,0,1 user reviews,0,1,1
723190,0,5 user reviews,2,3,5
723270,8,Very Positive,322,34,356
723280,0,2 user reviews,1,1,2
723350,7,Positive,29,6,35
723370,0,2 user reviews,1,1,2
723380,0,2 user reviews,1,1,2
723390,4,Mostly Negative,378,634,1012
723450,5,Mixed,12,7,19
723460,0,1 user reviews,1,0,1
723510,0,2 user reviews,1,1,2
723530,0,2 user reviews,2,0,2
723540,0,2 user reviews,0,2,2
723650,0,1 user reviews,1,0,1
723760,0,4 user reviews,4,0,4
723800,0,2 user reviews,0,2,2
723810,0,6 user reviews,1,5,6
723820,0,2 user reviews,2,0,2
723830,0,8 user reviews,4,4,8
723880,0,2 user reviews,1,1,2
723890,8,Very Positive,68,11,79
723910,0,1 user reviews,1,0,1
723930,7,Positive,9,1,10
723940,0,3 user reviews,3,0,3
724010,7,Positive,12,2,14
724030,0,2 user reviews,2,0,2
724070,5,Mixed,8,4,12
724080,0,7 user reviews,4,3,7
724090,0,2 user reviews,0,2,2
724110,0,3 user reviews,0,3,3
724120,0,3 user reviews,3,0,3
724130,0,5 user reviews,4,1,5
724250,6,Mostly Positive,47,19,66
724260,0,9 user reviews,8,1,9
724300,8,Very Positive,163,12,175
724330,0,6 user reviews,5,1,6
724340,0,1 user reviews,1,0,1
724350,5,Mixed,11,9,20
724370,0,7 user reviews,7,0,7
724390,6,Mostly Positive,21,7,28
724420,5,Mixed,6,4,10
724430,4,Mostly Negative,6,16,22
724440,0,6 user reviews,6,0,6
724460,0,3 user reviews,1,2,3
724470,8,Very Positive,66,15,81
724480,0,4 user reviews,1,3,4
724490,5,Mixed,13,9,22
724510,5,Mixed,16,8,24
724580,0,7 user reviews,2,5,7
724590,0,2 user reviews,1,1,2
724630,0,8 user reviews,4,4,8
724640,0,5 user reviews,5,0,5
724690,0,9 user reviews,5,4,9
724710,5,Mixed,13,9,22
724720,0,6 user reviews,6,0,6
724740,5,Mixed,123,60,183
724760,0,3 user reviews,2,1,3
724780,0,1 user reviews,1,0,1
724840,0,2 user reviews,2,0,2
724850,0,1 user reviews,1,0,1
724900,0,4 user reviews,2,2,4
724920,0,2 user reviews,1,1,2
724940,0,6 user reviews,2,4,6
724970,6,Mostly Positive,57,16,73
724980,7,Positive,17,1,18
725030,0,1 user reviews,1,0,1
725040,7,Positive,19,2,21
725050,0,1 user reviews,1,0,1
725080,6,Mostly Positive,7,3,10
725110,0,6 user reviews,4,2,6
725120,7,Positive,36,3,39
725170,7,Positive,10,1,11
725270,8,Very Positive,270,22,292
725280,0,9 user reviews,5,4,9
725320,0,1 user reviews,0,1,1
725330,8,Very Positive,54,2,56
725353,5,Mixed,74,34,108
725370,5,Mixed,12,15,27
725380,0,7 user reviews,7,0,7
725400,5,Mixed,9,10,19
725410,7,Positive,28,2,30
725430,0,1 user reviews,1,0,1
725480,9,Overwhelmingly Positive,1790,89,1879
725550,0,2 user reviews,1,1,2
725610,7,Positive,11,2,13
725620,0,1 user reviews,1,0,1
725640,0,4 user reviews,3,1,4
725680,0,8 user reviews,5,3,8
725780,6,Mostly Positive,34,13,47
725850,7,Positive,11,0,11
725910,0,1 user reviews,1,0,1
725950,0,2 user reviews,0,2,2
725960,4,Mostly Negative,12,23,35
725970,0,6 user reviews,5,1,6
726000,7,Positive,36,4,40
726020,7,Positive,20,4,24
726030,0,3 user reviews,0,3,3
726050,7,Positive,21,4,25
726060,0,4 user reviews,0,4,4
726070,3,Negative,2,13,15
726110,8,Very Positive,512,50,562
726120,6,Mostly Positive,9,3,12
726190,0,1 user reviews,1,0,1
726200,8,Very Positive,76,18,94
726230,7,Positive,19,1,20
726250,8,Very Positive,120,17,137
726300,0,3 user reviews,3,0,3
726320,6,Mostly Positive,9,3,12
726330,0,1 user reviews,1,0,1
726340,6,Mostly Positive,24,7,31
726360,5,Mixed,242,133,375
726380,0,9 user reviews,8,1,9
726430,5,Mixed,9,7,16
726450,0,1 user reviews,1,0,1
726460,0,8 user reviews,5,3,8
726480,7,Positive,33,3,36
726490,0,3 user reviews,2,1,3
726500,0,1 user reviews,1,0,1
726510,7,Positive,13,3,16
726520,0,1 user reviews,1,0,1
726560,7,Positive,23,0,23
726570,0,1 user reviews,0,1,1
726580,5,Mixed,10,7,17
726590,6,Mostly Positive,140,44,184
726600,0,9 user reviews,5,4,9
726620,5,Mixed,6,6,12
726630,7,Positive,12,1,13
726690,7,Positive,22,1,23
726700,0,1 user reviews,1,0,1
726710,0,7 user reviews,4,3,7
726720,6,Mostly Positive,11,4,15
726760,5,Mixed,9,9,18
726800,0,6 user reviews,1,5,6
726810,0,1 user reviews,1,0,1
726820,0,2 user reviews,2,0,2
726830,8,Very Positive,337,27,364
726840,8,Very Positive,133,23,156
726870,7,Positive,19,1,20
726880,7,Positive,12,0,12
726950,5,Mixed,20,23,43
726990,8,Very Positive,86,13,99
727010,0,1 user reviews,0,1,1
727020,7,Positive,18,0,18
727040,7,Positive,12,1,13
727050,0,1 user reviews,0,1,1
727060,0,4 user reviews,2,2,4
727070,0,9 user reviews,7,2,9
727080,0,1 user reviews,1,0,1
727090,4,Mostly Negative,11,17,28
727100,7,Positive,8,2,10
727110,0,2 user reviews,1,1,2
727130,8,Very Positive,522,102,624
727140,0,3 user reviews,3,0,3
727150,0,2 user reviews,2,0,2
727170,5,Mixed,7,10,17
727180,4,Mostly Negative,5,9,14
727190,5,Mixed,9,5,14
727200,0,5 user reviews,5,0,5
727220,6,Mostly Positive,7,3,10
727290,7,Positive,10,1,11
727320,0,3 user reviews,2,1,3
727330,0,1 user reviews,1,0,1
727340,6,Mostly Positive,37,10,47
727420,0,6 user reviews,6,0,6
727430,0,1 user reviews,1,0,1
727440,0,1 user reviews,1,0,1
727450,0,1 user reviews,1,0,1
727460,0,9 user reviews,5,4,9
727480,0,5 user reviews,3,2,5
727490,0,1 user reviews,0,1,1
727510,5,Mixed,20,22,42
727530,0,3 user reviews,1,2,3
727550,0,6 user reviews,4,2,6
727570,8,Very Positive,41,10,51
727610,0,1 user reviews,1,0,1
727640,7,Positive,19,2,21
727670,0,3 user reviews,3,0,3
727720,5,Mixed,14,7,21
727730,6,Mostly Positive,27,10,37
727760,6,Mostly Positive,20,6,26
727790,0,5 user reviews,5,0,5
727800,0,6 user reviews,4,2,6
727840,0,1 user reviews,0,1,1
727850,8,Very Positive,447,52,499
727860,0,1 user reviews,0,1,1
727900,0,3 user reviews,2,1,3
727910,5,Mixed,78,50,128
727930,7,Positive,45,4,49
727970,0,2 user reviews,1,1,2
727980,0,2 user reviews,2,0,2
727990,0,1 user reviews,0,1,1
728020,0,2 user reviews,2,0,2
728032,0,3 user reviews,3,0,3
728050,0,6 user reviews,1,5,6
728070,6,Mostly Positive,14,5,19
728150,0,7 user reviews,3,4,7
728190,7,Positive,19,0,19
728220,0,3 user reviews,3,0,3
728240,8,Very Positive,90,22,112
728300,7,Positive,15,1,16
728301,0,5 user reviews,4,1,5
728302,6,Mostly Positive,12,4,16
728350,0,1 user reviews,1,0,1
728420,6,Mostly Positive,16,6,22
728440,8,Very Positive,52,12,64
728530,8,Very Positive,923,72,995
728540,5,Mixed,1817,1707,3524
728600,0,8 user reviews,7,1,8
728610,0,1 user reviews,1,0,1
728630,4,Mostly Negative,4,7,11
728670,0,2 user reviews,1,1,2
728700,0,1 user reviews,1,0,1
728710,0,1 user reviews,1,0,1
728740,5,Mixed,259,153,412
728780,0,2 user reviews,2,0,2
728781,0,4 user reviews,3,1,4
728830,0,4 user reviews,4,0,4
728850,7,Positive,35,7,42
728870,7,Positive,22,3,25
728880,8,Very Positive,4117,285,4402
728910,7,Positive,16,0,16
728920,0,7 user reviews,5,2,7
728950,0,4 user reviews,2,2,4
728990,0,5 user reviews,2,3,5
729020,0,2 user reviews,2,0,2
729030,4,Mostly Negative,3,9,12
729040,8,Very Positive,3600,675,4275
729050,0,2 user reviews,2,0,2
729060,6,Mostly Positive,34,14,48
729090,4,Mostly Negative,4,9,13
729130,0,1 user reviews,1,0,1
729160,8,Very Positive,48,2,50
729190,0,7 user reviews,4,3,7
729220,5,Mixed,8,6,14
729230,0,1 user reviews,0,1,1
729240,0,3 user reviews,2,1,3
729300,7,Positive,18,0,18
729310,0,9 user reviews,4,5,9
729330,5,Mixed,15,13,28
729340,0,1 user reviews,0,1,1
729370,7,Positive,35,2,37
729390,0,4 user reviews,4,0,4
729410,0,1 user reviews,1,0,1
729450,7,Positive,38,6,44
729460,5,Mixed,14,8,22
729470,5,Mixed,7,4,11
729490,0,7 user reviews,6,1,7
729530,6,Mostly Positive,38,15,53
729570,7,Positive,14,3,17
729580,0,4 user reviews,4,0,4
729600,0,1 user reviews,1,0,1
729620,0,1 user reviews,0,1,1
729630,0,1 user reviews,1,0,1
729640,0,6 user reviews,6,0,6
729660,7,Positive,31,4,35
729670,5,Mixed,7,9,16
729720,5,Mixed,15,11,26
729760,0,4 user reviews,3,1,4
729780,0,1 user reviews,1,0,1
729800,0,1 user reviews,1,0,1
729840,0,2 user reviews,2,0,2
729850,0,9 user reviews,8,1,9
729910,0,1 user reviews,0,1,1
729920,0,2 user reviews,2,0,2
729930,0,2 user reviews,1,1,2
729940,0,2 user reviews,2,0,2
729950,0,2 user reviews,2,0,2
729960,0,1 user reviews,1,0,1
729970,0,4 user reviews,4,0,4
729980,0,8 user reviews,8,0,8
729990,0,1 user reviews,1,0,1
730000,8,Very Positive,184,35,219
730010,0,1 user reviews,0,1,1
730030,5,Mixed,11,5,16
730040,0,1 user reviews,1,0,1
730050,8,Very Positive,187,41,228
730120,0,7 user reviews,5,2,7
730170,0,2 user reviews,1,1,2
730180,0,1 user reviews,1,0,1
730190,0,4 user reviews,2,2,4
730220,5,Mixed,6,6,12
730260,6,Mostly Positive,15,5,20
730261,0,9 user reviews,2,7,9
730262,0,7 user reviews,4,3,7
730270,0,9 user reviews,9,0,9
730280,0,1 user reviews,0,1,1
730290,6,Mostly Positive,9,3,12
730300,7,Positive,12,0,12
730310,5,Mixed,421,395,816
730350,0,2 user reviews,2,0,2
730390,8,Very Positive,405,13,418
730410,4,Mostly Negative,49,85,134
730450,0,9 user reviews,6,3,9
730460,0,1 user reviews,0,1,1
730480,0,3 user reviews,2,1,3
730490,0,1 user reviews,1,0,1
730510,0,8 user reviews,8,0,8
730520,0,1 user reviews,1,0,1
730530,0,2 user reviews,2,0,2
730580,0,6 user reviews,4,2,6
730611,0,2 user reviews,2,0,2
730612,0,1 user reviews,1,0,1
730613,0,2 user reviews,1,1,2
730614,0,7 user reviews,7,0,7
730615,0,1 user reviews,0,1,1
730616,0,4 user reviews,3,1,4
730618,0,2 user reviews,2,0,2
730619,0,3 user reviews,2,1,3
730620,5,Mixed,27,12,39
730670,0,1 user reviews,1,0,1
730700,0,3 user reviews,3,0,3
730710,0,2 user reviews,0,2,2
730720,7,Positive,20,1,21
730750,0,6 user reviews,5,1,6
730760,0,2 user reviews,0,2,2
730780,0,1 user reviews,1,0,1
730790,0,2 user reviews,2,0,2
730820,9,Overwhelmingly Positive,567,11,578
730830,5,Mixed,58,38,96
730840,7,Positive,41,0,41
730860,7,Positive,10,2,12
730870,8,Very Positive,59,3,62
730920,7,Positive,46,3,49
731000,5,Mixed,5,6,11
731100,0,1 user reviews,1,0,1
731101,0,2 user reviews,2,0,2
731120,0,3 user reviews,1,2,3
731130,0,1 user reviews,1,0,1
731150,0,3 user reviews,1,2,3
731160,0,1 user reviews,0,1,1
731170,0,1 user reviews,1,0,1
731171,0,2 user reviews,1,1,2
731172,0,3 user reviews,2,1,3
731190,0,2 user reviews,1,1,2
731230,5,Mixed,9,5,14
731250,5,Mixed,16,8,24
731310,5,Mixed,8,5,13
731320,7,Positive,12,1,13
731390,0,1 user reviews,1,0,1
731420,7,Positive,14,3,17
731450,0,4 user reviews,1,3,4
731460,0,2 user reviews,1,1,2
731490,8,Very Positive,3068,216,3284
731510,0,5 user reviews,5,0,5
731520,0,4 user reviews,4,0,4
731560,7,Positive,27,1,28
731590,5,Mixed,46,23,69
731600,7,Positive,12,0,12
731620,5,Mixed,454,292,746
731650,5,Mixed,11,7,18
731670,0,2 user reviews,2,0,2
731690,0,2 user reviews,1,1,2
731700,0,4 user reviews,2,2,4
731720,5,Mixed,22,20,42
731760,0,6 user reviews,1,5,6
731790,0,1 user reviews,0,1,1
731820,0,3 user reviews,3,0,3
731880,5,Mixed,23,24,47
731890,0,8 user reviews,6,2,8
731920,5,Mixed,54,62,116
731930,0,5 user reviews,4,1,5
731940,7,Positive,24,6,30
731950,0,6 user reviews,5,1,6
732030,0,9 user reviews,8,1,9
732040,0,2 user reviews,2,0,2
732060,0,4 user reviews,1,3,4
732070,0,5 user reviews,4,1,5
732090,0,5 user reviews,2,3,5
732110,0,3 user reviews,2,1,3
732160,5,Mixed,36,26,62
732190,0,2 user reviews,2,0,2
732240,6,Mostly Positive,236,60,296
732290,0,3 user reviews,3,0,3
732370,8,Very Positive,134,22,156
732390,0,1 user reviews,1,0,1
732400,8,Very Positive,44,9,53
732410,0,1 user reviews,0,1,1
732430,9,Overwhelmingly Positive,5310,152,5462
732460,8,Very Positive,54,5,59
732470,7,Positive,8,2,10
732480,0,6 user reviews,3,3,6
732510,0,5 user reviews,3,2,5
732520,5,Mixed,12,9,21
732680,0,1 user reviews,0,1,1
732690,9,Overwhelmingly Positive,2439,71,2510
732700,0,3 user reviews,3,0,3
732770,7,Positive,15,1,16
732800,0,2 user reviews,1,1,2
732810,8,Very Positive,405,31,436
732820,0,1 user reviews,1,0,1
732840,0,5 user reviews,3,2,5
732850,0,1 user reviews,1,0,1
732860,0,4 user reviews,3,1,4
732890,0,6 user reviews,6,0,6
732930,7,Positive,19,0,19
733020,0,6 user reviews,5,1,6
733030,0,4 user reviews,2,2,4
733040,0,1 user reviews,0,1,1
733050,8,Very Positive,83,6,89
733060,0,5 user reviews,0,5,5
733070,8,Very Positive,184,21,205
733080,0,1 user reviews,1,0,1
733090,5,Mixed,13,6,19
733140,8,Very Positive,60,6,66
733180,0,7 user reviews,5,2,7
733200,0,2 user reviews,2,0,2
733210,8,Very Positive,284,26,310
733230,0,3 user reviews,0,3,3
733250,0,5 user reviews,4,1,5
733300,8,Very Positive,127,9,136
733340,8,Very Positive,103,10,113
733430,0,7 user reviews,1,6,7
733440,0,6 user reviews,0,6,6
733460,6,Mostly Positive,81,33,114
733500,0,2 user reviews,2,0,2
733510,0,4 user reviews,4,0,4
733520,0,4 user reviews,3,1,4
733530,0,3 user reviews,3,0,3
733540,0,7 user reviews,6,1,7
733550,0,4 user reviews,1,3,4
733570,0,1 user reviews,1,0,1
733610,5,Mixed,6,4,10
733670,0,4 user reviews,2,2,4
733690,5,Mixed,6,4,10
733740,8,Very Positive,56,5,61
733760,0,9 user reviews,8,1,9
733770,0,9 user reviews,2,7,9
733790,8,Very Positive,604,87,691
733800,6,Mostly Positive,33,11,44
733810,0,2 user reviews,2,0,2
733870,0,2 user reviews,2,0,2
733880,0,1 user reviews,1,0,1
733910,0,2 user reviews,2,0,2
733940,0,6 user reviews,0,6,6
733990,8,Very Positive,907,69,976
734020,5,Mixed,14,19,33
734070,0,5 user reviews,5,0,5
734080,0,5 user reviews,2,3,5
734090,0,1 user reviews,1,0,1
734120,6,Mostly Positive,38,12,50
734280,0,5 user reviews,4,1,5
734282,5,Mixed,9,6,15
734283,6,Mostly Positive,8,3,11
734380,4,Mostly Negative,3,7,10
734400,0,8 user reviews,8,0,8
734450,0,5 user reviews,4,1,5
734490,0,5 user reviews,5,0,5
734510,6,Mostly Positive,41,16,57
734540,5,Mixed,5,6,11
734570,5,Mixed,11,10,21
734580,0,2 user reviews,1,1,2
734590,4,Mostly Negative,6,18,24
734700,7,Positive,16,1,17
734730,5,Mixed,14,8,22
734740,7,Positive,36,3,39
734820,0,4 user reviews,3,1,4
734830,5,Mixed,25,19,44
734840,0,6 user reviews,4,2,6
734870,0,1 user reviews,1,0,1
734880,8,Very Positive,57,3,60
734890,0,2 user reviews,2,0,2
734900,7,Positive,26,1,27
734920,8,Very Positive,132,7,139
734949,0,1 user reviews,1,0,1
734980,7,Positive,38,8,46
735000,8,Very Positive,53,4,57
735010,0,5 user reviews,4,1,5
735030,0,3 user reviews,3,0,3
735060,6,Mostly Positive,10,3,13
735070,0,1 user reviews,1,0,1
735110,0,3 user reviews,0,3,3
735150,0,1 user reviews,1,0,1
735210,0,1 user reviews,1,0,1
735230,0,1 user reviews,1,0,1
735260,5,Mixed,6,4,10
735280,6,Mostly Positive,129,54,183
735320,0,4 user reviews,4,0,4
735350,5,Mixed,50,29,79
735360,0,7 user reviews,5,2,7
735370,5,Mixed,11,10,21
735410,5,Mixed,6,6,12
735433,0,2 user reviews,2,0,2
735450,5,Mixed,21,10,31
735490,0,1 user reviews,1,0,1
735500,5,Mixed,7,9,16
735510,0,7 user reviews,7,0,7
735530,0,3 user reviews,2,1,3
735540,0,1 user reviews,0,1,1
735550,0,2 user reviews,1,1,2
735570,0,8 user reviews,6,2,8
735580,8,Very Positive,111,3,114
735590,0,5 user reviews,4,1,5
735600,7,Positive,22,3,25
735650,0,1 user reviews,1,0,1
735700,0,3 user reviews,3,0,3
735730,6,Mostly Positive,245,70,315
735830,0,1 user reviews,0,1,1
736050,0,1 user reviews,1,0,1
736090,0,1 user reviews,1,0,1
736100,7,Positive,32,0,32
736110,5,Mixed,9,7,16
736170,0,4 user reviews,3,1,4
736180,0,2 user reviews,2,0,2
736190,8,Very Positive,898,57,955
736200,0,8 user reviews,8,0,8
736210,0,4 user reviews,2,2,4
736220,8,Very Positive,4932,1146,6078
736230,0,1 user reviews,1,0,1
736250,7,Positive,29,5,34
736260,9,Overwhelmingly Positive,5530,100,5630
736280,0,9 user reviews,5,4,9
736320,0,1 user reviews,1,0,1
736340,7,Positive,19,2,21
736370,0,3 user reviews,2,1,3
736390,0,8 user reviews,7,1,8
736400,0,9 user reviews,5,4,9
736420,0,5 user reviews,5,0,5
736430,0,4 user reviews,1,3,4
736450,0,2 user reviews,1,1,2
736470,0,6 user reviews,5,1,6
736570,8,Very Positive,214,12,226
736580,0,1 user reviews,1,0,1
736610,0,1 user reviews,0,1,1
736680,0,3 user reviews,2,1,3
736690,0,4 user reviews,3,1,4
736710,7,Positive,9,2,11
736720,7,Positive,14,2,16
736770,5,Mixed,5,5,10
736810,6,Mostly Positive,46,12,58
736840,7,Positive,14,1,15
736850,6,Mostly Positive,372,115,487
736860,5,Mixed,33,23,56
736930,5,Mixed,9,5,14
737000,7,Positive,15,3,18
737001,4,Mostly Negative,5,8,13
737002,7,Positive,11,2,13
737040,5,Mixed,124,69,193
737070,0,3 user reviews,1,2,3
737130,0,1 user reviews,1,0,1
737250,0,2 user reviews,2,0,2
737260,4,Mostly Negative,7,13,20
737270,8,Very Positive,68,6,74
737272,7,Positive,26,4,30
737280,0,3 user reviews,3,0,3
737330,0,5 user reviews,4,1,5
737380,0,2 user reviews,2,0,2
737390,0,3 user reviews,2,1,3
737480,0,3 user reviews,2,1,3
737510,0,6 user reviews,2,4,6
737530,4,Mostly Negative,3,7,10
737600,0,2 user reviews,1,1,2
737660,0,1 user reviews,1,0,1
737670,0,3 user reviews,2,1,3
737690,0,5 user reviews,5,0,5
737710,0,1 user reviews,1,0,1
737730,0,2 user reviews,2,0,2
737740,7,Positive,11,0,11
737780,8,Very Positive,42,9,51
737800,8,Very Positive,1201,199,1400
737810,0,3 user reviews,0,3,3
737820,0,5 user reviews,2,3,5
737830,0,3 user reviews,3,0,3
737840,0,4 user reviews,3,1,4
737870,7,Positive,30,5,35
737880,5,Mixed,18,8,26
737890,6,Mostly Positive,48,14,62
737920,0,1 user reviews,1,0,1
737930,0,5 user reviews,5,0,5
737980,0,2 user reviews,2,0,2
737990,7,Positive,29,5,34
738000,5,Mixed,18,11,29
738020,5,Mixed,10,6,16
738030,0,1 user reviews,1,0,1
738050,0,1 user reviews,1,0,1
738080,0,3 user reviews,2,1,3
738130,0,1 user reviews,1,0,1
738210,0,1 user reviews,1,0,1
738260,0,3 user reviews,1,2,3
738270,6,Mostly Positive,17,5,22
738290,0,1 user reviews,1,0,1
738320,0,2 user reviews,1,1,2
738350,0,7 user reviews,1,6,7
738360,0,1 user reviews,0,1,1
738440,0,6 user reviews,6,0,6
738450,0,8 user reviews,3,5,8
738510,0,8 user reviews,8,0,8
738520,8,Very Positive,1450,217,1667
738530,5,Mixed,246,158,404
738540,8,Very Positive,663,88,751
738550,5,Mixed,16,13,29
738560,6,Mostly Positive,10,3,13
738580,0,6 user reviews,5,1,6
738590,0,4 user reviews,3,1,4
738600,0,5 user reviews,2,3,5
738610,5,Mixed,66,37,103
738620,0,2 user reviews,2,0,2
738650,8,Very Positive,48,4,52
738700,0,3 user reviews,3,0,3
738710,0,2 user reviews,2,0,2
738711,0,2 user reviews,2,0,2
738720,0,2 user reviews,2,0,2
738730,0,1 user reviews,0,1,1
738760,5,Mixed,8,4,12
738790,0,4 user reviews,1,3,4
738810,0,1 user reviews,1,0,1
738830,0,2 user reviews,1,1,2
738860,7,Positive,13,1,14
738920,5,Mixed,31,28,59
738940,0,1 user reviews,1,0,1
739000,6,Mostly Positive,26,8,34
739010,0,4 user reviews,4,0,4
739030,0,5 user reviews,0,5,5
739050,0,5 user reviews,0,5,5
739080,7,Positive,27,0,27
739100,7,Positive,10,1,11
739130,5,Mixed,54,50,104
739170,0,7 user reviews,5,2,7
739180,7,Positive,15,1,16
739190,6,Mostly Positive,63,19,82
739210,7,Positive,15,2,17
739220,6,Mostly Positive,12,5,17
739240,5,Mixed,7,5,12
739250,0,1 user reviews,0,1,1
739251,0,8 user reviews,6,2,8
739253,0,2 user reviews,2,0,2
739255,0,2 user reviews,1,1,2
739256,0,4 user reviews,2,2,4
739260,0,2 user reviews,2,0,2
739270,0,1 user reviews,1,0,1
739280,8,Very Positive,46,7,53
739281,6,Mostly Positive,24,9,33
739282,6,Mostly Positive,48,17,65
739290,0,2 user reviews,2,0,2
739360,0,9 user reviews,7,2,9
739410,0,7 user reviews,4,3,7
739440,0,7 user reviews,6,1,7
739540,6,Mostly Positive,207,68,275
739581,7,Positive,32,5,37
739600,0,1 user reviews,1,0,1
739620,0,1 user reviews,0,1,1
739630,9,Overwhelmingly Positive,38545,1000,39545
739650,6,Mostly Positive,122,50,172
739660,0,1 user reviews,1,0,1
739690,0,8 user reviews,5,3,8
739710,0,1 user reviews,1,0,1
739720,7,Positive,16,1,17
739730,0,2 user reviews,1,1,2
739760,0,1 user reviews,1,0,1
739780,0,1 user reviews,0,1,1
739800,0,3 user reviews,2,1,3
739820,0,1 user reviews,1,0,1
739850,7,Positive,15,1,16
739950,0,3 user reviews,3,0,3
739980,8,Very Positive,61,15,76
739990,0,7 user reviews,4,3,7
740000,0,2 user reviews,1,1,2
740020,0,6 user reviews,6,0,6
740040,7,Positive,39,8,47
740050,0,7 user reviews,6,1,7
740060,0,3 user reviews,0,3,3
740070,0,8 user reviews,3,5,8
740080,8,Very Positive,64,9,73
740090,6,Mostly Positive,19,5,24
740140,4,Mostly Negative,3,10,13
740141,0,5 user reviews,3,2,5
740143,5,Mixed,28,17,45
740150,0,1 user reviews,1,0,1
740160,6,Mostly Positive,14,6,20
740170,0,2 user reviews,1,1,2
740190,0,5 user reviews,0,5,5
740200,5,Mixed,23,18,41
740220,0,2 user reviews,1,1,2
740230,8,Very Positive,76,11,87
740240,6,Mostly Positive,10,3,13
740260,7,Positive,18,3,21
740280,5,Mixed,5,5,10
740290,8,Very Positive,85,13,98
740300,0,3 user reviews,2,1,3
740320,6,Mostly Positive,7,3,10
740340,0,5 user reviews,3,2,5
740350,0,3 user reviews,2,1,3
740370,0,4 user reviews,4,0,4
740390,0,4 user reviews,1,3,4
740400,7,Positive,15,3,18
740410,7,Positive,25,4,29
740480,0,1 user reviews,1,0,1
740481,0,1 user reviews,1,0,1
740482,0,1 user reviews,1,0,1
740483,0,1 user reviews,1,0,1
740484,0,1 user reviews,1,0,1
740485,0,1 user reviews,1,0,1
740486,0,1 user reviews,1,0,1
740487,0,1 user reviews,1,0,1
740488,0,1 user reviews,1,0,1
740489,0,1 user reviews,1,0,1
740490,0,1 user reviews,1,0,1
740491,0,1 user reviews,1,0,1
740520,0,2 user reviews,2,0,2
740550,5,Mixed,26,16,42
740570,7,Positive,17,4,21
740590,0,8 user reviews,6,2,8
740591,0,9 user reviews,8,1,9
740592,0,7 user reviews,7,0,7
740600,5,Mixed,34,23,57
740650,0,4 user reviews,4,0,4
740660,0,8 user reviews,7,1,8
740720,0,1 user reviews,0,1,1
740730,0,2 user reviews,0,2,2
740780,0,7 user reviews,6,1,7
740790,5,Mixed,27,16,43
740810,5,Mixed,8,5,13
740950,0,2 user reviews,2,0,2
740960,0,1 user reviews,1,0,1
741010,0,1 user reviews,1,0,1
741030,0,2 user reviews,1,1,2
741080,0,1 user reviews,0,1,1
741100,0,7 user reviews,3,4,7
741110,0,2 user reviews,2,0,2
741120,4,Mostly Negative,3,7,10
741140,8,Very Positive,115,8,123
741150,8,Very Positive,42,8,50
741250,8,Very Positive,56,3,59
741260,5,Mixed,8,8,16
741350,6,Mostly Positive,220,69,289
741370,6,Mostly Positive,9,3,12
741400,7,Positive,20,5,25
741420,0,8 user reviews,6,2,8
741430,8,Very Positive,89,22,111
741450,0,5 user reviews,0,5,5
741470,0,1 user reviews,1,0,1
741490,5,Mixed,8,7,15
741500,5,Mixed,21,20,41
741510,6,Mostly Positive,206,74,280
741520,0,8 user reviews,7,1,8
741540,0,2 user reviews,2,0,2
741620,0,2 user reviews,1,1,2
741650,0,3 user reviews,1,2,3
741670,8,Very Positive,364,75,439
741710,0,2 user reviews,2,0,2
741711,0,1 user reviews,1,0,1
741760,0,6 user reviews,3,3,6
741770,0,5 user reviews,3,2,5
741780,0,1 user reviews,1,0,1
741820,4,Mostly Negative,86,213,299
741930,0,2 user reviews,0,2,2
741990,8,Very Positive,47,5,52
742010,0,4 user reviews,1,3,4
742030,0,9 user reviews,5,4,9
742120,8,Very Positive,3580,380,3960
742150,7,Positive,30,0,30
742220,0,3 user reviews,3,0,3
742230,0,3 user reviews,1,2,3
742250,8,Very Positive,60,9,69
742280,0,1 user reviews,1,0,1
742300,8,Very Positive,828,87,915
742340,6,Mostly Positive,7,3,10
742350,0,2 user reviews,2,0,2
742380,7,Positive,9,1,10
742460,8,Very Positive,122,19,141
742470,0,5 user reviews,5,0,5
742480,7,Positive,37,5,42
742490,8,Very Positive,57,13,70
742510,0,5 user reviews,4,1,5
742520,8,Very Positive,172,4,176
742530,6,Mostly Positive,20,7,27
742540,0,7 user reviews,6,1,7
742660,0,1 user reviews,1,0,1
742670,0,1 user reviews,1,0,1
742680,0,1 user reviews,1,0,1
742690,0,1 user reviews,1,0,1
742700,7,Positive,40,4,44
742790,0,2 user reviews,2,0,2
742800,0,2 user reviews,2,0,2
742830,7,Positive,13,3,16
742890,0,5 user reviews,5,0,5
742891,0,8 user reviews,8,0,8
742892,0,6 user reviews,6,0,6
742900,5,Mixed,18,8,26
742980,0,1 user reviews,1,0,1
743030,0,6 user reviews,3,3,6
743040,0,1 user reviews,1,0,1
743060,0,3 user reviews,0,3,3
743070,0,1 user reviews,1,0,1
743090,5,Mixed,28,37,65
743100,0,1 user reviews,1,0,1
743110,7,Positive,11,0,11
743130,8,Very Positive,317,17,334
743230,0,6 user reviews,5,1,6
743330,0,2 user reviews,1,1,2
743350,5,Mixed,8,4,12
743360,0,3 user reviews,3,0,3
743390,8,Very Positive,235,10,245
743450,9,Overwhelmingly Positive,4259,185,4444
743550,0,4 user reviews,4,0,4
743620,0,1 user reviews,0,1,1
743640,8,Very Positive,377,85,462
743660,0,5 user reviews,5,0,5
743830,5,Mixed,12,6,18
743850,7,Positive,18,1,19
743860,4,Mostly Negative,46,93,139
743880,0,2 user reviews,1,1,2
743890,6,Mostly Positive,432,180,612
743900,6,Mostly Positive,178,64,242
743940,0,5 user reviews,5,0,5
743960,5,Mixed,9,4,13
743990,0,2 user reviews,1,1,2
744010,0,4 user reviews,2,2,4
744040,6,Mostly Positive,7,3,10
744050,8,Very Positive,50,8,58
744060,6,Mostly Positive,311,105,416
744150,0,3 user reviews,3,0,3
744170,0,1 user reviews,1,0,1
744190,8,Very Positive,382,34,416
744220,3,Negative,2,9,11
744260,0,1 user reviews,0,1,1
744270,5,Mixed,26,34,60
744280,0,1 user reviews,0,1,1
744390,0,1 user reviews,0,1,1
744400,0,1 user reviews,1,0,1
744420,6,Mostly Positive,32,11,43
744430,7,Positive,25,4,29
744440,0,1 user reviews,1,0,1
744450,0,1 user reviews,0,1,1
744460,5,Mixed,7,7,14
744520,7,Positive,35,3,38
744550,0,1 user reviews,1,0,1
744570,8,Very Positive,58,10,68
744580,0,1 user reviews,1,0,1
744590,5,Mixed,6,5,11
744600,7,Positive,12,0,12
744610,0,5 user reviews,1,4,5
744630,0,1 user reviews,0,1,1
744650,7,Positive,16,0,16
744670,5,Mixed,68,35,103
744680,0,6 user reviews,4,2,6
744710,0,1 user reviews,0,1,1
744720,0,4 user reviews,0,4,4
744740,0,3 user reviews,3,0,3
744750,5,Mixed,7,5,12
744760,0,4 user reviews,2,2,4
744800,0,3 user reviews,3,0,3
744810,0,3 user reviews,3,0,3
744840,8,Very Positive,530,74,604
744871,0,2 user reviews,0,2,2
744880,0,1 user reviews,1,0,1
744890,0,1 user reviews,0,1,1
744920,0,2 user reviews,2,0,2
744940,5,Mixed,7,8,15
744950,5,Mixed,104,112,216
744990,0,1 user reviews,1,0,1
745000,6,Mostly Positive,58,19,77
745010,5,Mixed,60,36,96
745030,7,Positive,14,0,14
745060,0,2 user reviews,1,1,2
745090,7,Positive,20,3,23
745120,0,3 user reviews,1,2,3
745130,5,Mixed,8,7,15
745160,0,4 user reviews,4,0,4
745180,6,Mostly Positive,8,3,11
745220,6,Mostly Positive,158,45,203
745250,0,5 user reviews,4,1,5
745330,6,Mostly Positive,20,8,28
745340,4,Mostly Negative,4,7,11
745370,5,Mixed,6,6,12
745380,5,Mixed,5,6,11
745400,7,Positive,9,1,10
745420,0,4 user reviews,3,1,4
745430,0,3 user reviews,3,0,3
745500,0,4 user reviews,2,2,4
745510,7,Positive,27,5,32
745520,0,5 user reviews,5,0,5
745530,5,Mixed,6,5,11
745580,0,5 user reviews,4,1,5
745620,0,2 user reviews,1,1,2
745630,0,1 user reviews,1,0,1
745640,0,7 user reviews,0,7,7
745650,0,3 user reviews,3,0,3
745660,0,6 user reviews,6,0,6
745670,5,Mixed,5,6,11
745710,0,2 user reviews,2,0,2
745740,8,Very Positive,103,17,120
745750,0,1 user reviews,1,0,1
745790,7,Positive,13,1,14
745810,6,Mostly Positive,45,18,63
745830,0,6 user reviews,5,1,6
745840,0,5 user reviews,5,0,5
745850,8,Very Positive,60,5,65
745870,0,2 user reviews,2,0,2
745880,9,Overwhelmingly Positive,893,10,903
745890,0,3 user reviews,3,0,3
745900,0,3 user reviews,2,1,3
745911,0,1 user reviews,1,0,1
745912,0,1 user reviews,1,0,1
745920,8,Very Positive,11055,1192,12247
745930,0,2 user reviews,0,2,2
745940,5,Mixed,6,6,12
745950,7,Positive,20,5,25
745960,8,Very Positive,186,11,197
745970,6,Mostly Positive,18,5,23
746000,0,6 user reviews,5,1,6
746020,0,8 user reviews,2,6,8
746030,0,3 user reviews,2,1,3
746110,0,3 user reviews,3,0,3
746140,6,Mostly Positive,82,22,104
746220,0,2 user reviews,2,0,2
746240,0,6 user reviews,2,4,6
746340,0,1 user reviews,0,1,1
746350,5,Mixed,9,5,14
746360,0,1 user reviews,1,0,1
746390,5,Mixed,13,6,19
746400,8,Very Positive,126,5,131
746410,6,Mostly Positive,16,6,22
746420,0,4 user reviews,4,0,4
746430,0,9 user reviews,4,5,9
746470,7,Positive,17,2,19
746500,0,5 user reviews,5,0,5
746510,8,Very Positive,242,24,266
746540,5,Mixed,10,6,16
746560,8,Very Positive,57,1,58
746570,7,Positive,17,2,19
746580,8,Very Positive,319,31,350
746610,0,4 user reviews,3,1,4
746620,0,4 user reviews,2,2,4
746650,8,Very Positive,92,3,95
746660,0,8 user reviews,6,2,8
746680,0,1 user reviews,1,0,1
746710,8,Very Positive,183,16,199
746730,8,Very Positive,98,7,105
746731,0,4 user reviews,4,0,4
746750,0,8 user reviews,6,2,8
746760,4,Mostly Negative,5,8,13
746770,0,1 user reviews,1,0,1
746820,0,4 user reviews,4,0,4
746840,6,Mostly Positive,13,5,18
746850,8,Very Positive,1888,264,2152
746880,5,Mixed,12,7,19
746890,0,1 user reviews,1,0,1
746900,0,1 user reviews,0,1,1
746930,6,Mostly Positive,592,168,760
746940,8,Very Positive,85,5,90
746960,7,Positive,22,0,22
746990,0,6 user reviews,1,5,6
747020,0,1 user reviews,1,0,1
747030,0,9 user reviews,4,5,9
747040,0,5 user reviews,2,3,5
747050,6,Mostly Positive,8,3,11
747060,5,Mixed,23,12,35
747090,0,3 user reviews,2,1,3
747140,0,1 user reviews,1,0,1
747160,0,6 user reviews,6,0,6
747180,0,3 user reviews,3,0,3
747190,5,Mixed,26,12,38
747200,8,Very Positive,178,29,207
747260,5,Mixed,7,9,16
747290,0,3 user reviews,3,0,3
747310,5,Mixed,12,17,29
747320,6,Mostly Positive,13,4,17
747340,8,Very Positive,284,63,347
747350,8,Very Positive,418,56,474
747360,8,Very Positive,150,32,182
747410,0,1 user reviews,1,0,1
747470,7,Positive,15,2,17
747520,0,5 user reviews,5,0,5
747590,6,Mostly Positive,21,7,28
747600,0,1 user reviews,0,1,1
747620,7,Positive,17,1,18
747640,0,6 user reviews,5,1,6
747650,7,Positive,10,0,10
747690,7,Positive,17,3,20
747700,0,3 user reviews,0,3,3
747730,0,3 user reviews,2,1,3
747750,0,2 user reviews,2,0,2
747790,0,1 user reviews,1,0,1
747800,0,1 user reviews,0,1,1
747810,0,1 user reviews,1,0,1
747850,0,4 user reviews,3,1,4
747900,0,1 user reviews,1,0,1
747910,6,Mostly Positive,85,27,112
747980,0,3 user reviews,3,0,3
747990,0,9 user reviews,5,4,9
748010,0,1 user reviews,1,0,1
748040,8,Very Positive,50,3,53
748060,0,4 user reviews,1,3,4
748070,0,3 user reviews,3,0,3
748110,0,5 user reviews,4,1,5
748130,0,4 user reviews,1,3,4
748150,6,Mostly Positive,9,3,12
748260,0,1 user reviews,1,0,1
748270,0,8 user reviews,6,2,8
748290,0,1 user reviews,1,0,1
748300,5,Mixed,129,59,188
748310,0,4 user reviews,4,0,4
748330,7,Positive,11,0,11
748340,5,Mixed,11,11,22
748341,7,Positive,38,6,44
748360,8,Very Positive,508,123,631
748370,6,Mostly Positive,562,204,766
748430,0,2 user reviews,1,1,2
748460,8,Very Positive,42,8,50
748480,5,Mixed,17,8,25
748490,9,Overwhelmingly Positive,964,33,997
748500,0,1 user reviews,1,0,1
748520,0,2 user reviews,0,2,2
748540,0,9 user reviews,6,3,9
748580,0,2 user reviews,2,0,2
748600,7,Positive,14,3,17
748610,6,Mostly Positive,48,14,62
748650,0,3 user reviews,2,1,3
748670,0,4 user reviews,0,4,4
748680,0,2 user reviews,2,0,2
748720,0,2 user reviews,1,1,2
748790,0,1 user reviews,1,0,1
748800,0,2 user reviews,2,0,2
748820,0,4 user reviews,2,2,4
748850,0,1 user reviews,1,0,1
748880,0,7 user reviews,5,2,7
748890,8,Very Positive,84,7,91
748930,0,6 user reviews,3,3,6
748970,8,Very Positive,56,10,66
748980,0,3 user reviews,3,0,3
749010,0,9 user reviews,7,2,9
749040,0,2 user reviews,1,1,2
749050,5,Mixed,58,26,84
749080,0,7 user reviews,4,3,7
749110,0,4 user reviews,2,2,4
749130,0,2 user reviews,2,0,2
749140,7,Positive,12,0,12
749150,0,1 user reviews,0,1,1
749240,0,2 user reviews,1,1,2
749241,0,1 user reviews,1,0,1
749242,0,1 user reviews,1,0,1
749250,6,Mostly Positive,85,35,120
749270,4,Mostly Negative,7,16,23
749290,0,1 user reviews,1,0,1
749320,0,3 user reviews,3,0,3
749340,6,Mostly Positive,24,9,33
749370,5,Mixed,6,7,13
749410,7,Positive,12,1,13
749470,0,1 user reviews,1,0,1
749480,0,8 user reviews,3,5,8
749520,0,4 user reviews,4,0,4
749540,4,Mostly Negative,17,30,47
749550,6,Mostly Positive,9,3,12
749560,7,Positive,20,4,24
749580,0,3 user reviews,0,3,3
749590,0,1 user reviews,1,0,1
749650,0,1 user reviews,0,1,1
749670,0,8 user reviews,5,3,8
749700,0,7 user reviews,7,0,7
749710,0,6 user reviews,4,2,6
749730,7,Positive,11,1,12
749780,5,Mixed,57,73,130
749800,5,Mixed,70,43,113
749830,0,5 user reviews,3,2,5
749840,6,Mostly Positive,35,9,44
749850,0,9 user reviews,9,0,9
749860,0,5 user reviews,3,2,5
749880,0,4 user reviews,1,3,4
749890,7,Positive,40,4,44
749900,0,1 user reviews,0,1,1
749920,7,Positive,15,2,17
749960,5,Mixed,72,39,111
749980,0,7 user reviews,4,3,7
749990,0,7 user reviews,6,1,7
750010,5,Mixed,30,16,46
750020,0,2 user reviews,2,0,2
750030,8,Very Positive,94,18,112
750031,5,Mixed,134,78,212
750050,5,Mixed,280,177,457
750060,0,9 user reviews,9,0,9
750070,4,Mostly Negative,6,14,20
750080,0,3 user reviews,2,1,3
750170,8,Very Positive,129,5,134
750210,6,Mostly Positive,41,17,58
750230,5,Mixed,6,6,12
750310,6,Mostly Positive,39,11,50
750320,0,9 user reviews,8,1,9
750330,5,Mixed,8,7,15
750340,0,7 user reviews,7,0,7
750341,0,8 user reviews,8,0,8
750342,0,7 user reviews,7,0,7
750381,8,Very Positive,364,83,447
750430,0,4 user reviews,3,1,4
750440,0,5 user reviews,2,3,5
750450,7,Positive,25,0,25
750460,7,Positive,16,4,20
750470,8,Very Positive,102,8,110
750490,0,2 user reviews,2,0,2
750491,0,2 user reviews,1,1,2
750492,0,5 user reviews,4,1,5
750500,7,Positive,9,2,11
750520,6,Mostly Positive,65,18,83
750620,0,2 user reviews,1,1,2
750640,0,1 user reviews,1,0,1
750660,5,Mixed,6,5,11
750710,0,2 user reviews,1,1,2
750770,5,Mixed,9,4,13
750780,0,2 user reviews,2,0,2
750790,0,3 user reviews,2,1,3
750800,5,Mixed,28,14,42
750820,0,1 user reviews,1,0,1
750840,0,2 user reviews,0,2,2
750850,7,Positive,21,5,26
750870,0,3 user reviews,2,1,3
750910,0,3 user reviews,3,0,3
750920,8,Very Positive,8280,1586,9866
750960,0,7 user reviews,7,0,7
750970,0,7 user reviews,4,3,7
750990,7,Positive,25,2,27
751060,6,Mostly Positive,12,5,17
751110,6,Mostly Positive,37,13,50
751160,0,2 user reviews,0,2,2
751170,0,4 user reviews,3,1,4
751180,0,1 user reviews,0,1,1
751200,7,Positive,8,2,10
751220,7,Positive,27,1,28
751240,5,Mixed,65,48,113
751250,7,Positive,26,5,31
751260,0,5 user reviews,5,0,5
751270,0,1 user reviews,1,0,1
751280,8,Very Positive,68,1,69
751300,8,Very Positive,56,6,62
751330,0,5 user reviews,3,2,5
751340,6,Mostly Positive,19,7,26
751380,0,6 user reviews,5,1,6
751390,0,8 user reviews,5,3,8
751400,0,3 user reviews,3,0,3
751430,0,2 user reviews,1,1,2
751440,6,Mostly Positive,303,91,394
751450,8,Very Positive,69,1,70
751470,0,7 user reviews,7,0,7
751480,0,4 user reviews,3,1,4
751500,5,Mixed,80,39,119
751530,0,1 user reviews,0,1,1
751540,0,5 user reviews,2,3,5
751580,0,1 user reviews,1,0,1
751640,7,Positive,25,1,26
751660,0,2 user reviews,1,1,2
751670,0,2 user reviews,2,0,2
751680,0,2 user reviews,2,0,2
751700,0,1 user reviews,1,0,1
751720,0,5 user reviews,5,0,5
751730,7,Positive,14,2,16
751740,0,3 user reviews,0,3,3
751780,8,Very Positive,6367,420,6787
751820,8,Very Positive,86,19,105
751870,0,2 user reviews,0,2,2
751880,0,5 user reviews,5,0,5
751950,0,8 user reviews,7,1,8
751970,0,6 user reviews,6,0,6
752000,0,1 user reviews,0,1,1
752020,5,Mixed,5,7,12
752030,0,7 user reviews,4,3,7
752050,5,Mixed,11,11,22
752080,0,2 user reviews,2,0,2
752170,0,7 user reviews,7,0,7
752200,0,1 user reviews,0,1,1
752300,4,Mostly Negative,5,10,15
752310,0,4 user reviews,2,2,4
752330,7,Positive,24,5,29
752380,6,Mostly Positive,19,5,24
752400,0,1 user reviews,0,1,1
752430,0,3 user reviews,3,0,3
752440,0,7 user reviews,7,0,7
752450,5,Mixed,12,6,18
752470,7,Positive,35,7,42
752500,7,Positive,26,6,32
752520,5,Mixed,10,6,16
752550,7,Positive,13,0,13
752560,0,1 user reviews,1,0,1
752570,5,Mixed,5,5,10
752590,8,Very Positive,8483,588,9071
752600,0,7 user reviews,7,0,7
752640,6,Mostly Positive,15,5,20
752690,0,3 user reviews,2,1,3
752700,0,3 user reviews,0,3,3
752710,0,1 user reviews,1,0,1
752720,2,Very Negative,14,97,111
752730,4,Mostly Negative,4,13,17
752750,4,Mostly Negative,6,11,17
752780,0,4 user reviews,0,4,4
752790,0,2 user reviews,1,1,2
752800,7,Positive,17,0,17
752810,0,6 user reviews,2,4,6
752830,0,5 user reviews,3,2,5
752850,6,Mostly Positive,8,3,11
752910,8,Very Positive,84,13,97
752920,0,2 user reviews,2,0,2
753000,0,2 user reviews,1,1,2
753100,0,2 user reviews,0,2,2
753110,4,Mostly Negative,12,25,37
753120,0,1 user reviews,1,0,1
753170,0,1 user reviews,0,1,1
753200,0,6 user reviews,6,0,6
753210,4,Mostly Negative,3,7,10
753220,8,Very Positive,91,0,91
753230,6,Mostly Positive,54,21,75
753240,0,3 user reviews,1,2,3
753270,0,9 user reviews,6,3,9
753291,0,1 user reviews,1,0,1
753360,5,Mixed,17,8,25
753370,0,7 user reviews,2,5,7
753380,0,5 user reviews,4,1,5
753390,0,2 user reviews,1,1,2
753400,0,3 user reviews,3,0,3
753420,8,Very Positive,958,95,1053
753440,7,Positive,12,2,14
753450,0,2 user reviews,2,0,2
753460,0,2 user reviews,1,1,2
753470,0,1 user reviews,1,0,1
753490,0,5 user reviews,2,3,5
753500,0,2 user reviews,1,1,2
753560,0,3 user reviews,3,0,3
753570,0,1 user reviews,0,1,1
753590,5,Mixed,125,55,180
753640,8,Very Positive,5745,339,6084
753650,8,Very Positive,568,54,622
753660,8,Very Positive,44,10,54
753670,0,4 user reviews,2,2,4
753742,0,1 user reviews,0,1,1
753771,0,1 user reviews,1,0,1
753780,0,1 user reviews,1,0,1
753786,0,2 user reviews,1,1,2
753789,0,2 user reviews,2,0,2
753794,0,1 user reviews,1,0,1
753796,0,1 user reviews,1,0,1
753797,0,3 user reviews,3,0,3
753814,0,4 user reviews,0,4,4
753829,0,1 user reviews,1,0,1
753836,0,2 user reviews,0,2,2
753842,0,1 user reviews,1,0,1
753845,0,1 user reviews,1,0,1
753859,0,1 user reviews,1,0,1
753863,0,1 user reviews,1,0,1
753873,0,1 user reviews,1,0,1
753874,0,1 user reviews,1,0,1
753875,0,1 user reviews,1,0,1
753876,0,1 user reviews,0,1,1
753877,0,1 user reviews,1,0,1
753892,0,7 user reviews,7,0,7
753894,0,1 user reviews,1,0,1
753900,5,Mixed,24,15,39
753920,0,8 user reviews,3,5,8
753930,5,Mixed,176,85,261
753960,0,5 user reviews,2,3,5
753990,0,9 user reviews,4,5,9
754020,0,4 user reviews,3,1,4
754040,8,Very Positive,48,3,51
754110,0,9 user reviews,6,3,9
754120,5,Mixed,16,9,25
754150,8,Very Positive,548,30,578
754190,0,5 user reviews,5,0,5
754200,0,1 user reviews,0,1,1
754230,0,5 user reviews,4,1,5
754270,0,4 user reviews,4,0,4
754290,0,1 user reviews,0,1,1
754300,0,6 user reviews,6,0,6
754310,0,5 user reviews,5,0,5
754320,0,5 user reviews,4,1,5
754330,0,4 user reviews,2,2,4
754340,6,Mostly Positive,18,6,24
754380,0,2 user reviews,0,2,2
754400,0,2 user reviews,2,0,2
754460,0,6 user reviews,5,1,6
754470,0,1 user reviews,0,1,1
754500,6,Mostly Positive,217,73,290
754510,0,4 user reviews,3,1,4
754520,7,Positive,12,2,14
754530,5,Mixed,231,126,357
754540,7,Positive,14,2,16
754610,4,Mostly Negative,3,7,10
754630,0,2 user reviews,1,1,2
754680,6,Mostly Positive,19,5,24
754770,7,Positive,33,3,36
754790,0,6 user reviews,6,0,6
754800,0,1 user reviews,0,1,1
754810,0,1 user reviews,1,0,1
754830,0,3 user reviews,3,0,3
754840,8,Very Positive,47,4,51
754850,5,Mixed,31,20,51
754920,6,Mostly Positive,17,5,22
754921,5,Mixed,16,14,30
754922,5,Mixed,9,5,14
754923,0,9 user reviews,4,5,9
754930,0,7 user reviews,5,2,7
755070,0,1 user reviews,1,0,1
755130,0,3 user reviews,2,1,3
755140,0,2 user reviews,0,2,2
755230,0,1 user reviews,1,0,1
755240,0,1 user reviews,0,1,1
755250,0,4 user reviews,4,0,4
755290,0,2 user reviews,0,2,2
755340,0,2 user reviews,2,0,2
755350,5,Mixed,10,15,25
755370,0,1 user reviews,1,0,1
755410,8,Very Positive,95,4,99
755470,8,Very Positive,86,19,105
755490,0,7 user reviews,7,0,7
755500,6,Mostly Positive,241,78,319
755520,0,9 user reviews,8,1,9
755530,0,1 user reviews,1,0,1
755560,0,5 user reviews,4,1,5
755570,5,Mixed,20,17,37
755580,0,1 user reviews,0,1,1
755590,7,Positive,9,1,10
755600,6,Mostly Positive,9,3,12
755610,0,2 user reviews,2,0,2
755630,5,Mixed,23,15,38
755670,7,Positive,13,3,16
755743,0,1 user reviews,0,1,1
755744,0,1 user reviews,0,1,1
755752,0,1 user reviews,0,1,1
755756,0,3 user reviews,3,0,3
755757,0,4 user reviews,2,2,4
755760,0,1 user reviews,1,0,1
755790,6,Mostly Positive,161,64,225
755830,0,8 user reviews,7,1,8
755850,0,4 user reviews,2,2,4
755860,0,1 user reviews,1,0,1
755890,6,Mostly Positive,29,12,41
755920,0,7 user reviews,7,0,7
755950,7,Positive,24,3,27
755980,8,Very Positive,64,12,76
756010,5,Mixed,116,103,219
756020,7,Positive,9,1,10
756040,6,Mostly Positive,12,5,17
756060,0,8 user reviews,7,1,8
756070,0,6 user reviews,5,1,6
756071,6,Mostly Positive,102,39,141
756080,0,4 user reviews,3,1,4
756090,4,Mostly Negative,5,10,15
756100,0,1 user reviews,1,0,1
756150,0,1 user reviews,1,0,1
756190,0,1 user reviews,0,1,1
756210,0,3 user reviews,3,0,3
756230,0,7 user reviews,3,4,7
756240,6,Mostly Positive,22,7,29
756260,4,Mostly Negative,4,8,12
756280,0,7 user reviews,6,1,7
756290,0,2 user reviews,0,2,2
756320,7,Positive,23,0,23
756340,0,2 user reviews,1,1,2
756350,0,4 user reviews,1,3,4
756360,5,Mixed,25,18,43
756420,0,4 user reviews,0,4,4
756440,0,6 user reviews,6,0,6
756490,0,6 user reviews,3,3,6
756500,4,Mostly Negative,7,12,19
756520,0,3 user reviews,0,3,3
756530,6,Mostly Positive,96,38,134
756560,0,3 user reviews,3,0,3
756590,8,Very Positive,79,9,88
756600,7,Positive,13,2,15
756630,0,4 user reviews,4,0,4
756660,8,Very Positive,420,25,445
756680,0,2 user reviews,2,0,2
756700,7,Positive,13,3,16
756720,0,1 user reviews,0,1,1
756721,0,1 user reviews,1,0,1
756728,0,1 user reviews,0,1,1
756740,0,1 user reviews,1,0,1
756790,0,5 user reviews,5,0,5
756810,0,3 user reviews,1,2,3
756840,0,4 user reviews,4,0,4
756860,0,3 user reviews,2,1,3
756880,5,Mixed,17,22,39
756890,0,1 user reviews,1,0,1
756951,0,2 user reviews,0,2,2
756955,0,4 user reviews,3,1,4
756980,0,1 user reviews,1,0,1
757030,7,Positive,12,0,12
757040,7,Positive,47,2,49
757060,6,Mostly Positive,7,3,10
757070,0,1 user reviews,0,1,1
757080,7,Positive,9,2,11
757100,0,8 user reviews,7,1,8
757160,4,Mostly Negative,5,9,14
757170,0,2 user reviews,2,0,2
757180,7,Positive,42,6,48
757190,0,1 user reviews,1,0,1
757200,6,Mostly Positive,22,9,31
757210,8,Very Positive,154,15,169
757230,0,2 user reviews,0,2,2
757240,0,1 user reviews,1,0,1
757280,0,2 user reviews,2,0,2
757300,8,Very Positive,88,18,106
757320,8,Very Positive,180,19,199
757330,8,Very Positive,67,7,74
757350,5,Mixed,6,8,14
757400,0,1 user reviews,1,0,1
757420,0,7 user reviews,2,5,7
757430,0,4 user reviews,4,0,4
757450,6,Mostly Positive,17,5,22
757480,8,Very Positive,442,15,457
757500,0,2 user reviews,0,2,2
757510,0,8 user reviews,7,1,8
757540,0,4 user reviews,2,2,4
757580,6,Mostly Positive,12,5,17
757590,5,Mixed,9,8,17
757600,0,3 user reviews,1,2,3
757630,4,Mostly Negative,4,8,12
757700,0,3 user reviews,3,0,3
757730,7,Positive,12,1,13
757760,0,1 user reviews,1,0,1
757770,0,5 user reviews,4,1,5
757860,5,Mixed,5,7,12
757870,0,4 user reviews,3,1,4
757990,0,2 user reviews,1,1,2
758020,0,1 user reviews,1,0,1
758050,4,Mostly Negative,4,7,11
758070,7,Positive,9,1,10
758080,6,Mostly Positive,43,14,57
758090,7,Positive,17,0,17
758100,5,Mixed,29,22,51
758120,5,Mixed,8,6,14
758140,0,1 user reviews,0,1,1
758150,0,5 user reviews,4,1,5
758160,8,Very Positive,60,0,60
758170,0,6 user reviews,5,1,6
758190,8,Very Positive,589,92,681
758220,0,5 user reviews,4,1,5
758230,8,Very Positive,170,6,176
758250,5,Mixed,12,6,18
758290,0,5 user reviews,5,0,5
758320,6,Mostly Positive,48,14,62
758330,8,Very Positive,627,76,703
758370,8,Very Positive,455,51,506
758390,0,4 user reviews,1,3,4
758400,0,3 user reviews,2,1,3
758410,6,Mostly Positive,89,25,114
758420,5,Mixed,268,128,396
758440,0,7 user reviews,5,2,7
758470,0,7 user reviews,4,3,7
758480,8,Very Positive,211,9,220
758500,8,Very Positive,277,15,292
758560,7,Positive,15,0,15
758570,8,Very Positive,58,12,70
758580,0,3 user reviews,3,0,3
758590,0,3 user reviews,3,0,3
758600,0,3 user reviews,2,1,3
758610,0,1 user reviews,0,1,1
758630,0,5 user reviews,5,0,5
758640,0,1 user reviews,1,0,1
758660,7,Positive,24,1,25
758730,8,Very Positive,43,10,53
758770,4,Mostly Negative,13,20,33
758771,4,Mostly Negative,6,12,18
758790,0,1 user reviews,0,1,1
758870,8,Very Positive,455,51,506
758880,0,8 user reviews,5,3,8
758910,0,1 user reviews,1,0,1
758930,7,Positive,33,6,39
758990,8,Very Positive,612,57,669
759000,7,Positive,41,5,46
759010,0,6 user reviews,3,3,6
759060,6,Mostly Positive,17,6,23
759130,6,Mostly Positive,54,14,68
759160,5,Mixed,6,6,12
759170,0,1 user reviews,1,0,1
759220,7,Positive,15,1,16
759240,0,4 user reviews,4,0,4
759250,0,3 user reviews,3,0,3
759260,0,8 user reviews,6,2,8
759280,0,1 user reviews,0,1,1
759330,0,1 user reviews,1,0,1
759440,8,Very Positive,105,11,116
759454,0,2 user reviews,2,0,2
759455,0,2 user reviews,2,0,2
759500,0,6 user reviews,5,1,6
759540,6,Mostly Positive,55,14,69
759570,5,Mixed,22,26,48
759580,0,5 user reviews,4,1,5
759581,0,2 user reviews,2,0,2
759590,0,3 user reviews,3,0,3
759610,0,3 user reviews,2,1,3
759640,7,Positive,17,1,18
759650,0,1 user reviews,1,0,1
759680,0,1 user reviews,1,0,1
759681,0,2 user reviews,2,0,2
759740,6,Mostly Positive,540,141,681
759750,5,Mixed,9,10,19
759760,0,2 user reviews,2,0,2
759770,0,4 user reviews,3,1,4
759830,0,7 user reviews,4,3,7
759850,0,1 user reviews,1,0,1
759870,3,Negative,3,16,19
759940,0,8 user reviews,8,0,8
759950,0,8 user reviews,4,4,8
760000,0,2 user reviews,2,0,2
760020,0,4 user reviews,3,1,4
760030,0,2 user reviews,2,0,2
760050,7,Positive,29,6,35
760060,8,Very Positive,4265,496,4761
760070,6,Mostly Positive,86,32,118
760080,6,Mostly Positive,25,10,35
760120,0,1 user reviews,0,1,1
760180,0,3 user reviews,2,1,3
760200,7,Positive,36,3,39
760220,0,2 user reviews,2,0,2
760300,0,7 user reviews,7,0,7
760320,6,Mostly Positive,7,3,10
760330,8,Very Positive,175,8,183
760350,5,Mixed,8,5,13
760360,0,2 user reviews,0,2,2
760390,0,1 user reviews,1,0,1
760400,5,Mixed,12,6,18
760420,0,1 user reviews,0,1,1
760460,5,Mixed,30,22,52
760510,0,7 user reviews,7,0,7
760520,0,2 user reviews,1,1,2
760530,0,1 user reviews,0,1,1
760560,5,Mixed,6,6,12
760580,0,2 user reviews,1,1,2
760610,0,7 user reviews,7,0,7
760620,6,Mostly Positive,165,58,223
760630,7,Positive,40,4,44
760650,8,Very Positive,63,12,75
760660,0,6 user reviews,1,5,6
760680,0,4 user reviews,2,2,4
760710,0,2 user reviews,1,1,2
760720,0,5 user reviews,5,0,5
760730,6,Mostly Positive,47,18,65
760800,6,Mostly Positive,35,15,50
760810,7,Positive,40,1,41
760840,4,Mostly Negative,4,8,12
760841,4,Mostly Negative,4,7,11
760842,3,Negative,2,13,15
760843,4,Mostly Negative,17,38,55
760844,0,7 user reviews,1,6,7
760860,5,Mixed,7,7,14
760890,8,Very Positive,154,3,157
760920,7,Positive,19,1,20
760930,5,Mixed,16,14,30
760960,0,4 user reviews,3,1,4
760970,0,2 user reviews,2,0,2
761030,8,Very Positive,120,27,147
761040,0,5 user reviews,5,0,5
761100,0,1 user reviews,1,0,1
761110,0,4 user reviews,1,3,4
761160,0,4 user reviews,4,0,4
761170,7,Positive,33,2,35
761190,0,5 user reviews,4,1,5
761220,0,4 user reviews,2,2,4
761250,0,7 user reviews,1,6,7
761290,0,3 user reviews,3,0,3
761300,0,1 user reviews,1,0,1
761320,7,Positive,25,5,30
761350,8,Very Positive,53,5,58
761440,0,2 user reviews,2,0,2
761460,8,Very Positive,214,22,236
761480,7,Positive,21,0,21
761590,0,6 user reviews,6,0,6
761591,0,4 user reviews,4,0,4
761592,0,3 user reviews,3,0,3
761593,0,3 user reviews,3,0,3
761594,0,4 user reviews,4,0,4
761595,0,2 user reviews,2,0,2
761596,7,Positive,10,0,10
761597,0,1 user reviews,1,0,1
761600,8,Very Positive,407,23,430
761620,8,Very Positive,367,77,444
761630,3,Negative,1,9,10
761640,0,9 user reviews,1,8,9
761660,0,3 user reviews,0,3,3
761670,7,Positive,16,0,16
761700,5,Mixed,6,4,10
761760,5,Mixed,10,6,16
761790,5,Mixed,8,7,15
761880,0,1 user reviews,1,0,1
761890,5,Mixed,539,235,774
761910,8,Very Positive,134,18,152
761920,0,2 user reviews,2,0,2
761930,0,1 user reviews,0,1,1
762030,7,Positive,16,1,17
762070,0,1 user reviews,1,0,1
762080,6,Mostly Positive,28,11,39
762110,0,3 user reviews,3,0,3
762120,0,2 user reviews,0,2,2
762130,0,2 user reviews,1,1,2
762140,0,1 user reviews,0,1,1
762174,7,Positive,30,0,30
762176,0,1 user reviews,1,0,1
762177,0,4 user reviews,4,0,4
762178,0,3 user reviews,3,0,3
762179,0,5 user reviews,4,1,5
762180,7,Positive,17,0,17
762190,0,6 user reviews,6,0,6
762220,6,Mostly Positive,34,10,44
762240,0,5 user reviews,5,0,5
762270,0,8 user reviews,8,0,8
762290,0,1 user reviews,1,0,1
762300,0,1 user reviews,1,0,1
762310,0,1 user reviews,1,0,1
762320,0,1 user reviews,1,0,1
762330,0,1 user reviews,1,0,1
762340,0,1 user reviews,1,0,1
762350,0,1 user reviews,1,0,1
762360,0,1 user reviews,1,0,1
762380,5,Mixed,5,5,10
762390,0,2 user reviews,2,0,2
762490,6,Mostly Positive,22,9,31
762500,7,Positive,11,2,13
762520,5,Mixed,12,10,22
762590,7,Positive,12,3,15
762600,0,7 user reviews,6,1,7
762610,8,Very Positive,89,2,91
762630,0,4 user reviews,2,2,4
762640,0,1 user reviews,1,0,1
762650,5,Mixed,283,125,408
762670,0,2 user reviews,1,1,2
762680,0,3 user reviews,1,2,3
762770,7,Positive,12,1,13
762830,5,Mixed,227,112,339
762860,0,1 user reviews,1,0,1
762900,0,6 user reviews,2,4,6
762912,7,Positive,12,0,12
762913,7,Positive,21,1,22
762914,0,3 user reviews,3,0,3
762915,0,9 user reviews,9,0,9
762916,0,4 user reviews,4,0,4
762918,0,3 user reviews,3,0,3
762919,0,4 user reviews,4,0,4
762920,4,Mostly Negative,10,18,28
762930,7,Positive,18,0,18
762950,0,4 user reviews,3,1,4
762970,0,1 user reviews,0,1,1
762980,0,1 user reviews,1,0,1
763010,0,5 user reviews,4,1,5
763030,8,Very Positive,49,4,53
763050,0,9 user reviews,5,4,9
763070,5,Mixed,8,4,12
763090,5,Mixed,4,6,10
763100,5,Mixed,24,13,37
763210,0,7 user reviews,3,4,7
763250,6,Mostly Positive,69,22,91
763270,6,Mostly Positive,8,3,11
763280,0,2 user reviews,2,0,2
763290,5,Mixed,15,10,25
763300,0,5 user reviews,1,4,5
763320,0,3 user reviews,3,0,3
763350,0,3 user reviews,3,0,3
763360,0,5 user reviews,3,2,5
763370,0,6 user reviews,4,2,6
763380,0,2 user reviews,2,0,2
763400,0,2 user reviews,0,2,2
763430,6,Mostly Positive,47,15,62
763490,0,1 user reviews,1,0,1
763520,0,4 user reviews,2,2,4
763590,0,1 user reviews,1,0,1
763630,0,5 user reviews,3,2,5
763680,0,1 user reviews,0,1,1
763691,0,4 user reviews,4,0,4
763692,0,4 user reviews,4,0,4
763693,7,Positive,12,0,12
763699,8,Very Positive,51,3,54
763710,0,7 user reviews,5,2,7
763730,0,8 user reviews,5,3,8
763740,0,3 user reviews,1,2,3
763750,0,5 user reviews,3,2,5
763760,7,Positive,16,1,17
763770,5,Mixed,13,6,19
763780,8,Very Positive,288,27,315
763790,7,Positive,29,2,31
763810,0,6 user reviews,4,2,6
763820,5,Mixed,123,120,243
763890,9,Overwhelmingly Positive,1418,44,1462
763910,7,Positive,18,4,22
763930,8,Very Positive,49,1,50
763950,0,6 user reviews,2,4,6
763970,7,Positive,26,6,32
763990,5,Mixed,12,7,19
764010,5,Mixed,16,15,31
764050,8,Very Positive,443,103,546
764090,0,3 user reviews,3,0,3
764110,7,Positive,8,2,10
764180,0,6 user reviews,5,1,6
764230,8,Very Positive,52,5,57
764240,7,Positive,8,2,10
764280,0,7 user reviews,7,0,7
764300,8,Very Positive,142,10,152
764320,0,2 user reviews,1,1,2
764330,0,1 user reviews,1,0,1
764340,0,1 user reviews,1,0,1
764370,0,7 user reviews,7,0,7
764390,0,1 user reviews,1,0,1
764410,0,1 user reviews,0,1,1
764430,5,Mixed,8,5,13
764470,0,6 user reviews,4,2,6
764490,0,4 user reviews,1,3,4
764500,7,Positive,27,6,33
764510,8,Very Positive,63,11,74
764550,0,1 user reviews,0,1,1
764560,5,Mixed,10,5,15
764590,6,Mostly Positive,15,4,19
764660,0,1 user reviews,1,0,1
764661,0,2 user reviews,2,0,2
764670,5,Mixed,10,9,19
764720,0,2 user reviews,2,0,2
764780,0,1 user reviews,0,1,1
764790,8,Very Positive,1996,132,2128
764830,0,4 user reviews,2,2,4
764880,0,1 user reviews,1,0,1
764890,0,4 user reviews,4,0,4
764920,5,Mixed,151,113,264
764970,0,8 user reviews,7,1,8
764990,7,Positive,21,1,22
765010,0,1 user reviews,1,0,1
765030,0,1 user reviews,1,0,1
765040,0,1 user reviews,1,0,1
765050,0,1 user reviews,0,1,1
765060,7,Positive,11,1,12
765100,7,Positive,10,0,10
765140,0,2 user reviews,1,1,2
765160,0,8 user reviews,4,4,8
765180,4,Mostly Negative,6,14,20
765210,6,Mostly Positive,48,16,64
765230,0,9 user reviews,8,1,9
765250,5,Mixed,25,20,45
765260,0,3 user reviews,1,2,3
765320,0,3 user reviews,1,2,3
765340,0,1 user reviews,0,1,1
765350,0,3 user reviews,3,0,3
765360,0,3 user reviews,3,0,3
765370,0,3 user reviews,0,3,3
765380,5,Mixed,8,4,12
765390,0,8 user reviews,1,7,8
765400,0,5 user reviews,1,4,5
765410,9,Overwhelmingly Positive,2103,92,2195
765430,0,5 user reviews,5,0,5
765460,0,6 user reviews,4,2,6
765470,0,4 user reviews,2,2,4
765490,0,7 user reviews,6,1,7
765520,0,2 user reviews,2,0,2
765530,0,3 user reviews,0,3,3
765560,0,7 user reviews,4,3,7
765570,0,3 user reviews,1,2,3
765590,7,Positive,16,2,18
765610,7,Positive,16,2,18
765620,0,1 user reviews,0,1,1
765640,0,4 user reviews,4,0,4
765690,7,Positive,14,0,14
765710,0,1 user reviews,1,0,1
765730,0,3 user reviews,0,3,3
765750,0,4 user reviews,4,0,4
765770,0,8 user reviews,7,1,8
765790,0,3 user reviews,1,2,3
765830,0,4 user reviews,4,0,4
765840,0,9 user reviews,8,1,9
765850,0,6 user reviews,6,0,6
765860,0,5 user reviews,4,1,5
765870,8,Very Positive,238,50,288
765880,6,Mostly Positive,46,14,60
765890,7,Positive,25,1,26
765900,6,Mostly Positive,59,19,78
765910,0,7 user reviews,7,0,7
765930,0,3 user reviews,0,3,3
765940,7,Positive,18,1,19
765950,0,5 user reviews,2,3,5
765960,7,Positive,32,3,35
766000,7,Positive,10,2,12
766010,0,1 user reviews,1,0,1
766030,7,Positive,10,0,10
766040,5,Mixed,31,30,61
766070,0,1 user reviews,0,1,1
766150,0,1 user reviews,1,0,1
766280,8,Very Positive,124,10,134
766300,0,3 user reviews,3,0,3
766320,6,Mostly Positive,58,17,75
766370,5,Mixed,262,165,427
766420,0,2 user reviews,1,1,2
766449,0,1 user reviews,1,0,1
766450,0,3 user reviews,3,0,3
766460,0,2 user reviews,0,2,2
766471,0,1 user reviews,1,0,1
766472,0,1 user reviews,1,0,1
766500,0,1 user reviews,1,0,1
766521,0,2 user reviews,2,0,2
766550,6,Mostly Positive,7,3,10
766560,7,Positive,9,1,10
766580,0,2 user reviews,0,2,2
766600,4,Mostly Negative,3,7,10
766620,0,1 user reviews,0,1,1
766630,7,Positive,39,8,47
766680,5,Mixed,12,9,21
766700,0,7 user reviews,3,4,7
766710,0,1 user reviews,1,0,1
766712,0,3 user reviews,2,1,3
766730,8,Very Positive,83,6,89
766740,0,9 user reviews,8,1,9
766780,0,6 user reviews,6,0,6
766850,5,Mixed,28,27,55
766870,8,Very Positive,50,10,60
766910,0,1 user reviews,1,0,1
766940,7,Positive,25,1,26
767010,0,1 user reviews,1,0,1
767020,0,2 user reviews,2,0,2
767030,5,Mixed,5,6,11
767050,4,Mostly Negative,4,7,11
767100,0,5 user reviews,2,3,5
767110,5,Mixed,4,6,10
767130,0,4 user reviews,1,3,4
767170,0,1 user reviews,0,1,1
767190,0,4 user reviews,4,0,4
767200,0,2 user reviews,2,0,2
767240,7,Positive,12,3,15
767260,0,1 user reviews,1,0,1
767310,0,7 user reviews,1,6,7
767330,0,4 user reviews,0,4,4
767340,0,7 user reviews,3,4,7
767360,7,Positive,17,1,18
767390,5,Mixed,97,46,143
767400,0,1 user reviews,1,0,1
767460,7,Positive,19,4,23
767490,6,Mostly Positive,33,9,42
767500,0,5 user reviews,5,0,5
767570,7,Positive,13,0,13
767580,0,2 user reviews,1,1,2
767650,7,Positive,11,0,11
767810,0,1 user reviews,1,0,1
767840,0,2 user reviews,1,1,2
767890,5,Mixed,8,5,13
767910,0,3 user reviews,0,3,3
767930,8,Very Positive,138,15,153
767960,0,3 user reviews,1,2,3
767970,6,Mostly Positive,11,3,14
767980,0,4 user reviews,3,1,4
768020,0,2 user reviews,1,1,2
768050,0,7 user reviews,4,3,7
768060,7,Positive,15,2,17
768090,0,7 user reviews,5,2,7
768110,0,1 user reviews,1,0,1
768130,0,2 user reviews,1,1,2
768170,0,4 user reviews,1,3,4
768240,0,3 user reviews,3,0,3
768270,0,9 user reviews,9,0,9
768290,7,Positive,13,1,14
768300,0,2 user reviews,1,1,2
768310,0,1 user reviews,1,0,1
768340,0,3 user reviews,3,0,3
768370,5,Mixed,30,32,62
768460,6,Mostly Positive,12,4,16
768480,0,2 user reviews,2,0,2
768530,5,Mixed,42,19,61
768540,5,Mixed,17,11,28
768550,0,9 user reviews,6,3,9
768561,0,2 user reviews,0,2,2
768562,0,2 user reviews,2,0,2
768570,0,3 user reviews,0,3,3
768580,0,7 user reviews,6,1,7
768590,7,Positive,10,1,11
768640,0,2 user reviews,2,0,2
768702,0,1 user reviews,1,0,1
768703,0,1 user reviews,0,1,1
768730,0,2 user reviews,1,1,2
768750,5,Mixed,54,68,122
768770,0,2 user reviews,2,0,2
768800,6,Mostly Positive,26,9,35
768830,8,Very Positive,55,8,63
768880,0,4 user reviews,3,1,4
768990,0,8 user reviews,4,4,8
769020,0,2 user reviews,2,0,2
769060,0,8 user reviews,6,2,8
769080,0,5 user reviews,2,3,5
769110,4,Mostly Negative,5,9,14
769130,0,6 user reviews,6,0,6
769140,0,1 user reviews,1,0,1
769150,0,6 user reviews,2,4,6
769160,0,1 user reviews,1,0,1
769180,7,Positive,22,0,22
769200,0,6 user reviews,4,2,6
769220,7,Positive,10,2,12
769320,7,Positive,10,0,10
769340,0,8 user reviews,6,2,8
769360,4,Mostly Negative,5,11,16
769370,0,1 user reviews,0,1,1
769390,0,3 user reviews,0,3,3
769410,7,Positive,18,3,21
769420,0,5 user reviews,4,1,5
769440,7,Positive,9,2,11
769520,0,1 user reviews,1,0,1
769540,0,1 user reviews,1,0,1
769550,0,5 user reviews,3,2,5
769560,0,9 user reviews,9,0,9
769580,0,1 user reviews,1,0,1
769590,0,4 user reviews,4,0,4
769620,0,8 user reviews,4,4,8
769640,0,2 user reviews,1,1,2
769670,5,Mixed,43,23,66
769680,0,2 user reviews,2,0,2
769690,5,Mixed,13,7,20
769710,0,3 user reviews,2,1,3
769720,0,3 user reviews,1,2,3
769730,5,Mixed,8,6,14
769740,0,2 user reviews,1,1,2
769750,0,4 user reviews,3,1,4
769780,0,2 user reviews,1,1,2
769840,7,Positive,19,2,21
769910,0,8 user reviews,8,0,8
769920,7,Positive,14,0,14
769930,0,1 user reviews,1,0,1
769940,0,5 user reviews,5,0,5
769950,5,Mixed,131,85,216
769970,6,Mostly Positive,119,35,154
769980,6,Mostly Positive,9,3,12
770010,0,1 user reviews,1,0,1
770020,0,6 user reviews,5,1,6
770050,0,6 user reviews,4,2,6
770070,5,Mixed,40,31,71
770100,8,Very Positive,221,52,273
770110,6,Mostly Positive,57,16,73
770120,0,1 user reviews,1,0,1
770160,0,5 user reviews,3,2,5
770190,0,1 user reviews,1,0,1
770200,5,Mixed,19,9,28
770240,5,Mixed,337,354,691
770270,0,3 user reviews,0,3,3
770320,0,4 user reviews,1,3,4
770370,0,7 user reviews,4,3,7
770380,0,1 user reviews,1,0,1
770390,6,Mostly Positive,440,139,579
770400,4,Mostly Negative,7,13,20
770410,6,Mostly Positive,18,7,25
770440,5,Mixed,10,11,21
770480,0,7 user reviews,7,0,7
770490,5,Mixed,11,7,18
770560,0,2 user reviews,0,2,2
770600,7,Positive,15,1,16
770610,0,3 user reviews,1,2,3
770620,6,Mostly Positive,11,3,14
770630,0,6 user reviews,6,0,6
770660,0,4 user reviews,4,0,4
770690,0,6 user reviews,0,6,6
770780,7,Positive,27,1,28
770810,8,Very Positive,55,10,65
770820,0,6 user reviews,6,0,6
770850,0,7 user reviews,6,1,7
770860,0,9 user reviews,8,1,9
770870,0,3 user reviews,3,0,3
770880,0,1 user reviews,1,0,1
770900,0,3 user reviews,3,0,3
770920,0,2 user reviews,1,1,2
770950,0,2 user reviews,2,0,2
770970,0,8 user reviews,8,0,8
770972,7,Positive,9,2,11
770973,6,Mostly Positive,70,19,89
770974,8,Very Positive,74,0,74
770975,7,Positive,11,1,12
770976,7,Positive,31,1,32
771010,7,Positive,34,4,38
771070,7,Positive,20,0,20
771100,0,6 user reviews,4,2,6
771130,0,8 user reviews,2,6,8
771240,7,Positive,26,3,29
771300,5,Mixed,421,274,695
771320,5,Mixed,6,6,12
771340,0,4 user reviews,3,1,4
771350,8,Very Positive,101,25,126
771370,0,3 user reviews,0,3,3
771380,0,3 user reviews,3,0,3
771400,0,5 user reviews,0,5,5
771410,7,Positive,38,4,42
771420,8,Very Positive,51,2,53
771430,0,7 user reviews,5,2,7
771470,0,9 user reviews,3,6,9
771490,0,1 user reviews,1,0,1
771500,0,6 user reviews,1,5,6
771530,7,Positive,20,4,24
771570,0,6 user reviews,2,4,6
771610,0,8 user reviews,7,1,8
771640,0,1 user reviews,1,0,1
771670,0,4 user reviews,2,2,4
771680,7,Positive,17,4,21
771690,0,7 user reviews,2,5,7
771710,6,Mostly Positive,26,9,35
771720,5,Mixed,33,21,54
771750,0,4 user reviews,1,3,4
771780,0,3 user reviews,2,1,3
771810,6,Mostly Positive,56,16,72
771820,0,2 user reviews,0,2,2
771830,0,4 user reviews,4,0,4
771840,6,Mostly Positive,22,6,28
771890,0,8 user reviews,5,3,8
771920,5,Mixed,68,42,110
771950,6,Mostly Positive,12,4,16
772060,0,5 user reviews,3,2,5
772080,0,4 user reviews,2,2,4
772090,7,Positive,10,0,10
772100,0,1 user reviews,0,1,1
772150,6,Mostly Positive,106,29,135
772180,8,Very Positive,79,8,87
772200,6,Mostly Positive,11,4,15
772220,0,5 user reviews,3,2,5
772240,0,3 user reviews,2,1,3
772270,8,Very Positive,57,6,63
772290,8,Very Positive,80,10,90
772300,0,2 user reviews,0,2,2
772320,0,5 user reviews,3,2,5
772340,0,5 user reviews,5,0,5
772360,0,5 user reviews,3,2,5
772420,0,1 user reviews,0,1,1
772430,8,Very Positive,256,63,319
772440,0,1 user reviews,0,1,1
772470,7,Positive,12,2,14
772480,6,Mostly Positive,31,8,39
772500,5,Mixed,16,16,32
772530,7,Positive,12,1,13
772540,6,Mostly Positive,163,69,232
772570,7,Positive,12,0,12
772600,0,3 user reviews,1,2,3
772610,7,Positive,46,1,47
772670,0,5 user reviews,2,3,5
772730,7,Positive,9,2,11
772750,0,8 user reviews,8,0,8
772990,5,Mixed,8,9,17
773010,0,4 user reviews,1,3,4
773090,6,Mostly Positive,42,16,58
773110,0,5 user reviews,3,2,5
773120,0,3 user reviews,0,3,3
773130,0,2 user reviews,2,0,2
773170,0,4 user reviews,3,1,4
773210,0,7 user reviews,7,0,7
773230,0,3 user reviews,2,1,3
773240,4,Mostly Negative,3,7,10
773280,0,1 user reviews,0,1,1
773320,0,1 user reviews,0,1,1
773330,5,Mixed,7,5,12
773360,0,1 user reviews,1,0,1
773390,5,Mixed,35,18,53
773420,0,5 user reviews,3,2,5
773430,7,Positive,37,3,40
773440,0,4 user reviews,1,3,4
773460,5,Mixed,14,8,22
773470,0,1 user reviews,0,1,1
773471,0,8 user reviews,4,4,8
773472,0,7 user reviews,6,1,7
773500,6,Mostly Positive,36,11,47
773510,0,8 user reviews,5,3,8
773530,0,2 user reviews,2,0,2
773540,6,Mostly Positive,18,6,24
773570,0,2 user reviews,1,1,2
773580,8,Very Positive,204,25,229
773590,5,Mixed,23,10,33
773600,0,6 user reviews,3,3,6
773610,0,1 user reviews,1,0,1
773620,0,2 user reviews,2,0,2
773640,0,5 user reviews,1,4,5
773650,0,2 user reviews,0,2,2
773670,8,Very Positive,348,11,359
773710,0,5 user reviews,5,0,5
773740,8,Very Positive,54,2,56
773763,0,1 user reviews,1,0,1
773765,0,1 user reviews,1,0,1
773770,5,Mixed,18,13,31
773790,8,Very Positive,637,85,722
773810,0,1 user reviews,1,0,1
773830,6,Mostly Positive,14,4,18
773840,8,Very Positive,55,6,61
773900,7,Positive,43,1,44
773910,0,1 user reviews,0,1,1
773920,0,3 user reviews,1,2,3
773930,7,Positive,10,2,12
773951,6,Mostly Positive,3209,848,4057
773991,5,Mixed,56,70,126
774011,4,Mostly Negative,41,124,165
774041,8,Very Positive,43,9,52
774051,0,1 user reviews,0,1,1
774071,0,6 user reviews,4,2,6
774081,0,5 user reviews,4,1,5
774091,8,Very Positive,144,14,158
774121,0,1 user reviews,1,0,1
774131,0,1 user reviews,0,1,1
774141,7,Positive,9,2,11
774151,7,Positive,12,2,14
774161,0,7 user reviews,5,2,7
774171,9,Overwhelmingly Positive,7473,160,7633
774191,7,Positive,10,2,12
774201,8,Very Positive,705,49,754
774221,7,Positive,15,1,16
774231,0,7 user reviews,5,2,7
774241,5,Mixed,466,419,885
774261,7,Positive,22,3,25
774281,5,Mixed,12,7,19
774321,5,Mixed,30,24,54
774331,0,9 user reviews,2,7,9
774351,6,Mostly Positive,343,138,481
774361,8,Very Positive,2704,311,3015
774401,6,Mostly Positive,11,3,14
774411,0,6 user reviews,4,2,6
774441,5,Mixed,17,9,26
774461,8,Very Positive,672,68,740
774501,0,1 user reviews,1,0,1
774511,5,Mixed,121,72,193
774521,0,4 user reviews,2,2,4
774531,7,Positive,22,0,22
774541,6,Mostly Positive,332,102,434
774551,5,Mixed,9,5,14
774561,7,Positive,25,5,30
774611,0,1 user reviews,1,0,1
774621,0,1 user reviews,1,0,1
774641,0,1 user reviews,1,0,1
774651,7,Positive,33,2,35
774661,0,4 user reviews,2,2,4
774711,0,8 user reviews,7,1,8
774754,0,6 user reviews,5,1,6
774756,0,1 user reviews,1,0,1
774757,0,2 user reviews,2,0,2
774758,7,Positive,15,0,15
774759,5,Mixed,10,9,19
774760,0,2 user reviews,1,1,2
774781,6,Mostly Positive,7,3,10
774811,5,Mixed,285,126,411
774841,0,2 user reviews,2,0,2
774861,8,Very Positive,2434,298,2732
774871,0,4 user reviews,4,0,4
774891,0,4 user reviews,3,1,4
774901,5,Mixed,9,6,15
774911,5,Mixed,22,18,40
774931,0,1 user reviews,1,0,1
775031,0,1 user reviews,1,0,1
775200,0,1 user reviews,1,0,1
775260,0,1 user reviews,1,0,1
775270,0,2 user reviews,2,0,2
775310,7,Positive,12,0,12
775410,7,Positive,24,0,24
775460,0,7 user reviews,5,2,7
775490,7,Positive,13,0,13
775520,6,Mostly Positive,8,3,11
775530,8,Very Positive,55,10,65
775570,0,1 user reviews,0,1,1
775580,8,Very Positive,103,6,109
775620,0,1 user reviews,0,1,1
775630,5,Mixed,34,27,61
775690,0,3 user reviews,3,0,3
775720,0,3 user reviews,2,1,3
775730,0,1 user reviews,1,0,1
775760,5,Mixed,7,5,12
775790,0,3 user reviews,1,2,3
775800,0,5 user reviews,3,2,5
775820,5,Mixed,5,6,11
775860,0,9 user reviews,5,4,9
775881,0,1 user reviews,0,1,1
775900,6,Mostly Positive,108,43,151
775910,6,Mostly Positive,9,3,12
775920,0,1 user reviews,0,1,1
775940,8,Very Positive,800,109,909
775960,7,Positive,18,4,22
776000,5,Mixed,8,8,16
776020,0,5 user reviews,4,1,5
776040,0,8 user reviews,6,2,8
776100,0,1 user reviews,0,1,1
776140,0,4 user reviews,2,2,4
776160,0,3 user reviews,3,0,3
776180,0,8 user reviews,8,0,8
776190,0,5 user reviews,1,4,5
776290,0,3 user reviews,0,3,3
776320,0,4 user reviews,2,2,4
776340,8,Very Positive,89,17,106
776360,0,2 user reviews,2,0,2
776370,5,Mixed,13,7,20
776430,0,2 user reviews,1,1,2
776480,0,7 user reviews,6,1,7
776490,8,Very Positive,353,53,406
776520,5,Mixed,6,5,11
776530,0,7 user reviews,5,2,7
776540,5,Mixed,11,9,20
776550,5,Mixed,6,6,12
776560,0,9 user reviews,8,1,9
776580,5,Mixed,12,17,29
776600,0,5 user reviews,4,1,5
776610,0,3 user reviews,1,2,3
776650,0,4 user reviews,4,0,4
776670,0,3 user reviews,1,2,3
776720,0,3 user reviews,3,0,3
776780,0,5 user reviews,5,0,5
776790,7,Positive,10,1,11
776820,0,8 user reviews,4,4,8
776830,0,7 user reviews,7,0,7
776850,0,2 user reviews,2,0,2
776890,4,Mostly Negative,13,21,34
776920,0,8 user reviews,6,2,8
776930,0,4 user reviews,1,3,4
776950,5,Mixed,7,10,17
776960,5,Mixed,52,24,76
776990,0,1 user reviews,1,0,1
777000,0,4 user reviews,1,3,4
777020,7,Positive,9,1,10
777040,0,6 user reviews,2,4,6
777050,5,Mixed,11,6,17
777080,0,1 user reviews,1,0,1
777090,0,7 user reviews,4,3,7
777110,0,3 user reviews,3,0,3
777120,0,1 user reviews,1,0,1
777130,7,Positive,13,1,14
777150,8,Very Positive,59,10,69
777160,7,Positive,21,5,26
777180,0,8 user reviews,4,4,8
777200,0,3 user reviews,3,0,3
777240,0,1 user reviews,0,1,1
777270,0,1 user reviews,1,0,1
777310,0,2 user reviews,1,1,2
777320,3,Negative,5,36,41
777340,0,6 user reviews,4,2,6
777350,0,5 user reviews,2,3,5
777380,0,1 user reviews,1,0,1
777400,4,Mostly Negative,8,17,25
777410,0,9 user reviews,9,0,9
777420,0,8 user reviews,5,3,8
777430,5,Mixed,14,10,24
777530,0,1 user reviews,0,1,1
777540,0,1 user reviews,1,0,1
777550,0,1 user reviews,1,0,1
777590,0,2 user reviews,1,1,2
777610,0,3 user reviews,3,0,3
777640,0,2 user reviews,0,2,2
777650,7,Positive,22,5,27
777660,0,1 user reviews,0,1,1
777700,0,4 user reviews,4,0,4
777760,0,3 user reviews,3,0,3
777770,5,Mixed,135,60,195
777790,8,Very Positive,67,7,74
777820,0,7 user reviews,5,2,7
777850,0,1 user reviews,0,1,1
777870,0,5 user reviews,5,0,5
777880,6,Mostly Positive,41,11,52
778000,0,1 user reviews,1,0,1
778020,0,1 user reviews,1,0,1
778050,0,4 user reviews,2,2,4
778080,0,7 user reviews,2,5,7
778110,0,8 user reviews,1,7,8
778120,0,1 user reviews,0,1,1
778140,0,1 user reviews,1,0,1
778150,6,Mostly Positive,35,11,46
778160,0,5 user reviews,4,1,5
778190,0,2 user reviews,1,1,2
778210,0,1 user reviews,1,0,1
778230,0,2 user reviews,2,0,2
778240,0,1 user reviews,0,1,1
778250,6,Mostly Positive,17,6,23
778270,0,1 user reviews,0,1,1
778330,8,Very Positive,113,3,116
778340,0,9 user reviews,6,3,9
778360,0,2 user reviews,1,1,2
778390,8,Very Positive,104,14,118
778400,8,Very Positive,47,4,51
778410,5,Mixed,13,9,22
778460,0,8 user reviews,6,2,8
778470,0,5 user reviews,5,0,5
778530,7,Positive,20,1,21
778550,0,5 user reviews,0,5,5
778570,5,Mixed,7,6,13
778580,0,1 user reviews,1,0,1
778590,0,5 user reviews,2,3,5
778610,8,Very Positive,182,11,193
778640,0,6 user reviews,6,0,6
778650,0,6 user reviews,6,0,6
778710,0,1 user reviews,0,1,1
778760,0,7 user reviews,3,4,7
778780,0,2 user reviews,2,0,2
778800,7,Positive,24,0,24
778810,0,1 user reviews,0,1,1
778830,0,1 user reviews,0,1,1
778840,7,Positive,25,1,26
778850,0,2 user reviews,1,1,2
778860,0,9 user reviews,7,2,9
778870,0,2 user reviews,1,1,2
778930,6,Mostly Positive,26,7,33
779010,0,1 user reviews,0,1,1
779060,0,4 user reviews,1,3,4
779070,0,1 user reviews,1,0,1
779090,7,Positive,39,5,44
779100,6,Mostly Positive,25,10,35
779110,0,4 user reviews,3,1,4
779120,0,4 user reviews,4,0,4
779130,5,Mixed,41,18,59
779140,0,5 user reviews,4,1,5
779150,0,2 user reviews,0,2,2
779160,0,2 user reviews,1,1,2
779240,0,9 user reviews,6,3,9
779250,7,Positive,8,2,10
779280,7,Positive,16,0,16
779290,6,Mostly Positive,247,104,351
779300,0,9 user reviews,5,4,9
779320,0,2 user reviews,1,1,2
779330,5,Mixed,79,39,118
779340,8,Very Positive,9728,1576,11304
779360,6,Mostly Positive,17,6,23
779380,5,Mixed,7,4,11
779390,0,3 user reviews,1,2,3
779400,0,4 user reviews,4,0,4
779401,0,8 user reviews,7,1,8
779430,8,Very Positive,47,9,56
779450,5,Mixed,6,5,11
779550,0,1 user reviews,1,0,1
779570,5,Mixed,8,8,16
779580,0,4 user reviews,4,0,4
779590,8,Very Positive,181,27,208
779610,4,Mostly Negative,8,22,30
779620,0,2 user reviews,2,0,2
779640,6,Mostly Positive,8,3,11
779700,0,3 user reviews,2,1,3
779730,0,5 user reviews,5,0,5
779760,0,1 user reviews,1,0,1
779790,0,2 user reviews,0,2,2
779800,0,3 user reviews,1,2,3
779810,0,4 user reviews,2,2,4
779840,0,1 user reviews,0,1,1
779880,6,Mostly Positive,157,57,214
779892,0,6 user reviews,4,2,6
779894,7,Positive,23,1,24
779896,0,3 user reviews,2,1,3
779898,0,6 user reviews,5,1,6
779920,0,2 user reviews,2,0,2
779930,4,Mostly Negative,10,26,36
779931,0,4 user reviews,3,1,4
779932,8,Very Positive,67,4,71
779933,8,Very Positive,71,5,76
779934,7,Positive,40,0,40
779935,7,Positive,46,3,49
779936,7,Positive,37,5,42
779937,7,Positive,30,5,35
779938,7,Positive,23,5,28
779939,7,Positive,31,3,34
779950,0,3 user reviews,2,1,3
779960,5,Mixed,13,7,20
780000,0,3 user reviews,3,0,3
780020,6,Mostly Positive,37,12,49
780080,0,7 user reviews,5,2,7
780100,6,Mostly Positive,29,12,41
780140,0,7 user reviews,3,4,7
780160,0,7 user reviews,2,5,7
780210,6,Mostly Positive,147,37,184
780230,0,1 user reviews,1,0,1
780260,0,1 user reviews,1,0,1
780270,0,6 user reviews,6,0,6
780280,8,Very Positive,78,7,85
780290,8,Very Positive,1536,279,1815
780320,0,7 user reviews,4,3,7
780340,7,Positive,35,3,38
780350,6,Mostly Positive,66,26,92
780390,8,Very Positive,56,6,62
780500,8,Very Positive,84,10,94
780520,0,3 user reviews,3,0,3
780550,0,5 user reviews,5,0,5
780560,7,Positive,13,2,15
780561,0,6 user reviews,5,1,6
780570,0,2 user reviews,2,0,2
780580,5,Mixed,12,14,26
780590,0,3 user reviews,1,2,3
780630,0,1 user reviews,1,0,1
780670,7,Positive,24,2,26
780690,3,Negative,0,11,11
780710,0,2 user reviews,1,1,2
780740,0,1 user reviews,1,0,1
780750,5,Mixed,24,15,39
780760,0,5 user reviews,4,1,5
780800,0,4 user reviews,3,1,4
780840,7,Positive,14,2,16
780850,0,4 user reviews,4,0,4
780990,7,Positive,16,0,16
781000,0,1 user reviews,1,0,1
781010,7,Positive,13,0,13
781050,5,Mixed,14,15,29
781100,0,9 user reviews,3,6,9
781110,7,Positive,16,0,16
781120,0,2 user reviews,2,0,2
781130,6,Mostly Positive,20,6,26
781220,0,9 user reviews,7,2,9
781230,0,1 user reviews,1,0,1
781250,0,2 user reviews,2,0,2
781260,0,3 user reviews,2,1,3
781270,0,1 user reviews,1,0,1
781280,0,5 user reviews,4,1,5
781290,0,3 user reviews,1,2,3
781320,0,9 user reviews,7,2,9
781480,6,Mostly Positive,119,41,160
781510,0,1 user reviews,1,0,1
781520,0,6 user reviews,3,3,6
781531,0,1 user reviews,1,0,1
781532,0,1 user reviews,0,1,1
781610,0,2 user reviews,1,1,2
781640,7,Positive,9,2,11
781650,0,1 user reviews,1,0,1
781660,5,Mixed,9,5,14
781670,0,3 user reviews,2,1,3
781680,0,3 user reviews,2,1,3
781760,0,8 user reviews,4,4,8
781800,0,2 user reviews,1,1,2
781810,8,Very Positive,47,8,55
781820,7,Positive,21,4,25
781840,0,1 user reviews,1,0,1
781850,0,2 user reviews,2,0,2
781860,0,2 user reviews,2,0,2
781880,0,4 user reviews,2,2,4
781890,0,7 user reviews,7,0,7
781920,0,8 user reviews,8,0,8
781930,0,3 user reviews,2,1,3
781950,0,1 user reviews,1,0,1
782020,0,3 user reviews,1,2,3
782050,0,7 user reviews,5,2,7
782070,5,Mixed,14,15,29
782090,0,4 user reviews,3,1,4
782100,0,8 user reviews,5,3,8
782110,5,Mixed,7,6,13
782120,7,Positive,11,0,11
782140,5,Mixed,63,39,102
782160,0,3 user reviews,1,2,3
782180,0,1 user reviews,1,0,1
782190,0,3 user reviews,2,1,3
782210,0,4 user reviews,4,0,4
782230,7,Positive,41,8,49
782270,7,Positive,11,1,12
782280,0,3 user reviews,3,0,3
782300,7,Positive,9,2,11
782310,0,4 user reviews,4,0,4
782330,8,Very Positive,44566,6756,51322
782380,6,Mostly Positive,7,3,10
782410,0,3 user reviews,0,3,3
782450,0,1 user reviews,0,1,1
782510,0,9 user reviews,3,6,9
782570,0,7 user reviews,3,4,7
782610,0,2 user reviews,2,0,2
782650,0,1 user reviews,1,0,1
782690,5,Mixed,26,16,42
782700,0,5 user reviews,2,3,5
783050,7,Positive,29,0,29
783060,0,2 user reviews,0,2,2
783070,0,1 user reviews,1,0,1
783120,0,5 user reviews,5,0,5
783150,7,Positive,20,2,22
783170,5,Mixed,149,101,250
783180,0,8 user reviews,7,1,8
783190,5,Mixed,52,40,92
783200,6,Mostly Positive,18,6,24
783210,6,Mostly Positive,91,28,119
783220,0,6 user reviews,1,5,6
783260,0,6 user reviews,4,2,6
783270,0,1 user reviews,0,1,1
783280,0,1 user reviews,1,0,1
783310,4,Mostly Negative,4,11,15
783330,0,4 user reviews,3,1,4
783340,6,Mostly Positive,10,3,13
783380,0,1 user reviews,0,1,1
783390,0,2 user reviews,2,0,2
783420,0,5 user reviews,2,3,5
783430,0,4 user reviews,4,0,4
783440,6,Mostly Positive,12,5,17
783450,4,Mostly Negative,8,15,23
783507,0,1 user reviews,0,1,1
783542,0,2 user reviews,0,2,2
783544,0,2 user reviews,1,1,2
783545,0,5 user reviews,4,1,5
783546,0,3 user reviews,3,0,3
783590,5,Mixed,95,43,138
783640,0,2 user reviews,1,1,2
783710,5,Mixed,13,16,29
783790,0,5 user reviews,5,0,5
783810,0,4 user reviews,3,1,4
783840,8,Very Positive,170,34,204
783850,0,2 user reviews,0,2,2
783860,5,Mixed,9,5,14
783870,0,1 user reviews,1,0,1
783890,0,2 user reviews,0,2,2
783910,0,9 user reviews,5,4,9
783940,7,Positive,29,2,31
783990,7,Positive,43,5,48
784010,0,6 user reviews,6,0,6
784040,0,1 user reviews,1,0,1
784050,6,Mostly Positive,27,7,34
784070,6,Mostly Positive,11,4,15
784100,0,5 user reviews,5,0,5
784130,0,7 user reviews,7,0,7
784150,8,Very Positive,1780,229,2009
784160,0,8 user reviews,4,4,8
784180,0,1 user reviews,1,0,1
784930,0,6 user reviews,6,0,6
784940,5,Mixed,19,9,28
784950,0,1 user reviews,1,0,1
785080,0,2 user reviews,2,0,2
785100,7,Positive,10,1,11
785110,7,Positive,36,8,44
785150,0,1 user reviews,1,0,1
785260,5,Mixed,518,252,770
785300,6,Mostly Positive,86,25,111
785430,0,2 user reviews,0,2,2
785440,0,1 user reviews,1,0,1
785480,8,Very Positive,110,18,128
785560,0,2 user reviews,2,0,2
785590,0,6 user reviews,5,1,6
785640,5,Mixed,15,10,25
785660,5,Mixed,28,23,51
785670,5,Mixed,5,7,12
785680,3,Negative,0,10,10
785690,0,1 user reviews,1,0,1
785740,5,Mixed,537,318,855
785750,0,8 user reviews,8,0,8
785760,7,Positive,16,2,18
785780,7,Positive,18,3,21
785790,8,Very Positive,131,6,137
785840,8,Very Positive,59,3,62
785850,5,Mixed,46,33,79
785860,5,Mixed,10,14,24
785870,0,2 user reviews,2,0,2
785880,8,Very Positive,87,20,107
785890,8,Very Positive,161,9,170
785900,0,1 user reviews,0,1,1
785910,5,Mixed,10,10,20
785920,0,6 user reviews,1,5,6
785930,5,Mixed,5,6,11
785940,0,2 user reviews,1,1,2
786010,0,2 user reviews,2,0,2
786040,0,1 user reviews,1,0,1
786070,0,1 user reviews,1,0,1
786090,0,2 user reviews,2,0,2
786100,0,2 user reviews,2,0,2
786120,0,1 user reviews,1,0,1
786130,0,1 user reviews,0,1,1
786170,0,2 user reviews,2,0,2
786180,0,3 user reviews,1,2,3
786280,0,2 user reviews,1,1,2
786290,5,Mixed,6,4,10
786340,0,4 user reviews,3,1,4
786350,0,1 user reviews,1,0,1
786390,7,Positive,9,2,11
786420,0,2 user reviews,1,1,2
786450,6,Mostly Positive,61,18,79
786510,6,Mostly Positive,10,4,14
786520,8,Very Positive,122,19,141
786540,0,1 user reviews,1,0,1
786560,0,6 user reviews,4,2,6
786580,5,Mixed,126,57,183
786620,0,1 user reviews,1,0,1
786630,7,Positive,26,4,30
786650,0,2 user reviews,2,0,2
786670,0,9 user reviews,6,3,9
786710,0,8 user reviews,8,0,8
786720,4,Mostly Negative,3,8,11
786740,0,5 user reviews,1,4,5
786750,0,6 user reviews,3,3,6
786770,0,3 user reviews,3,0,3
786800,0,3 user reviews,3,0,3
786820,0,9 user reviews,9,0,9
786840,0,2 user reviews,1,1,2
786890,0,2 user reviews,2,0,2
786910,5,Mixed,14,12,26
786950,0,2 user reviews,2,0,2
786980,0,5 user reviews,1,4,5
786990,7,Positive,12,1,13
787040,5,Mixed,12,13,25
787050,0,2 user reviews,2,0,2
787070,8,Very Positive,234,5,239
787110,0,1 user reviews,1,0,1
787120,0,3 user reviews,1,2,3
787140,0,2 user reviews,0,2,2
787170,0,4 user reviews,4,0,4
787200,0,7 user reviews,6,1,7
787250,5,Mixed,6,5,11
787300,4,Mostly Negative,3,7,10
787340,5,Mixed,362,179,541
787370,4,Mostly Negative,4,7,11
787400,7,Positive,35,7,42
787410,0,1 user reviews,0,1,1
787420,0,5 user reviews,1,4,5
787430,0,1 user reviews,0,1,1
787440,0,7 user reviews,4,3,7
787460,0,4 user reviews,1,3,4
787480,9,Overwhelmingly Positive,1968,33,2001
787530,0,4 user reviews,3,1,4
787550,0,7 user reviews,3,4,7
787620,0,5 user reviews,5,0,5
787650,0,4 user reviews,4,0,4
787680,0,1 user reviews,0,1,1
787681,0,1 user reviews,0,1,1
787682,0,2 user reviews,0,2,2
787690,0,5 user reviews,3,2,5
787710,7,Positive,15,3,18
787720,4,Mostly Negative,3,7,10
787730,0,2 user reviews,1,1,2
787740,5,Mixed,72,38,110
787780,5,Mixed,6,4,10
787790,0,6 user reviews,4,2,6
787840,6,Mostly Positive,18,5,23
787850,7,Positive,17,3,20
787860,8,Very Positive,9624,1021,10645
787890,0,1 user reviews,1,0,1
787910,7,Positive,14,0,14
787930,7,Positive,35,8,43
787940,0,1 user reviews,0,1,1
787960,0,3 user reviews,2,1,3
787970,7,Positive,24,5,29
787980,0,2 user reviews,1,1,2
788000,0,1 user reviews,1,0,1
788020,0,1 user reviews,0,1,1
788050,7,Positive,16,4,20
788060,0,3 user reviews,3,0,3
788100,6,Mostly Positive,748,188,936
788120,0,2 user reviews,2,0,2
788130,5,Mixed,28,13,41
788150,0,4 user reviews,4,0,4
788180,0,1 user reviews,1,0,1
788190,0,4 user reviews,1,3,4
788200,0,2 user reviews,0,2,2
788210,5,Mixed,29,19,48
788250,0,3 user reviews,2,1,3
788260,5,Mixed,1242,822,2064
788270,8,Very Positive,201,50,251
788320,0,8 user reviews,6,2,8
788330,0,4 user reviews,4,0,4
788380,7,Positive,17,4,21
788390,7,Positive,11,1,12
788400,0,1 user reviews,1,0,1
788410,7,Positive,30,5,35
788420,7,Positive,22,4,26
788430,5,Mixed,9,5,14
788480,0,9 user reviews,5,4,9
788490,4,Mostly Negative,5,8,13
788500,0,2 user reviews,0,2,2
788510,0,5 user reviews,2,3,5
788520,0,3 user reviews,2,1,3
788610,6,Mostly Positive,8,3,11
788630,6,Mostly Positive,71,30,101
788640,0,8 user reviews,6,2,8
788670,0,4 user reviews,4,0,4
788690,8,Very Positive,164,21,185
788700,6,Mostly Positive,67,23,90
788720,0,2 user reviews,2,0,2
788730,0,1 user reviews,1,0,1
788740,5,Mixed,16,15,31
788760,0,6 user reviews,5,1,6
788810,5,Mixed,6,6,12
788870,4,Mostly Negative,5,9,14
788890,0,5 user reviews,4,1,5
788900,0,3 user reviews,2,1,3
788910,5,Mixed,15,13,28
788930,7,Positive,45,2,47
788960,0,3 user reviews,1,2,3
788970,5,Mixed,18,10,28
788980,0,1 user reviews,1,0,1
789010,0,3 user reviews,2,1,3
789070,0,4 user reviews,4,0,4
789090,7,Positive,38,3,41
789160,0,5 user reviews,3,2,5
789170,0,4 user reviews,2,2,4
789200,0,5 user reviews,5,0,5
789220,0,6 user reviews,1,5,6
789240,0,7 user reviews,5,2,7
789260,6,Mostly Positive,33,10,43
789280,0,1 user reviews,1,0,1
789290,5,Mixed,6,4,10
789380,7,Positive,23,2,25
789393,0,9 user reviews,5,4,9
789460,0,8 user reviews,6,2,8
789480,7,Positive,10,0,10
789490,0,2 user reviews,1,1,2
789510,0,1 user reviews,0,1,1
789520,0,6 user reviews,2,4,6
789530,0,1 user reviews,0,1,1
789550,0,1 user reviews,1,0,1
789570,8,Very Positive,50,4,54
789640,0,2 user reviews,1,1,2
789670,0,3 user reviews,1,2,3
789680,0,2 user reviews,1,1,2
789700,0,1 user reviews,0,1,1
789730,7,Positive,35,4,39
789740,7,Positive,15,3,18
789750,6,Mostly Positive,10,3,13
789760,8,Very Positive,231,20,251
789770,0,3 user reviews,3,0,3
789800,0,1 user reviews,1,0,1
789880,0,9 user reviews,2,7,9
789890,0,4 user reviews,0,4,4
789900,0,8 user reviews,5,3,8
789910,5,Mixed,19,12,31
789930,0,4 user reviews,3,1,4
789950,8,Very Positive,54,11,65
789960,4,Mostly Negative,5,10,15
789980,0,1 user reviews,0,1,1
790020,7,Positive,16,3,19
790060,8,Very Positive,127,0,127
790080,7,Positive,12,2,14
790090,0,8 user reviews,6,2,8
790120,7,Positive,14,2,16
790130,7,Positive,8,2,10
790160,0,1 user reviews,0,1,1
790170,0,4 user reviews,4,0,4
790180,0,4 user reviews,3,1,4
790210,0,4 user reviews,2,2,4
790230,0,9 user reviews,1,8,9
790250,0,1 user reviews,1,0,1
790260,0,4 user reviews,4,0,4
790290,7,Positive,10,2,12
790300,0,6 user reviews,2,4,6
790350,7,Positive,16,3,19
790360,7,Positive,28,0,28
790390,0,1 user reviews,1,0,1
790460,0,1 user reviews,1,0,1
790520,0,2 user reviews,2,0,2
790540,4,Mostly Negative,50,109,159
790570,0,5 user reviews,2,3,5
790630,0,5 user reviews,4,1,5
790700,5,Mixed,7,9,16
790710,0,2 user reviews,2,0,2
790730,0,3 user reviews,0,3,3
790740,8,Very Positive,1155,83,1238
790750,7,Positive,8,2,10
790760,0,4 user reviews,2,2,4
790780,0,1 user reviews,1,0,1
790800,0,2 user reviews,0,2,2
790810,0,5 user reviews,1,4,5
790820,8,Very Positive,1304,153,1457
790830,0,5 user reviews,4,1,5
790831,7,Positive,15,2,17
790832,7,Positive,8,2,10
790840,0,1 user reviews,0,1,1
790850,8,Very Positive,334,39,373
790860,7,Positive,9,1,10
790900,0,1 user reviews,0,1,1
790923,0,1 user reviews,1,0,1
790924,0,2 user reviews,2,0,2
790930,0,4 user reviews,3,1,4
790950,0,4 user reviews,1,3,4
790960,0,1 user reviews,1,0,1
791000,0,1 user reviews,1,0,1
791020,7,Positive,21,1,22
791050,0,5 user reviews,2,3,5
791140,0,3 user reviews,3,0,3
791160,0,1 user reviews,1,0,1
791180,8,Very Positive,114,17,131
791240,7,Positive,24,0,24
791260,0,3 user reviews,1,2,3
791290,0,2 user reviews,2,0,2
791320,0,7 user reviews,3,4,7
791330,8,Very Positive,150,17,167
791370,0,1 user reviews,1,0,1
791380,0,1 user reviews,0,1,1
791400,6,Mostly Positive,15,4,19
791420,0,1 user reviews,1,0,1
791430,0,8 user reviews,4,4,8
791470,7,Positive,15,0,15
791490,0,1 user reviews,1,0,1
791500,7,Positive,15,3,18
791570,5,Mixed,7,9,16
791580,0,1 user reviews,0,1,1
791590,5,Mixed,5,7,12
791600,0,4 user reviews,3,1,4
791700,7,Positive,29,4,33
791740,0,1 user reviews,1,0,1
791750,8,Very Positive,49,9,58
791760,0,7 user reviews,4,3,7
791770,8,Very Positive,56,5,61
791800,0,6 user reviews,6,0,6
791870,0,2 user reviews,2,0,2
791871,0,3 user reviews,3,0,3
791872,0,2 user reviews,1,1,2
791880,0,4 user reviews,3,1,4
791890,0,5 user reviews,5,0,5
791930,0,1 user reviews,1,0,1
791950,4,Mostly Negative,4,7,11
791960,0,5 user reviews,5,0,5
791990,4,Mostly Negative,3,7,10
792000,0,3 user reviews,2,1,3
792030,0,1 user reviews,1,0,1
792040,8,Very Positive,102,9,111
792060,0,2 user reviews,1,1,2
792070,0,2 user reviews,1,1,2
792100,8,Very Positive,399,21,420
792110,0,4 user reviews,4,0,4
792160,0,5 user reviews,4,1,5
792300,8,Very Positive,431,94,525
792320,0,5 user reviews,4,1,5
792330,7,Positive,18,3,21
792331,7,Positive,32,2,34
792340,0,2 user reviews,1,1,2
792350,0,3 user reviews,2,1,3
792370,0,7 user reviews,6,1,7
792400,0,1 user reviews,0,1,1
792410,7,Positive,15,2,17
792420,7,Positive,16,2,18
792490,0,1 user reviews,1,0,1
792500,0,4 user reviews,2,2,4
792520,5,Mixed,76,35,111
792550,0,3 user reviews,1,2,3
792560,7,Positive,9,1,10
792640,0,5 user reviews,4,1,5
792650,7,Positive,26,4,30
792660,6,Mostly Positive,40,13,53
792670,0,5 user reviews,1,4,5
792680,0,6 user reviews,5,1,6
792710,8,Very Positive,395,11,406
792720,0,4 user reviews,3,1,4
792760,0,1 user reviews,1,0,1
792800,0,2 user reviews,2,0,2
792810,0,1 user reviews,1,0,1
792840,0,3 user reviews,1,2,3
792850,0,8 user reviews,7,1,8
792860,0,7 user reviews,7,0,7
792870,0,1 user reviews,1,0,1
792880,5,Mixed,13,10,23
792900,0,2 user reviews,0,2,2
792930,6,Mostly Positive,17,6,23
792940,0,8 user reviews,2,6,8
792970,6,Mostly Positive,8,3,11
792980,0,7 user reviews,3,4,7
792990,4,Mostly Negative,54,190,244
793000,0,2 user reviews,2,0,2
793010,0,5 user reviews,5,0,5
793030,0,1 user reviews,1,0,1
793190,5,Mixed,20,12,32
793200,0,3 user reviews,3,0,3
793210,0,7 user reviews,5,2,7
793220,6,Mostly Positive,10,3,13
793240,6,Mostly Positive,7,3,10
793260,0,3 user reviews,2,1,3
793270,0,1 user reviews,1,0,1
793320,0,1 user reviews,1,0,1
793350,9,Overwhelmingly Positive,614,18,632
793360,0,3 user reviews,3,0,3
793370,8,Very Positive,427,78,505
793390,0,1 user reviews,1,0,1
793450,7,Positive,32,1,33
793460,8,Very Positive,437,73,510
793510,0,8 user reviews,1,7,8
793531,0,1 user reviews,1,0,1
793532,0,1 user reviews,1,0,1
793533,0,1 user reviews,1,0,1
793534,0,1 user reviews,1,0,1
793535,0,2 user reviews,2,0,2
793536,0,4 user reviews,4,0,4
793537,0,3 user reviews,3,0,3
793544,0,1 user reviews,1,0,1
793545,0,2 user reviews,2,0,2
793546,0,5 user reviews,5,0,5
793547,0,1 user reviews,1,0,1
793548,0,1 user reviews,1,0,1
793549,0,1 user reviews,1,0,1
793551,7,Positive,14,2,16
793553,0,1 user reviews,1,0,1
793560,7,Positive,39,7,46
793600,7,Positive,12,2,14
793610,3,Negative,2,14,16
793620,6,Mostly Positive,9,3,12
793630,7,Positive,8,2,10
793640,0,5 user reviews,4,1,5
793650,0,1 user reviews,0,1,1
793670,5,Mixed,11,5,16
793680,8,Very Positive,67,7,74
793690,8,Very Positive,184,16,200
793730,0,2 user reviews,2,0,2
793740,8,Very Positive,123,7,130
793750,0,1 user reviews,0,1,1
793751,0,2 user reviews,1,1,2
793760,5,Mixed,11,10,21
793770,0,1 user reviews,0,1,1
793771,0,1 user reviews,0,1,1
793820,0,6 user reviews,6,0,6
793830,7,Positive,10,0,10
793880,0,8 user reviews,8,0,8
793940,5,Mixed,7,4,11
793970,0,9 user reviews,1,8,9
793990,0,4 user reviews,3,1,4
794030,7,Positive,12,0,12
794040,0,1 user reviews,0,1,1
794050,0,6 user reviews,1,5,6
794060,5,Mixed,9,5,14
794101,0,2 user reviews,2,0,2
794102,0,3 user reviews,1,2,3
794103,0,3 user reviews,2,1,3
794104,0,4 user reviews,1,3,4
794105,0,9 user reviews,3,6,9
794106,0,1 user reviews,0,1,1
794107,0,2 user reviews,2,0,2
794108,0,1 user reviews,1,0,1
794109,0,6 user reviews,5,1,6
794140,0,4 user reviews,3,1,4
794141,0,2 user reviews,1,1,2
794143,0,2 user reviews,2,0,2
794150,5,Mixed,25,13,38
794170,0,1 user reviews,1,0,1
794180,0,5 user reviews,1,4,5
794190,5,Mixed,10,5,15
794220,7,Positive,16,3,19
794240,7,Positive,32,6,38
794260,6,Mostly Positive,5606,1851,7457
794270,5,Mixed,88,65,153
794300,0,5 user reviews,2,3,5
794310,7,Positive,27,0,27
794320,0,1 user reviews,1,0,1
794340,0,3 user reviews,3,0,3
794341,0,4 user reviews,3,1,4
794342,0,3 user reviews,3,0,3
794343,7,Positive,43,1,44
794344,0,2 user reviews,2,0,2
794345,7,Positive,25,2,27
794350,0,1 user reviews,1,0,1
794390,7,Positive,26,1,27
794401,0,2 user reviews,1,1,2
794410,6,Mostly Positive,17,6,23
794480,0,2 user reviews,2,0,2
794490,6,Mostly Positive,192,75,267
794540,8,Very Positive,295,38,333
794550,8,Very Positive,64,5,69
794560,0,2 user reviews,2,0,2
794570,0,2 user reviews,2,0,2
794580,8,Very Positive,58,14,72
794600,0,2 user reviews,2,0,2
794640,0,3 user reviews,2,1,3
794650,4,Mostly Negative,5,13,18
794730,0,1 user reviews,1,0,1
794740,0,9 user reviews,5,4,9
794760,7,Positive,12,3,15
794780,0,2 user reviews,2,0,2
794800,8,Very Positive,494,87,581
794830,0,3 user reviews,3,0,3
794860,8,Very Positive,147,7,154
794930,0,5 user reviews,2,3,5
794940,7,Positive,30,3,33
794950,0,1 user reviews,1,0,1
794960,7,Positive,9,2,11
794990,0,4 user reviews,1,3,4
795040,7,Positive,45,2,47
795050,0,4 user reviews,4,0,4
795100,7,Positive,18,2,20
795110,7,Positive,8,2,10
795120,0,1 user reviews,1,0,1
795160,5,Mixed,12,8,20
795220,7,Positive,10,1,11
795230,0,5 user reviews,2,3,5
795310,5,Mixed,9,7,16
795320,0,2 user reviews,1,1,2
795440,0,2 user reviews,2,0,2
795490,0,5 user reviews,2,3,5
795510,7,Positive,24,2,26
795530,0,1 user reviews,0,1,1
795570,7,Positive,19,2,21
795610,0,9 user reviews,5,4,9
795621,7,Positive,17,1,18
795630,6,Mostly Positive,239,79,318
795650,0,1 user reviews,1,0,1
795680,6,Mostly Positive,18,5,23
795720,0,2 user reviews,1,1,2
795731,7,Positive,11,2,13
795732,0,5 user reviews,4,1,5
795760,6,Mostly Positive,10,3,13
795910,0,3 user reviews,2,1,3
795920,0,2 user reviews,2,0,2
795940,0,3 user reviews,3,0,3
795960,0,1 user reviews,0,1,1
795990,0,8 user reviews,5,3,8
796030,0,5 user reviews,3,2,5
796050,0,5 user reviews,4,1,5
796060,0,3 user reviews,3,0,3
796070,0,2 user reviews,2,0,2
796090,0,1 user reviews,1,0,1
796100,0,2 user reviews,2,0,2
796130,0,2 user reviews,1,1,2
796320,0,2 user reviews,1,1,2
796330,3,Negative,0,11,11
796340,0,5 user reviews,3,2,5
796350,0,4 user reviews,3,1,4
796360,5,Mixed,11,9,20
796370,0,8 user reviews,7,1,8
796380,7,Positive,15,1,16
796430,6,Mostly Positive,17,5,22
796440,0,7 user reviews,1,6,7
796460,5,Mixed,7,9,16
796480,5,Mixed,8,5,13
796490,0,3 user reviews,3,0,3
796510,5,Mixed,16,9,25
796590,5,Mixed,9,6,15
796600,5,Mixed,9,5,14
796620,5,Mixed,23,12,35
796640,0,4 user reviews,4,0,4
796650,7,Positive,8,2,10
796710,0,1 user reviews,0,1,1
796760,0,1 user reviews,1,0,1
796770,6,Mostly Positive,7,3,10
796780,7,Positive,13,1,14
796790,0,8 user reviews,6,2,8
796840,0,8 user reviews,7,1,8
796860,4,Mostly Negative,47,104,151
796900,0,9 user reviews,6,3,9
796920,0,1 user reviews,0,1,1
796940,8,Very Positive,61,3,64
796980,0,2 user reviews,1,1,2
797040,5,Mixed,7,10,17
797070,0,8 user reviews,6,2,8
797090,5,Mixed,4,6,10
797150,0,5 user reviews,4,1,5
797190,0,2 user reviews,1,1,2
797220,5,Mixed,9,5,14
797240,0,1 user reviews,1,0,1
797280,7,Positive,19,1,20
797300,0,4 user reviews,3,1,4
797310,0,1 user reviews,1,0,1
797330,0,3 user reviews,3,0,3
797340,0,3 user reviews,3,0,3
797350,0,1 user reviews,1,0,1
797400,5,Mixed,196,93,289
797410,7,Positive,22,4,26
797420,0,2 user reviews,2,0,2
797440,0,2 user reviews,2,0,2
797450,0,1 user reviews,1,0,1
797500,0,1 user reviews,1,0,1
797550,0,1 user reviews,0,1,1
797570,0,9 user reviews,9,0,9
797610,0,9 user reviews,9,0,9
797620,7,Positive,22,2,24
797630,0,1 user reviews,1,0,1
797660,0,1 user reviews,0,1,1
797670,0,1 user reviews,1,0,1
797671,0,1 user reviews,1,0,1
797710,5,Mixed,9,4,13
797760,0,1 user reviews,0,1,1
797770,0,2 user reviews,1,1,2
797780,0,1 user reviews,0,1,1
797790,0,1 user reviews,0,1,1
797800,0,1 user reviews,0,1,1
797840,0,1 user reviews,1,0,1
797860,0,1 user reviews,1,0,1
798030,0,1 user reviews,1,0,1
798080,0,1 user reviews,0,1,1
798140,0,5 user reviews,5,0,5
798170,0,7 user reviews,7,0,7
798200,0,1 user reviews,1,0,1
798210,0,4 user reviews,3,1,4
798230,0,5 user reviews,2,3,5
798240,0,3 user reviews,3,0,3
798252,0,1 user reviews,1,0,1
798290,5,Mixed,110,50,160
798320,0,1 user reviews,1,0,1
798330,0,2 user reviews,2,0,2
798380,0,3 user reviews,1,2,3
798390,8,Very Positive,104,22,126
798420,0,3 user reviews,1,2,3
798430,0,7 user reviews,7,0,7
798460,8,Very Positive,546,74,620
798490,8,Very Positive,536,103,639
798510,8,Very Positive,316,38,354
798520,0,1 user reviews,0,1,1
798560,0,9 user reviews,3,6,9
798590,5,Mixed,25,32,57
798650,7,Positive,16,0,16
798680,0,5 user reviews,4,1,5
798710,0,7 user reviews,2,5,7
798740,0,7 user reviews,7,0,7
798750,7,Positive,9,1,10
798790,0,7 user reviews,6,1,7
798810,8,Very Positive,274,33,307
798830,5,Mixed,12,18,30
798840,6,Mostly Positive,37,13,50
798850,5,Mixed,9,6,15
798860,0,1 user reviews,1,0,1
798870,0,6 user reviews,5,1,6
798880,0,3 user reviews,3,0,3
798901,0,1 user reviews,1,0,1
798902,0,1 user reviews,1,0,1
798960,0,9 user reviews,7,2,9
799070,8,Very Positive,390,15,405
799080,0,4 user reviews,2,2,4
799110,7,Positive,22,3,25
799120,0,3 user reviews,1,2,3
799180,0,2 user reviews,1,1,2
799200,8,Very Positive,154,35,189
799210,0,1 user reviews,0,1,1
799260,6,Mostly Positive,12,4,16
799270,0,2 user reviews,1,1,2
799310,0,1 user reviews,1,0,1
799330,0,2 user reviews,2,0,2
799331,0,5 user reviews,5,0,5
799350,5,Mixed,71,56,127
799420,0,4 user reviews,1,3,4
799482,0,2 user reviews,2,0,2
799500,5,Mixed,26,15,41
799510,8,Very Positive,185,6,191
799520,8,Very Positive,81,13,94
799530,5,Mixed,9,5,14
799560,0,2 user reviews,1,1,2
799590,0,4 user reviews,4,0,4
799610,0,1 user reviews,0,1,1
799620,0,6 user reviews,5,1,6
799640,8,Very Positive,232,9,241
799670,5,Mixed,6,4,10
799730,7,Positive,8,2,10
799750,5,Mixed,16,10,26
799751,4,Mostly Negative,11,20,31
799770,0,2 user reviews,2,0,2
799790,7,Positive,24,4,28
799800,7,Positive,14,3,17
799810,5,Mixed,14,7,21
799820,0,3 user reviews,2,1,3
799840,5,Mixed,10,8,18
799870,0,1 user reviews,1,0,1
799890,0,4 user reviews,1,3,4
799910,0,9 user reviews,6,3,9
800020,0,1 user reviews,1,0,1
800030,0,8 user reviews,3,5,8
800050,7,Positive,14,2,16
800120,7,Positive,29,5,34
800130,0,2 user reviews,1,1,2
800180,7,Positive,26,0,26
800190,7,Positive,15,1,16
800200,6,Mostly Positive,48,16,64
800220,0,1 user reviews,0,1,1
800221,0,2 user reviews,1,1,2
800222,0,1 user reviews,1,0,1
800230,7,Positive,15,0,15
800240,6,Mostly Positive,10,4,14
800270,6,Mostly Positive,944,338,1282
800290,0,9 user reviews,8,1,9
800310,0,5 user reviews,0,5,5
800320,0,1 user reviews,1,0,1
800330,0,1 user reviews,1,0,1
800340,5,Mixed,7,4,11
800341,0,2 user reviews,2,0,2
800342,0,7 user reviews,7,0,7
800350,0,3 user reviews,3,0,3
800370,8,Very Positive,302,20,322
800380,5,Mixed,9,7,16
800390,7,Positive,21,0,21
800450,5,Mixed,25,11,36
800490,7,Positive,9,2,11
800510,0,6 user reviews,4,2,6
800520,0,1 user reviews,1,0,1
800530,0,1 user reviews,0,1,1
800550,0,4 user reviews,3,1,4
800560,5,Mixed,6,5,11
800580,5,Mixed,6,4,10
800600,8,Very Positive,177,9,186
800620,8,Very Positive,181,5,186
800640,0,7 user reviews,6,1,7
800650,5,Mixed,8,6,14
800660,0,2 user reviews,2,0,2
800670,5,Mixed,9,5,14
800690,7,Positive,16,0,16
800700,0,8 user reviews,7,1,8
800740,0,1 user reviews,1,0,1
800820,0,9 user reviews,9,0,9
800840,0,1 user reviews,0,1,1
800860,0,3 user reviews,3,0,3
800910,0,2 user reviews,2,0,2
800930,7,Positive,12,1,13
800980,0,2 user reviews,0,2,2
801010,5,Mixed,4,6,10
801020,0,2 user reviews,0,2,2
801040,8,Very Positive,50,8,58
801060,0,2 user reviews,0,2,2
801150,0,2 user reviews,1,1,2
801180,0,4 user reviews,1,3,4
801210,5,Mixed,20,12,32
801250,0,1 user reviews,1,0,1
801260,0,5 user reviews,4,1,5
801280,0,2 user reviews,1,1,2
801290,8,Very Positive,50,3,53
801300,0,7 user reviews,7,0,7
801320,0,8 user reviews,4,4,8
801330,0,2 user reviews,1,1,2
801340,0,7 user reviews,1,6,7
801380,0,1 user reviews,1,0,1
801410,0,2 user reviews,2,0,2
801440,0,9 user reviews,4,5,9
801480,8,Very Positive,351,11,362
801490,0,3 user reviews,0,3,3
801500,0,2 user reviews,2,0,2
801560,0,2 user reviews,2,0,2
801561,0,1 user reviews,1,0,1
801580,0,1 user reviews,1,0,1
801630,9,Overwhelmingly Positive,1037,45,1082
801660,0,1 user reviews,1,0,1
801670,6,Mostly Positive,26,8,34
801690,0,3 user reviews,3,0,3
801700,0,2 user reviews,1,1,2
801710,7,Positive,22,3,25
801750,7,Positive,20,0,20
801760,0,3 user reviews,3,0,3
801770,0,4 user reviews,1,3,4
801780,0,3 user reviews,0,3,3
801830,0,1 user reviews,0,1,1
801860,8,Very Positive,284,5,289
801880,5,Mixed,41,40,81
801890,0,2 user reviews,2,0,2
801900,0,9 user reviews,7,2,9
801920,0,6 user reviews,6,0,6
801940,0,3 user reviews,1,2,3
801980,7,Positive,16,0,16
802000,0,2 user reviews,2,0,2
802040,7,Positive,35,4,39
802060,0,1 user reviews,1,0,1
802070,7,Positive,8,2,10
802080,0,9 user reviews,7,2,9
802090,0,2 user reviews,2,0,2
802120,0,2 user reviews,0,2,2
802130,0,3 user reviews,3,0,3
802180,0,1 user reviews,1,0,1
802190,0,6 user reviews,3,3,6
802210,0,7 user reviews,6,1,7
802260,0,2 user reviews,2,0,2
802280,0,1 user reviews,1,0,1
802290,0,1 user reviews,0,1,1
802300,0,2 user reviews,1,1,2
802310,0,4 user reviews,3,1,4
802320,0,3 user reviews,1,2,3
802330,4,Mostly Negative,5,8,13
802340,0,4 user reviews,3,1,4
802360,0,8 user reviews,3,5,8
802400,7,Positive,30,2,32
802450,7,Positive,37,7,44
802460,0,1 user reviews,1,0,1
802480,0,1 user reviews,0,1,1
802490,5,Mixed,8,4,12
802530,0,2 user reviews,0,2,2
802640,8,Very Positive,53,2,55
802650,0,5 user reviews,5,0,5
802660,0,2 user reviews,1,1,2
802690,5,Mixed,7,7,14
802700,5,Mixed,24,14,38
802720,0,2 user reviews,2,0,2
802730,8,Very Positive,83,14,97
802740,7,Positive,12,1,13
802780,0,5 user reviews,4,1,5
802810,5,Mixed,7,6,13
802820,0,9 user reviews,7,2,9
802850,5,Mixed,13,8,21
802860,0,6 user reviews,6,0,6
802870,8,Very Positive,189,5,194
802880,8,Very Positive,121,5,126
802890,8,Very Positive,238,13,251
802900,0,8 user reviews,5,3,8
802910,7,Positive,18,1,19
802920,0,9 user reviews,5,4,9
802930,0,6 user reviews,6,0,6
802980,0,2 user reviews,2,0,2
803040,5,Mixed,37,23,60
803080,0,4 user reviews,3,1,4
803110,0,4 user reviews,1,3,4
803130,5,Mixed,6,5,11
803150,7,Positive,32,4,36
803170,0,1 user reviews,1,0,1
803240,0,1 user reviews,0,1,1
803260,5,Mixed,8,4,12
803270,0,6 user reviews,6,0,6
803280,0,5 user reviews,5,0,5
803290,0,1 user reviews,1,0,1
803310,0,9 user reviews,1,8,9
803320,0,1 user reviews,0,1,1
803330,9,Overwhelmingly Positive,2845,137,2982
803360,0,5 user reviews,4,1,5
803380,7,Positive,16,1,17
803381,7,Positive,18,3,21
803390,0,3 user reviews,2,1,3
803510,0,8 user reviews,7,1,8
803570,0,5 user reviews,1,4,5
803580,0,1 user reviews,1,0,1
803590,0,6 user reviews,6,0,6
803600,8,Very Positive,828,113,941
803610,0,2 user reviews,2,0,2
803680,0,1 user reviews,0,1,1
803720,0,4 user reviews,2,2,4
803750,0,7 user reviews,6,1,7
803760,0,1 user reviews,1,0,1
803780,0,1 user reviews,1,0,1
803800,0,7 user reviews,3,4,7
803830,6,Mostly Positive,97,26,123
803840,0,1 user reviews,1,0,1
803850,6,Mostly Positive,17,7,24
803870,0,1 user reviews,1,0,1
803890,4,Mostly Negative,3,7,10
803920,0,6 user reviews,5,1,6
803930,0,3 user reviews,3,0,3
803980,5,Mixed,389,170,559
804000,6,Mostly Positive,8,3,11
804010,8,Very Positive,435,52,487
804030,0,3 user reviews,3,0,3
804120,0,5 user reviews,4,1,5
804130,6,Mostly Positive,9,3,12
804210,5,Mixed,9,7,16
804290,5,Mixed,6,5,11
804310,0,2 user reviews,2,0,2
804350,6,Mostly Positive,21,6,27
804400,0,5 user reviews,5,0,5
804430,0,7 user reviews,2,5,7
804440,0,6 user reviews,5,1,6
804460,0,6 user reviews,3,3,6
804490,6,Mostly Positive,446,112,558
804530,0,5 user reviews,5,0,5
804600,0,6 user reviews,4,2,6
804610,5,Mixed,7,4,11
804640,7,Positive,15,2,17
804641,7,Positive,13,1,14
804642,7,Positive,9,1,10
804643,0,7 user reviews,6,1,7
804644,7,Positive,9,1,10
804645,0,8 user reviews,7,1,8
804646,7,Positive,10,2,12
804647,0,9 user reviews,7,2,9
804680,0,1 user reviews,0,1,1
804700,8,Very Positive,92,4,96
804730,5,Mixed,31,44,75
804760,7,Positive,32,5,37
804780,0,4 user reviews,3,1,4
804830,0,9 user reviews,3,6,9
804850,5,Mixed,90,66,156
804870,6,Mostly Positive,61,24,85
804900,0,5 user reviews,3,2,5
804950,0,2 user reviews,2,0,2
805000,0,1 user reviews,1,0,1
805010,0,4 user reviews,3,1,4
805020,0,2 user reviews,2,0,2
805030,0,2 user reviews,2,0,2
805040,0,2 user reviews,2,0,2
805060,0,1 user reviews,1,0,1
805070,0,1 user reviews,1,0,1
805090,5,Mixed,5,6,11
805120,0,7 user reviews,3,4,7
805150,4,Mostly Negative,4,7,11
805320,7,Positive,19,0,19
805340,0,1 user reviews,1,0,1
805350,0,1 user reviews,1,0,1
805360,0,8 user reviews,6,2,8
805370,0,6 user reviews,6,0,6
805400,6,Mostly Positive,10,4,14
805420,0,3 user reviews,3,0,3
805440,0,6 user reviews,4,2,6
805470,0,1 user reviews,1,0,1
805500,6,Mostly Positive,9,3,12
805520,0,3 user reviews,3,0,3
805550,8,Very Positive,3045,447,3492
805590,8,Very Positive,70,0,70
805610,0,8 user reviews,6,2,8
805660,6,Mostly Positive,18,6,24
805690,0,1 user reviews,0,1,1
805710,0,6 user reviews,3,3,6
805720,0,2 user reviews,1,1,2
805760,5,Mixed,5,5,10
805790,0,1 user reviews,1,0,1
805820,8,Very Positive,97,3,100
805840,0,3 user reviews,3,0,3
805870,6,Mostly Positive,22,8,30
805880,0,7 user reviews,4,3,7
805900,0,3 user reviews,3,0,3
805920,6,Mostly Positive,21,6,27
805940,8,Very Positive,525,125,650
805970,0,3 user reviews,3,0,3
805980,0,6 user reviews,3,3,6
806010,0,2 user reviews,1,1,2
806020,0,9 user reviews,7,2,9
806100,6,Mostly Positive,9,3,12
806120,0,3 user reviews,3,0,3
806140,8,Very Positive,107,17,124
806160,3,Negative,2,9,11
806220,5,Mixed,5,5,10
806230,0,7 user reviews,3,4,7
806240,0,1 user reviews,1,0,1
806350,0,4 user reviews,4,0,4
806370,0,1 user reviews,1,0,1
806470,0,8 user reviews,4,4,8
806490,7,Positive,9,1,10
806501,0,3 user reviews,0,3,3
806510,0,1 user reviews,1,0,1
806530,6,Mostly Positive,20,8,28
806550,0,1 user reviews,1,0,1
806580,7,Positive,10,0,10
806610,0,7 user reviews,6,1,7
806630,0,5 user reviews,5,0,5
806670,0,4 user reviews,4,0,4
806720,0,6 user reviews,6,0,6
806740,0,4 user reviews,2,2,4
806770,6,Mostly Positive,22,7,29
806780,5,Mixed,70,38,108
806830,0,5 user reviews,1,4,5
806840,0,4 user reviews,4,0,4
806850,5,Mixed,8,6,14
806860,5,Mixed,56,46,102
806900,0,3 user reviews,3,0,3
806910,0,9 user reviews,6,3,9
806930,0,1 user reviews,0,1,1
806940,0,1 user reviews,0,1,1
806950,5,Mixed,166,97,263
806960,5,Mixed,8,6,14
806970,0,2 user reviews,1,1,2
806990,0,2 user reviews,2,0,2
807020,0,2 user reviews,2,0,2
807060,6,Mostly Positive,24,9,33
807070,0,2 user reviews,2,0,2
807080,4,Mostly Negative,4,8,12
807120,8,Very Positive,1278,206,1484
807140,0,2 user reviews,2,0,2
807230,5,Mixed,22,10,32
807290,0,2 user reviews,2,0,2
807320,7,Positive,10,1,11
807340,0,2 user reviews,1,1,2
807430,0,4 user reviews,2,2,4
807520,0,3 user reviews,3,0,3
807530,0,2 user reviews,2,0,2
807540,0,1 user reviews,1,0,1
807560,0,2 user reviews,2,0,2
807620,0,2 user reviews,2,0,2
807630,0,2 user reviews,2,0,2
807640,0,1 user reviews,1,0,1
807730,5,Mixed,8,4,12
807770,0,6 user reviews,5,1,6
807780,0,3 user reviews,1,2,3
807790,5,Mixed,4,6,10
807800,0,1 user reviews,1,0,1
807820,0,1 user reviews,0,1,1
807830,0,5 user reviews,0,5,5
807850,0,1 user reviews,0,1,1
807860,0,2 user reviews,0,2,2
807870,0,1 user reviews,0,1,1
807880,0,5 user reviews,2,3,5
807890,0,2 user reviews,0,2,2
807920,5,Mixed,53,40,93
807930,0,1 user reviews,0,1,1
807940,0,3 user reviews,1,2,3
807950,0,2 user reviews,0,2,2
807960,0,1 user reviews,1,0,1
808020,0,1 user reviews,0,1,1
808080,8,Very Positive,131,16,147
808090,5,Mixed,8,5,13
808100,8,Very Positive,152,23,175
808120,0,2 user reviews,1,1,2
808130,0,8 user reviews,4,4,8
808160,6,Mostly Positive,7,3,10
808190,0,1 user reviews,1,0,1
808210,0,7 user reviews,5,2,7
808220,0,9 user reviews,8,1,9
808270,0,2 user reviews,0,2,2
808290,0,2 user reviews,1,1,2
808360,0,5 user reviews,5,0,5
808400,0,1 user reviews,1,0,1
808410,0,2 user reviews,2,0,2
808420,0,4 user reviews,1,3,4
808440,0,1 user reviews,1,0,1
808450,0,6 user reviews,5,1,6
808540,0,9 user reviews,5,4,9
808580,0,3 user reviews,3,0,3
808720,0,1 user reviews,0,1,1
808750,0,1 user reviews,0,1,1
808770,5,Mixed,9,4,13
808800,7,Positive,30,5,35
808910,8,Very Positive,596,95,691
808931,0,1 user reviews,1,0,1
808932,0,4 user reviews,3,1,4
808934,0,3 user reviews,3,0,3
808935,0,1 user reviews,1,0,1
808950,0,5 user reviews,4,1,5
808980,0,7 user reviews,7,0,7
808990,0,4 user reviews,3,1,4
809000,5,Mixed,18,16,34
809020,9,Overwhelmingly Positive,477,23,500
809050,5,Mixed,12,7,19
809080,0,6 user reviews,1,5,6
809140,8,Very Positive,999,182,1181
809180,0,4 user reviews,4,0,4
809200,0,4 user reviews,3,1,4
809210,6,Mostly Positive,45,12,57
809220,0,1 user reviews,0,1,1
809230,8,Very Positive,374,83,457
809240,6,Mostly Positive,10,4,14
809260,0,1 user reviews,1,0,1
809270,0,4 user reviews,2,2,4
809280,5,Mixed,57,44,101
809310,7,Positive,29,5,34
809320,0,3 user reviews,3,0,3
809330,0,1 user reviews,1,0,1
809340,5,Mixed,8,4,12
809360,0,7 user reviews,6,1,7
809410,7,Positive,9,2,11
809440,8,Very Positive,183,28,211
809450,0,2 user reviews,0,2,2
809460,0,2 user reviews,2,0,2
809470,0,3 user reviews,1,2,3
809480,0,2 user reviews,1,1,2
809490,0,5 user reviews,2,3,5
809500,0,5 user reviews,2,3,5
809530,7,Positive,20,3,23
809540,8,Very Positive,109,13,122
809570,0,1 user reviews,1,0,1
809580,5,Mixed,19,10,29
809680,7,Positive,17,0,17
809700,0,1 user reviews,1,0,1
809720,6,Mostly Positive,148,38,186
809730,6,Mostly Positive,55,16,71
809760,0,1 user reviews,0,1,1
809770,0,8 user reviews,2,6,8
809790,0,8 user reviews,3,5,8
809800,0,1 user reviews,0,1,1
809840,5,Mixed,7,5,12
809850,7,Positive,35,5,40
809870,8,Very Positive,74,1,75
809880,8,Very Positive,144,16,160
809890,6,Mostly Positive,181,63,244
809900,0,6 user reviews,5,1,6
809950,0,8 user reviews,7,1,8
809960,8,Very Positive,47,7,54
810000,0,5 user reviews,5,0,5
810040,8,Very Positive,184,16,200
810050,0,4 user reviews,2,2,4
810060,0,6 user reviews,4,2,6
810080,0,1 user reviews,0,1,1
810250,0,3 user reviews,2,1,3
810330,0,5 user reviews,4,1,5
810340,0,6 user reviews,4,2,6
810360,0,7 user reviews,5,2,7
810380,7,Positive,10,0,10
810390,0,1 user reviews,1,0,1
810420,0,3 user reviews,3,0,3
810450,0,4 user reviews,4,0,4
810460,5,Mixed,17,14,31
810470,7,Positive,12,2,14
810500,8,Very Positive,60,8,68
810510,0,7 user reviews,4,3,7
810530,0,2 user reviews,2,0,2
810540,0,3 user reviews,1,2,3
810570,0,3 user reviews,3,0,3
810580,0,2 user reviews,2,0,2
810590,7,Positive,9,2,11
810600,0,3 user reviews,3,0,3
810610,0,1 user reviews,1,0,1
810630,0,7 user reviews,6,1,7
810640,7,Positive,26,3,29
810650,0,3 user reviews,0,3,3
810660,8,Very Positive,53,6,59
810670,6,Mostly Positive,75,29,104
810680,0,4 user reviews,3,1,4
810700,0,2 user reviews,1,1,2
810720,0,2 user reviews,2,0,2
810770,5,Mixed,9,7,16
810780,6,Mostly Positive,25,8,33
810800,0,9 user reviews,6,3,9
810850,0,2 user reviews,2,0,2
810890,0,1 user reviews,1,0,1
810900,0,1 user reviews,1,0,1
810920,0,2 user reviews,2,0,2
810970,0,2 user reviews,2,0,2
811020,0,1 user reviews,1,0,1
811040,0,3 user reviews,3,0,3
811070,0,5 user reviews,5,0,5
811080,0,4 user reviews,1,3,4
811110,7,Positive,10,0,10
811160,0,1 user reviews,1,0,1
811170,5,Mixed,16,14,30
811180,0,3 user reviews,1,2,3
811190,0,4 user reviews,1,3,4
811210,4,Mostly Negative,5,15,20
811230,0,1 user reviews,1,0,1
811240,6,Mostly Positive,7,3,10
811250,0,6 user reviews,1,5,6
811270,7,Positive,39,4,43
811290,7,Positive,10,1,11
811300,0,3 user reviews,2,1,3
811310,5,Mixed,15,19,34
811320,8,Very Positive,169,20,189
811440,0,2 user reviews,2,0,2
811450,0,2 user reviews,1,1,2
811460,7,Positive,10,0,10
811480,0,8 user reviews,5,3,8
811620,7,Positive,8,2,10
811630,0,5 user reviews,2,3,5
811640,0,3 user reviews,3,0,3
811690,0,1 user reviews,0,1,1
811710,0,2 user reviews,2,0,2
811720,6,Mostly Positive,28,11,39
811840,7,Positive,43,1,44
811870,8,Very Positive,129,7,136
811880,5,Mixed,82,92,174
811890,8,Very Positive,118,13,131
811900,0,7 user reviews,4,3,7
811910,7,Positive,12,0,12
811950,0,4 user reviews,2,2,4
812020,6,Mostly Positive,31,13,44
812040,6,Mostly Positive,527,173,700
812070,6,Mostly Positive,17,5,22
812090,0,6 user reviews,6,0,6
812100,0,4 user reviews,3,1,4
812110,5,Mixed,11,5,16
812130,0,3 user reviews,3,0,3
812140,8,Very Positive,24074,2674,26748
812160,6,Mostly Positive,19,6,25
812170,0,2 user reviews,2,0,2
812180,0,4 user reviews,1,3,4
812190,0,7 user reviews,7,0,7
812360,0,3 user reviews,3,0,3
812390,0,1 user reviews,0,1,1
812410,8,Very Positive,74,9,83
812450,0,3 user reviews,2,1,3
812470,0,1 user reviews,0,1,1
812550,6,Mostly Positive,67,23,90
812560,5,Mixed,15,10,25
812580,0,8 user reviews,7,1,8
812650,7,Positive,14,2,16
812690,0,2 user reviews,2,0,2
812750,0,1 user reviews,1,0,1
812760,0,1 user reviews,0,1,1
812770,0,9 user reviews,6,3,9
812800,7,Positive,15,0,15
812810,0,6 user reviews,6,0,6
812840,8,Very Positive,99,3,102
812850,0,5 user reviews,2,3,5
812860,7,Positive,9,2,11
812870,6,Mostly Positive,83,32,115
812890,0,1 user reviews,1,0,1
812900,0,1 user reviews,1,0,1
812930,0,8 user reviews,6,2,8
812940,0,1 user reviews,0,1,1
812960,6,Mostly Positive,19,6,25
812970,0,1 user reviews,1,0,1
812980,0,9 user reviews,7,2,9
813020,0,1 user reviews,1,0,1
813030,6,Mostly Positive,7,3,10
813110,0,1 user reviews,0,1,1
813150,0,7 user reviews,4,3,7
813170,5,Mixed,7,10,17
813240,0,3 user reviews,1,2,3
813250,0,7 user reviews,7,0,7
813260,0,1 user reviews,1,0,1
813280,0,1 user reviews,0,1,1
813300,0,1 user reviews,1,0,1
813370,0,1 user reviews,1,0,1
813390,0,7 user reviews,6,1,7
813410,7,Positive,17,0,17
813420,7,Positive,36,1,37
813450,7,Positive,16,3,19
813460,7,Positive,16,2,18
813480,7,Positive,11,1,12
813530,7,Positive,22,2,24
813540,8,Very Positive,78,15,93
813590,7,Positive,11,1,12
813630,9,Overwhelmingly Positive,2817,90,2907
813650,7,Positive,35,3,38
813700,8,Very Positive,100,13,113
813730,0,2 user reviews,2,0,2
813780,8,Very Positive,19367,1393,20760
813820,7,Positive,12,1,13
813840,0,3 user reviews,2,1,3
813900,0,2 user reviews,0,2,2
813930,5,Mixed,10,5,15
813970,0,4 user reviews,3,1,4
814020,0,2 user reviews,2,0,2
814030,6,Mostly Positive,11,3,14
814060,0,1 user reviews,1,0,1
814070,0,1 user reviews,1,0,1
814100,0,1 user reviews,1,0,1
814110,5,Mixed,14,8,22
814140,0,4 user reviews,2,2,4
814190,0,2 user reviews,1,1,2
814200,5,Mixed,10,6,16
814210,0,2 user reviews,1,1,2
814230,0,1 user reviews,1,0,1
814251,0,4 user reviews,1,3,4
814300,7,Positive,24,1,25
814310,0,7 user reviews,3,4,7
814320,0,1 user reviews,1,0,1
814340,4,Mostly Negative,4,8,12
814360,7,Positive,40,1,41
814370,9,Overwhelmingly Positive,876,34,910
814380,8,Very Positive,22355,1937,24292
814400,5,Mixed,26,13,39
814420,7,Positive,10,0,10
814480,6,Mostly Positive,84,32,116
814510,0,1 user reviews,1,0,1
814530,8,Very Positive,76,12,88
814540,8,Very Positive,1202,95,1297
814560,0,1 user reviews,1,0,1
814570,0,2 user reviews,1,1,2
814580,0,1 user reviews,1,0,1
814590,0,4 user reviews,2,2,4
814600,0,4 user reviews,3,1,4
814610,6,Mostly Positive,9,3,12
814620,0,1 user reviews,1,0,1
814650,0,6 user reviews,5,1,6
814660,0,6 user reviews,3,3,6
814710,0,1 user reviews,1,0,1
814740,8,Very Positive,142,35,177
814770,0,9 user reviews,3,6,9
814870,0,3 user reviews,2,1,3
814890,0,2 user reviews,2,0,2
814900,5,Mixed,11,11,22
814990,0,1 user reviews,1,0,1
815000,7,Positive,30,7,37
815010,0,9 user reviews,8,1,9
815070,0,3 user reviews,2,1,3
815080,5,Mixed,11,11,22
815150,8,Very Positive,55,1,56
815160,0,2 user reviews,2,0,2
815170,0,3 user reviews,0,3,3
815210,5,Mixed,20,14,34
815240,0,3 user reviews,0,3,3
815250,0,5 user reviews,1,4,5
815280,0,5 user reviews,4,1,5
815290,5,Mixed,13,7,20
815300,0,1 user reviews,1,0,1
815320,5,Mixed,11,5,16
815351,0,2 user reviews,1,1,2
815352,0,1 user reviews,1,0,1
815354,0,3 user reviews,3,0,3
815355,0,1 user reviews,1,0,1
815356,0,2 user reviews,2,0,2
815360,0,8 user reviews,3,5,8
815370,8,Very Positive,6174,1010,7184
815380,7,Positive,36,6,42
815390,0,8 user reviews,5,3,8
815410,0,7 user reviews,7,0,7
815420,0,2 user reviews,1,1,2
815440,6,Mostly Positive,17,7,24
815450,8,Very Positive,119,7,126
815460,5,Mixed,406,351,757
815480,0,1 user reviews,0,1,1
815540,0,3 user reviews,3,0,3
815550,0,3 user reviews,3,0,3
815560,0,3 user reviews,2,1,3
815570,0,4 user reviews,3,1,4
815580,7,Positive,14,1,15
815620,0,1 user reviews,0,1,1
815630,0,2 user reviews,2,0,2
815660,7,Positive,9,1,10
815690,0,1 user reviews,1,0,1
815730,0,3 user reviews,2,1,3
815760,0,6 user reviews,6,0,6
815770,0,7 user reviews,6,1,7
815780,8,Very Positive,959,138,1097
815810,0,1 user reviews,1,0,1
815830,7,Positive,10,1,11
815840,0,2 user reviews,1,1,2
815860,0,7 user reviews,4,3,7
815950,7,Positive,9,1,10
815980,0,1 user reviews,1,0,1
816020,5,Mixed,1896,894,2790
816030,0,1 user reviews,1,0,1
816060,5,Mixed,5,5,10
816090,6,Mostly Positive,2150,754,2904
816160,0,8 user reviews,5,3,8
816180,0,5 user reviews,4,1,5
816190,0,7 user reviews,6,1,7
816210,0,4 user reviews,3,1,4
816220,0,7 user reviews,3,4,7
816240,0,1 user reviews,1,0,1
816250,7,Positive,13,1,14
816270,8,Very Positive,52,10,62
816280,0,2 user reviews,2,0,2
816330,5,Mixed,13,9,22
816340,8,Very Positive,680,42,722
816360,0,2 user reviews,1,1,2
816380,0,2 user reviews,1,1,2
816390,0,1 user reviews,1,0,1
816410,0,1 user reviews,1,0,1
816430,6,Mostly Positive,23,8,31
816490,8,Very Positive,138,15,153
816500,7,Positive,9,1,10
816550,0,2 user reviews,1,1,2
816560,5,Mixed,8,5,13
816570,0,1 user reviews,0,1,1
816580,0,6 user reviews,3,3,6
816610,0,2 user reviews,2,0,2
816630,0,4 user reviews,3,1,4
816650,0,7 user reviews,5,2,7
816660,0,2 user reviews,1,1,2
816670,0,6 user reviews,2,4,6
816710,5,Mixed,12,6,18
816720,7,Positive,8,2,10
816760,0,8 user reviews,7,1,8
816770,0,9 user reviews,8,1,9
816780,7,Positive,10,1,11
816790,0,4 user reviews,3,1,4
816830,7,Positive,11,1,12
816840,0,1 user reviews,0,1,1
816870,0,8 user reviews,7,1,8
816890,0,1 user reviews,1,0,1
816920,0,5 user reviews,1,4,5
816981,0,1 user reviews,1,0,1
816982,0,1 user reviews,1,0,1
816990,0,6 user reviews,3,3,6
817110,0,1 user reviews,0,1,1
817130,5,Mixed,613,311,924
817150,0,2 user reviews,1,1,2
817160,0,1 user reviews,1,0,1
817190,7,Positive,27,4,31
817200,0,7 user reviews,2,5,7
817220,0,5 user reviews,5,0,5
817230,8,Very Positive,71,8,79
817250,0,1 user reviews,1,0,1
817260,0,1 user reviews,1,0,1
817270,0,1 user reviews,0,1,1
817310,0,5 user reviews,0,5,5
817390,0,6 user reviews,3,3,6
817460,5,Mixed,9,5,14
817470,0,2 user reviews,2,0,2
817490,7,Positive,12,0,12
817510,5,Mixed,149,85,234
817530,0,5 user reviews,4,1,5
817540,8,Very Positive,437,74,511
817550,6,Mostly Positive,126,37,163
817560,0,3 user reviews,2,1,3
817610,0,2 user reviews,1,1,2
817630,0,2 user reviews,1,1,2
817640,0,4 user reviews,1,3,4
817660,0,7 user reviews,5,2,7
817680,4,Mostly Negative,5,11,16
817710,0,2 user reviews,2,0,2
817720,5,Mixed,36,22,58
817760,0,2 user reviews,2,0,2
817770,5,Mixed,11,6,17
817820,0,3 user reviews,3,0,3
817840,8,Very Positive,459,41,500
817860,7,Positive,40,0,40
817920,0,1 user reviews,1,0,1
817950,0,3 user reviews,1,2,3
817980,0,3 user reviews,3,0,3
818030,0,4 user reviews,1,3,4
818050,7,Positive,19,0,19
818060,6,Mostly Positive,8,3,11
818140,0,5 user reviews,5,0,5
818150,7,Positive,13,2,15
818210,8,Very Positive,118,25,143
818220,0,7 user reviews,3,4,7
818270,0,2 user reviews,1,1,2
818320,8,Very Positive,147,30,177
818330,0,9 user reviews,3,6,9
818350,0,2 user reviews,2,0,2
818360,0,1 user reviews,1,0,1
818390,0,7 user reviews,3,4,7
818400,0,8 user reviews,5,3,8
818410,7,Positive,13,0,13
818430,0,2 user reviews,0,2,2
818440,5,Mixed,6,6,12
818480,0,7 user reviews,3,4,7
818500,7,Positive,34,2,36
818530,7,Positive,12,3,15
818570,7,Positive,19,4,23
818590,0,4 user reviews,1,3,4
818610,7,Positive,34,5,39
818620,0,2 user reviews,1,1,2
818640,0,1 user reviews,0,1,1
818650,0,5 user reviews,3,2,5
818670,0,3 user reviews,3,0,3
818700,0,7 user reviews,6,1,7
818730,6,Mostly Positive,16,5,21
818760,7,Positive,11,0,11
818780,0,1 user reviews,0,1,1
818790,0,1 user reviews,1,0,1
818800,7,Positive,8,2,10
818830,0,2 user reviews,2,0,2
818860,0,6 user reviews,6,0,6
818940,7,Positive,22,4,26
818950,0,7 user reviews,6,1,7
818960,7,Positive,13,2,15
818981,0,1 user reviews,1,0,1
818990,0,2 user reviews,1,1,2
819020,6,Mostly Positive,172,48,220
819030,8,Very Positive,228,19,247
819040,7,Positive,19,0,19
819060,7,Positive,10,2,12
819070,0,3 user reviews,1,2,3
819080,0,2 user reviews,0,2,2
819100,0,1 user reviews,1,0,1
819160,0,2 user reviews,2,0,2
819180,0,1 user reviews,0,1,1
819210,0,2 user reviews,0,2,2
819220,0,3 user reviews,3,0,3
819230,8,Very Positive,67,6,73
819240,0,1 user reviews,1,0,1
819280,0,5 user reviews,4,1,5
819320,0,5 user reviews,4,1,5
819330,0,7 user reviews,7,0,7
819400,5,Mixed,7,7,14
819410,0,9 user reviews,2,7,9
819480,7,Positive,22,2,24
819500,5,Mixed,267,200,467
819510,7,Positive,10,1,11
819520,0,7 user reviews,6,1,7
819560,0,6 user reviews,5,1,6
819630,8,Very Positive,77,2,79
819640,0,2 user reviews,1,1,2
819650,5,Mixed,14,16,30
819660,0,1 user reviews,0,1,1
819670,0,2 user reviews,2,0,2
819740,5,Mixed,10,5,15
819780,7,Positive,10,0,10
819800,0,1 user reviews,1,0,1
819860,0,1 user reviews,1,0,1
819870,0,1 user reviews,1,0,1
819880,0,1 user reviews,1,0,1
819940,0,1 user reviews,1,0,1
819960,0,8 user reviews,7,1,8
819980,0,3 user reviews,3,0,3
820020,5,Mixed,46,29,75
820030,5,Mixed,37,16,53
820040,5,Mixed,10,6,16
820070,0,4 user reviews,4,0,4
820140,8,Very Positive,55,1,56
820150,0,1 user reviews,1,0,1
820151,0,2 user reviews,2,0,2
820170,0,2 user reviews,2,0,2
820180,0,2 user reviews,2,0,2
820200,0,4 user reviews,2,2,4
820201,0,4 user reviews,4,0,4
820203,6,Mostly Positive,57,24,81
820210,0,8 user reviews,8,0,8
820231,0,1 user reviews,1,0,1
820232,0,1 user reviews,1,0,1
820240,5,Mixed,19,10,29
820250,0,8 user reviews,4,4,8
820300,0,3 user reviews,3,0,3
820310,0,4 user reviews,1,3,4
820320,5,Mixed,9,6,15
820380,5,Mixed,11,8,19
820442,7,Positive,32,4,36
820460,0,7 user reviews,5,2,7
820480,0,2 user reviews,2,0,2
820510,7,Positive,12,1,13
820530,0,1 user reviews,1,0,1
820580,5,Mixed,7,8,15
820600,7,Positive,17,0,17
820610,6,Mostly Positive,27,7,34
820620,6,Mostly Positive,16,6,22
820630,8,Very Positive,209,24,233
820640,0,5 user reviews,5,0,5
820660,0,2 user reviews,0,2,2
820680,0,2 user reviews,1,1,2
820700,0,7 user reviews,5,2,7
820710,0,3 user reviews,2,1,3
820730,8,Very Positive,77,4,81
820760,0,5 user reviews,3,2,5
820780,0,1 user reviews,1,0,1
820830,0,2 user reviews,2,0,2
820840,0,7 user reviews,5,2,7
820870,0,1 user reviews,1,0,1
820880,5,Mixed,11,7,18
820890,0,1 user reviews,1,0,1
820900,8,Very Positive,73,7,80
820910,7,Positive,39,3,42
820930,7,Positive,28,7,35
820940,0,1 user reviews,0,1,1
820950,0,9 user reviews,9,0,9
821030,0,2 user reviews,1,1,2
821060,5,Mixed,58,33,91
821090,8,Very Positive,50,7,57
821100,0,4 user reviews,2,2,4
821120,0,8 user reviews,6,2,8
821170,0,5 user reviews,5,0,5
821180,0,3 user reviews,0,3,3
821190,0,4 user reviews,3,1,4
821230,7,Positive,17,1,18
821250,6,Mostly Positive,442,119,561
821260,0,1 user reviews,0,1,1
821320,8,Very Positive,70,6,76
821330,0,4 user reviews,2,2,4
821350,5,Mixed,79,57,136
821360,0,1 user reviews,1,0,1
821370,5,Mixed,8,5,13
821390,5,Mixed,11,6,17
821400,0,2 user reviews,2,0,2
821410,0,5 user reviews,4,1,5
821450,0,2 user reviews,2,0,2
821480,0,1 user reviews,0,1,1
821490,0,5 user reviews,5,0,5
821500,0,9 user reviews,8,1,9
821520,0,6 user reviews,4,2,6
821550,0,6 user reviews,4,2,6
821560,0,6 user reviews,6,0,6
821570,0,5 user reviews,5,0,5
821630,0,1 user reviews,1,0,1
821640,7,Positive,30,2,32
821710,0,1 user reviews,1,0,1
821720,0,6 user reviews,5,1,6
821780,7,Positive,11,2,13
821790,6,Mostly Positive,26,7,33
821850,0,6 user reviews,1,5,6
821860,0,3 user reviews,1,2,3
821890,8,Very Positive,296,37,333
821910,0,5 user reviews,0,5,5
821940,6,Mostly Positive,58,23,81
821950,7,Positive,40,7,47
822010,0,5 user reviews,5,0,5
822040,7,Positive,24,2,26
822070,0,1 user reviews,0,1,1
822080,0,9 user reviews,9,0,9
822091,0,1 user reviews,0,1,1
822094,7,Positive,16,1,17
822130,0,6 user reviews,1,5,6
822140,0,2 user reviews,1,1,2
822150,0,3 user reviews,1,2,3
822180,0,1 user reviews,1,0,1
822190,7,Positive,21,0,21
822250,0,2 user reviews,1,1,2
822330,0,2 user reviews,1,1,2
822340,0,1 user reviews,1,0,1
822380,0,4 user reviews,0,4,4
822400,0,1 user reviews,1,0,1
822440,0,3 user reviews,1,2,3
822450,0,5 user reviews,5,0,5
822460,0,5 user reviews,4,1,5
822510,0,7 user reviews,4,3,7
822530,0,5 user reviews,2,3,5
822540,6,Mostly Positive,37,13,50
822550,0,1 user reviews,1,0,1
822640,0,2 user reviews,2,0,2
822650,5,Mixed,15,16,31
822660,0,6 user reviews,6,0,6
822680,0,6 user reviews,1,5,6
822700,0,2 user reviews,2,0,2
822720,0,4 user reviews,3,1,4
822740,0,1 user reviews,1,0,1
822750,0,4 user reviews,3,1,4
822760,8,Very Positive,101,2,103
822770,0,6 user reviews,1,5,6
822800,6,Mostly Positive,23,6,29
822810,0,2 user reviews,2,0,2
822830,8,Very Positive,69,0,69
822840,0,1 user reviews,0,1,1
822860,0,1 user reviews,1,0,1
822900,0,8 user reviews,6,2,8
822910,0,2 user reviews,1,1,2
822920,7,Positive,9,2,11
822930,8,Very Positive,417,14,431
822940,0,9 user reviews,9,0,9
822970,0,1 user reviews,1,0,1
822990,6,Mostly Positive,147,40,187
823020,0,3 user reviews,3,0,3
823030,0,1 user reviews,1,0,1
823040,6,Mostly Positive,10,3,13
823100,0,5 user reviews,3,2,5
823130,8,Very Positive,3258,729,3987
823180,0,1 user reviews,1,0,1
823260,0,2 user reviews,2,0,2
823261,0,2 user reviews,2,0,2
823262,0,2 user reviews,2,0,2
823280,5,Mixed,6,5,11
823310,0,2 user reviews,1,1,2
823330,0,2 user reviews,1,1,2
823340,0,4 user reviews,3,1,4
823360,0,4 user reviews,3,1,4
823370,0,3 user reviews,3,0,3
823500,8,Very Positive,11295,1247,12542
823510,0,1 user reviews,1,0,1
823530,7,Positive,29,5,34
823580,7,Positive,16,1,17
823610,6,Mostly Positive,54,19,73
823640,4,Mostly Negative,9,14,23
823650,0,2 user reviews,2,0,2
823670,0,1 user reviews,0,1,1
823690,0,2 user reviews,2,0,2
823700,5,Mixed,11,6,17
823710,0,8 user reviews,3,5,8
823730,0,7 user reviews,5,2,7
823740,0,4 user reviews,1,3,4
823770,0,6 user reviews,1,5,6
823800,0,4 user reviews,2,2,4
823810,0,6 user reviews,4,2,6
823840,7,Positive,40,1,41
823910,8,Very Positive,509,42,551
823920,0,5 user reviews,3,2,5
823930,0,1 user reviews,1,0,1
823940,6,Mostly Positive,197,76,273
823950,5,Mixed,394,244,638
823990,5,Mixed,43,37,80
824070,5,Mixed,211,175,386
824190,8,Very Positive,133,24,157
824200,7,Positive,8,2,10
824230,0,3 user reviews,2,1,3
824250,0,3 user reviews,3,0,3
824270,8,Very Positive,7450,678,8128
824280,6,Mostly Positive,86,36,122
824380,0,2 user reviews,2,0,2
824381,0,2 user reviews,2,0,2
824382,0,2 user reviews,2,0,2
824450,5,Mixed,10,5,15
824460,7,Positive,15,0,15
824470,0,6 user reviews,4,2,6
824570,7,Positive,13,0,13
824580,0,4 user reviews,2,2,4
824610,7,Positive,18,3,21
824620,0,9 user reviews,9,0,9
824640,0,2 user reviews,2,0,2
824720,8,Very Positive,424,59,483
824760,7,Positive,12,2,14
824770,0,1 user reviews,1,0,1
824830,8,Very Positive,72,11,83
824850,7,Positive,44,4,48
825000,0,3 user reviews,1,2,3
825020,0,1 user reviews,1,0,1
825040,0,1 user reviews,1,0,1
825090,0,2 user reviews,1,1,2
825240,0,7 user reviews,7,0,7
825300,8,Very Positive,59,10,69
825310,5,Mixed,132,183,315
825320,0,4 user reviews,4,0,4
825350,0,2 user reviews,1,1,2
825370,6,Mostly Positive,8,3,11
825400,0,5 user reviews,5,0,5
825470,0,2 user reviews,2,0,2
825480,0,3 user reviews,3,0,3
825490,0,1 user reviews,0,1,1
825500,5,Mixed,5,5,10
825550,5,Mixed,20,15,35
825570,8,Very Positive,134,9,143
825590,0,1 user reviews,1,0,1
825620,0,2 user reviews,1,1,2
825630,9,Overwhelmingly Positive,641,29,670
825650,0,1 user reviews,0,1,1
825660,0,1 user reviews,0,1,1
825680,0,2 user reviews,0,2,2
825700,0,1 user reviews,1,0,1
825710,0,2 user reviews,1,1,2
825730,8,Very Positive,66,7,73
825930,6,Mostly Positive,10,4,14
825970,0,7 user reviews,4,3,7
826000,5,Mixed,13,11,24
826010,6,Mostly Positive,14,6,20
826030,0,5 user reviews,3,2,5
826040,0,4 user reviews,3,1,4
826050,0,1 user reviews,1,0,1
826080,0,6 user reviews,5,1,6
826083,0,3 user reviews,2,1,3
826084,0,1 user reviews,0,1,1
826085,0,1 user reviews,1,0,1
826086,0,1 user reviews,1,0,1
826087,0,2 user reviews,1,1,2
826160,5,Mixed,11,9,20
826170,0,2 user reviews,2,0,2
826180,6,Mostly Positive,13,4,17
826290,0,6 user reviews,6,0,6
826370,0,1 user reviews,1,0,1
826380,0,1 user reviews,1,0,1
826390,0,1 user reviews,1,0,1
826420,0,8 user reviews,7,1,8
826430,0,2 user reviews,1,1,2
826440,0,1 user reviews,1,0,1
826450,0,5 user reviews,4,1,5
826460,5,Mixed,5,7,12
826490,0,1 user reviews,1,0,1
826491,0,1 user reviews,1,0,1
826492,0,1 user reviews,1,0,1
826493,0,1 user reviews,1,0,1
826494,0,1 user reviews,1,0,1
826495,0,1 user reviews,1,0,1
826496,0,1 user reviews,1,0,1
826497,0,1 user reviews,1,0,1
826498,0,1 user reviews,1,0,1
826499,0,1 user reviews,1,0,1
826500,0,1 user reviews,1,0,1
826501,0,1 user reviews,1,0,1
826502,0,1 user reviews,1,0,1
826503,0,1 user reviews,1,0,1
826504,0,1 user reviews,1,0,1
826505,0,1 user reviews,1,0,1
826506,0,1 user reviews,1,0,1
826507,0,1 user reviews,1,0,1
826540,8,Very Positive,67,7,74
826580,0,1 user reviews,0,1,1
826600,6,Mostly Positive,85,28,113
826620,0,1 user reviews,1,0,1
826630,6,Mostly Positive,920,347,1267
826650,7,Positive,13,1,14
826660,0,7 user reviews,5,2,7
826740,7,Positive,30,6,36
826930,0,4 user reviews,3,1,4
826940,8,Very Positive,101,24,125
827000,7,Positive,17,4,21
827050,6,Mostly Positive,26,7,33
827100,0,8 user reviews,4,4,8
827110,0,6 user reviews,2,4,6
827120,0,7 user reviews,3,4,7
827130,0,4 user reviews,2,2,4
827240,4,Mostly Negative,120,188,308
827250,7,Positive,8,2,10
827270,0,1 user reviews,1,0,1
827280,0,3 user reviews,2,1,3
827290,8,Very Positive,158,4,162
827380,6,Mostly Positive,10,3,13
827410,0,1 user reviews,0,1,1
827420,5,Mixed,9,6,15
827450,0,2 user reviews,1,1,2
827460,0,7 user reviews,7,0,7
827520,0,3 user reviews,3,0,3
827530,0,7 user reviews,4,3,7
827590,0,3 user reviews,3,0,3
827610,0,7 user reviews,6,1,7
827640,6,Mostly Positive,32,10,42
827700,0,1 user reviews,0,1,1
827710,0,1 user reviews,1,0,1
827720,0,2 user reviews,0,2,2
827730,0,7 user reviews,7,0,7
827770,0,2 user reviews,0,2,2
827780,0,1 user reviews,0,1,1
827810,0,1 user reviews,1,0,1
827820,0,1 user reviews,1,0,1
827830,0,9 user reviews,8,1,9
827880,0,4 user reviews,4,0,4
827920,0,5 user reviews,4,1,5
827940,7,Positive,9,2,11
827950,0,1 user reviews,1,0,1
828070,8,Very Positive,147,17,164
828090,0,2 user reviews,1,1,2
828150,6,Mostly Positive,21,7,28
828160,0,4 user reviews,2,2,4
828240,7,Positive,15,1,16
828270,0,2 user reviews,2,0,2
828300,0,1 user reviews,1,0,1
828320,7,Positive,8,2,10
828350,0,3 user reviews,3,0,3
828360,0,3 user reviews,2,1,3
828410,0,4 user reviews,2,2,4
828420,0,1 user reviews,1,0,1
828440,0,3 user reviews,1,2,3
828460,0,2 user reviews,1,1,2
828480,0,4 user reviews,2,2,4
828490,0,1 user reviews,1,0,1
828500,0,2 user reviews,2,0,2
828520,0,2 user reviews,2,0,2
828540,0,1 user reviews,1,0,1
828550,5,Mixed,8,4,12
828580,7,Positive,42,5,47
828590,7,Positive,11,1,12
828600,0,1 user reviews,1,0,1
828626,0,1 user reviews,1,0,1
828640,7,Positive,19,4,23
828660,6,Mostly Positive,26,7,33
828680,7,Positive,11,0,11
828730,0,2 user reviews,0,2,2
828740,6,Mostly Positive,107,27,134
828770,0,3 user reviews,2,1,3
828790,5,Mixed,200,206,406
828800,0,9 user reviews,6,3,9
828830,0,1 user reviews,0,1,1
828860,0,3 user reviews,3,0,3
828890,5,Mixed,13,8,21
828900,6,Mostly Positive,123,43,166
828910,5,Mixed,6,5,11
828950,6,Mostly Positive,12,4,16
828960,5,Mixed,14,14,28
828970,0,2 user reviews,0,2,2
829040,0,3 user reviews,3,0,3
829080,0,8 user reviews,7,1,8
829110,8,Very Positive,484,66,550
829200,0,2 user reviews,2,0,2
829210,7,Positive,9,2,11
829250,4,Mostly Negative,7,11,18
829260,7,Positive,15,2,17
829300,0,5 user reviews,4,1,5
829350,0,1 user reviews,1,0,1
829370,0,5 user reviews,4,1,5
829390,5,Mixed,7,4,11
829410,0,4 user reviews,2,2,4
829490,0,2 user reviews,2,0,2
829540,7,Positive,14,0,14
829550,0,1 user reviews,1,0,1
829560,7,Positive,15,2,17
829590,6,Mostly Positive,401,119,520
829610,0,2 user reviews,1,1,2
829630,0,3 user reviews,1,2,3
829660,8,Very Positive,202,15,217
829720,0,4 user reviews,3,1,4
829731,0,1 user reviews,0,1,1
829736,0,1 user reviews,1,0,1
829750,0,1 user reviews,1,0,1
829760,0,1 user reviews,1,0,1
829780,5,Mixed,6,6,12
829940,0,9 user reviews,9,0,9
829960,7,Positive,13,3,16
830360,0,2 user reviews,1,1,2
830370,8,Very Positive,147,18,165
830380,0,4 user reviews,1,3,4
830400,6,Mostly Positive,12,5,17
830410,0,1 user reviews,1,0,1
830430,0,2 user reviews,0,2,2
830450,8,Very Positive,68,7,75
830451,6,Mostly Positive,19,7,26
830460,7,Positive,28,5,33
830461,6,Mostly Positive,31,10,41
830490,5,Mixed,5,5,10
830500,0,1 user reviews,1,0,1
830520,0,3 user reviews,3,0,3
830530,0,4 user reviews,3,1,4
830590,6,Mostly Positive,29,10,39
830620,0,3 user reviews,3,0,3
830630,5,Mixed,9,6,15
830640,6,Mostly Positive,27,8,35
830710,7,Positive,18,4,22
830720,0,3 user reviews,3,0,3
830750,0,3 user reviews,2,1,3
830810,0,1 user reviews,0,1,1
830820,8,Very Positive,367,17,384
830850,0,6 user reviews,6,0,6
830890,0,1 user reviews,0,1,1
830980,5,Mixed,88,41,129
831060,0,4 user reviews,1,3,4
831070,7,Positive,20,2,22
831090,7,Positive,18,2,20
831120,7,Positive,23,2,25
831150,0,2 user reviews,2,0,2
831160,0,5 user reviews,5,0,5
831161,0,4 user reviews,2,2,4
831162,0,5 user reviews,5,0,5
831250,0,4 user reviews,2,2,4
831260,0,3 user reviews,3,0,3
831312,0,3 user reviews,3,0,3
831350,0,1 user reviews,0,1,1
831460,0,1 user reviews,1,0,1
831470,5,Mixed,8,5,13
831510,0,2 user reviews,1,1,2
831520,0,8 user reviews,2,6,8
831530,7,Positive,28,3,31
831540,0,1 user reviews,0,1,1
831560,8,Very Positive,404,72,476
831570,7,Positive,21,0,21
831650,0,1 user reviews,1,0,1
831660,0,2 user reviews,2,0,2
831670,0,8 user reviews,5,3,8
831680,0,3 user reviews,3,0,3
831690,0,2 user reviews,0,2,2
831700,0,6 user reviews,1,5,6
831710,5,Mixed,5,6,11
831720,7,Positive,19,1,20
831770,5,Mixed,7,4,11
831790,0,2 user reviews,1,1,2
831840,8,Very Positive,54,5,59
831910,0,1 user reviews,0,1,1
831950,0,6 user reviews,3,3,6
831980,8,Very Positive,745,55,800
832130,0,6 user reviews,5,1,6
832140,0,5 user reviews,5,0,5
832320,7,Positive,15,1,16
832350,5,Mixed,13,16,29
832380,0,2 user reviews,2,0,2
832420,0,6 user reviews,3,3,6
832470,0,5 user reviews,4,1,5
832540,5,Mixed,16,7,23
832550,0,5 user reviews,1,4,5
832580,0,1 user reviews,1,0,1
832610,0,9 user reviews,1,8,9
832650,0,7 user reviews,5,2,7
832680,5,Mixed,8,4,12
832690,0,6 user reviews,4,2,6
832700,5,Mixed,35,28,63
832710,7,Positive,18,3,21
832720,5,Mixed,26,12,38
832770,7,Positive,29,0,29
832990,0,6 user reviews,1,5,6
833010,0,4 user reviews,2,2,4
833030,7,Positive,23,4,27
833040,8,Very Positive,780,51,831
833070,0,5 user reviews,5,0,5
833090,8,Very Positive,266,34,300
833110,0,4 user reviews,2,2,4
833140,7,Positive,40,3,43
833150,0,4 user reviews,2,2,4
833170,6,Mostly Positive,23,6,29
833180,0,7 user reviews,3,4,7
833260,7,Positive,8,2,10
833270,7,Positive,11,1,12
833360,8,Very Positive,236,22,258
833370,5,Mixed,5,5,10
833380,0,2 user reviews,0,2,2
833390,0,2 user reviews,2,0,2
833400,5,Mixed,13,8,21
833470,0,5 user reviews,4,1,5
833500,7,Positive,12,0,12
833510,0,1 user reviews,0,1,1
833540,0,2 user reviews,1,1,2
833590,0,6 user reviews,6,0,6
833640,0,4 user reviews,2,2,4
833650,0,1 user reviews,0,1,1
833660,0,9 user reviews,5,4,9
833670,0,2 user reviews,1,1,2
833690,0,6 user reviews,6,0,6
833700,0,7 user reviews,1,6,7
833750,0,1 user reviews,1,0,1
833770,0,3 user reviews,2,1,3
833800,0,1 user reviews,0,1,1
833810,0,4 user reviews,1,3,4
833820,0,7 user reviews,1,6,7
833860,0,2 user reviews,1,1,2
833890,0,6 user reviews,5,1,6
833910,7,Positive,33,5,38
833920,0,5 user reviews,1,4,5
833940,0,1 user reviews,1,0,1
833950,7,Positive,19,0,19
833980,0,4 user reviews,4,0,4
833990,7,Positive,23,1,24
834000,0,3 user reviews,1,2,3
834020,0,2 user reviews,0,2,2
834060,5,Mixed,34,37,71
834070,5,Mixed,6,7,13
834100,0,1 user reviews,0,1,1
834130,0,2 user reviews,1,1,2
834131,0,2 user reviews,1,1,2
834140,5,Mixed,6,6,12
834150,6,Mostly Positive,10,4,14
834170,0,7 user reviews,4,3,7
834180,0,6 user reviews,5,1,6
834210,0,1 user reviews,0,1,1
834280,5,Mixed,168,75,243
834340,6,Mostly Positive,12,4,16
834350,0,1 user reviews,1,0,1
834360,0,2 user reviews,1,1,2
834380,0,5 user reviews,5,0,5
834390,5,Mixed,12,6,18
834400,0,1 user reviews,0,1,1
834401,0,8 user reviews,8,0,8
834403,5,Mixed,9,5,14
834404,0,4 user reviews,4,0,4
834405,0,2 user reviews,2,0,2
834406,0,2 user reviews,0,2,2
834407,5,Mixed,9,13,22
834408,0,3 user reviews,2,1,3
834420,0,2 user reviews,1,1,2
834450,5,Mixed,5,6,11
834530,8,Very Positive,2454,138,2592
834580,7,Positive,16,0,16
834740,8,Very Positive,704,103,807
834750,5,Mixed,16,12,28
834760,8,Very Positive,49,1,50
834800,5,Mixed,26,19,45
834910,5,Mixed,7748,8876,16624
834930,0,3 user reviews,3,0,3
835040,0,7 user reviews,5,2,7
835110,7,Positive,34,3,37
835130,0,4 user reviews,2,2,4
835430,8,Very Positive,235,36,271
835440,0,1 user reviews,0,1,1
835450,0,1 user reviews,0,1,1
835460,0,1 user reviews,1,0,1
835471,0,1 user reviews,0,1,1
835490,0,2 user reviews,1,1,2
835510,0,9 user reviews,4,5,9
835520,0,2 user reviews,2,0,2
835560,0,3 user reviews,3,0,3
835570,6,Mostly Positive,145,47,192
835600,0,3 user reviews,2,1,3
835630,0,7 user reviews,7,0,7
835640,0,4 user reviews,4,0,4
835650,8,Very Positive,60,7,67
835660,0,1 user reviews,0,1,1
835670,8,Very Positive,466,108,574
835680,0,2 user reviews,2,0,2
835690,0,3 user reviews,3,0,3
835700,7,Positive,21,4,25
835710,0,8 user reviews,8,0,8
835730,0,3 user reviews,3,0,3
835740,0,1 user reviews,1,0,1
835860,0,1 user reviews,0,1,1
835910,5,Mixed,6,5,11
835950,7,Positive,38,1,39
836080,6,Mostly Positive,10,4,14
836110,5,Mixed,11,9,20
836230,0,1 user reviews,1,0,1
836260,0,4 user reviews,4,0,4
836280,0,3 user reviews,2,1,3
836290,0,4 user reviews,3,1,4
836300,0,4 user reviews,4,0,4
836330,0,8 user reviews,3,5,8
836350,7,Positive,15,2,17
836400,0,1 user reviews,1,0,1
836420,0,1 user reviews,0,1,1
836450,8,Very Positive,213,14,227
836460,0,6 user reviews,5,1,6
836470,0,3 user reviews,1,2,3
836480,0,8 user reviews,5,3,8
836490,7,Positive,37,5,42
836540,0,6 user reviews,6,0,6
836550,0,4 user reviews,4,0,4
836560,0,6 user reviews,5,1,6
836580,4,Mostly Negative,5,11,16
836590,0,7 user reviews,4,3,7
836600,0,6 user reviews,5,1,6
836610,0,7 user reviews,7,0,7
836620,6,Mostly Positive,13342,5203,18545
836630,0,4 user reviews,3,1,4
836631,0,1 user reviews,1,0,1
836632,0,1 user reviews,0,1,1
836640,7,Positive,9,1,10
836690,0,2 user reviews,2,0,2
836700,0,5 user reviews,3,2,5
836750,5,Mixed,12,14,26
836760,6,Mostly Positive,39,13,52
836770,5,Mixed,12,8,20
836781,7,Positive,12,2,14
836783,0,3 user reviews,3,0,3
836785,0,7 user reviews,6,1,7
836790,0,7 user reviews,5,2,7
836810,5,Mixed,19,24,43
836811,5,Mixed,20,10,30
836812,7,Positive,12,1,13
836820,0,6 user reviews,5,1,6
836850,5,Mixed,44,24,68
836860,3,Negative,2,13,15
836870,4,Mostly Negative,3,12,15
836900,7,Positive,11,1,12
837040,7,Positive,9,1,10
837090,0,9 user reviews,8,1,9
837100,5,Mixed,4,6,10
837110,3,Negative,1,10,11
837180,0,3 user reviews,3,0,3
837190,7,Positive,26,3,29
837200,6,Mostly Positive,14,6,20
837210,0,2 user reviews,1,1,2
837220,0,1 user reviews,0,1,1
837240,0,9 user reviews,5,4,9
837260,0,2 user reviews,1,1,2
837270,0,4 user reviews,3,1,4
837290,0,1 user reviews,0,1,1
837330,0,5 user reviews,5,0,5
837360,0,2 user reviews,1,1,2
837400,8,Very Positive,82,13,95
837430,5,Mixed,8,7,15
837440,6,Mostly Positive,13,4,17
837450,0,2 user reviews,2,0,2
837460,7,Positive,33,1,34
837470,8,Very Positive,766,52,818
837510,6,Mostly Positive,59,24,83
837530,0,8 user reviews,1,7,8
837550,0,2 user reviews,1,1,2
837590,5,Mixed,38,22,60
837600,5,Mixed,15,13,28
837610,8,Very Positive,198,30,228
837780,0,9 user reviews,4,5,9
837790,5,Mixed,9,5,14
837800,6,Mostly Positive,13,4,17
837810,0,3 user reviews,0,3,3
837830,7,Positive,13,0,13
837840,0,7 user reviews,7,0,7
837841,0,7 user reviews,5,2,7
837850,7,Positive,13,1,14
837860,0,4 user reviews,4,0,4
837861,0,5 user reviews,5,0,5
837900,0,7 user reviews,3,4,7
837930,6,Mostly Positive,9,3,12
837940,7,Positive,17,1,18
838010,7,Positive,26,4,30
838020,0,1 user reviews,1,0,1
838050,5,Mixed,8,11,19
838100,0,6 user reviews,6,0,6
838110,7,Positive,39,6,45
838120,0,6 user reviews,6,0,6
838130,0,2 user reviews,2,0,2
838140,0,2 user reviews,2,0,2
838150,0,1 user reviews,0,1,1
838160,0,6 user reviews,3,3,6
838180,7,Positive,35,7,42
838270,5,Mixed,7,10,17
838310,8,Very Positive,1202,86,1288
838330,5,Mixed,85,48,133
838340,0,8 user reviews,6,2,8
838350,8,Very Positive,339,38,377
838380,5,Mixed,590,271,861
838390,7,Positive,28,3,31
838410,7,Positive,18,2,20
838420,0,6 user reviews,1,5,6
838490,0,8 user reviews,8,0,8
838530,0,2 user reviews,2,0,2
838540,0,1 user reviews,1,0,1
838620,8,Very Positive,67,5,72
838630,5,Mixed,197,147,344
838700,0,3 user reviews,3,0,3
838710,0,2 user reviews,2,0,2
838720,0,3 user reviews,3,0,3
838730,0,3 user reviews,2,1,3
838750,0,1 user reviews,1,0,1
838760,0,2 user reviews,1,1,2
838770,8,Very Positive,141,20,161
838790,0,3 user reviews,2,1,3
838810,0,1 user reviews,1,0,1
838820,4,Mostly Negative,7,11,18
838840,0,3 user reviews,0,3,3
838860,7,Positive,29,0,29
838940,0,5 user reviews,3,2,5
838980,0,1 user reviews,0,1,1
838990,8,Very Positive,67,13,80
839010,0,2 user reviews,2,0,2
839020,7,Positive,19,4,23
839030,0,1 user reviews,0,1,1
839040,0,4 user reviews,2,2,4
839080,0,2 user reviews,1,1,2
839090,0,6 user reviews,5,1,6
839110,0,1 user reviews,1,0,1
839130,0,3 user reviews,3,0,3
839170,0,8 user reviews,5,3,8
839210,0,3 user reviews,3,0,3
839230,0,4 user reviews,4,0,4
839250,0,1 user reviews,0,1,1
839260,5,Mixed,6,7,13
839280,7,Positive,20,3,23
839300,5,Mixed,6,5,11
839310,8,Very Positive,380,69,449
839340,7,Positive,14,1,15
839420,7,Positive,15,1,16
839450,8,Very Positive,66,10,76
839520,0,1 user reviews,0,1,1
839530,0,1 user reviews,1,0,1
839540,0,2 user reviews,0,2,2
839570,6,Mostly Positive,11,3,14
839580,0,3 user reviews,1,2,3
839590,0,2 user reviews,0,2,2
839620,0,1 user reviews,0,1,1
839630,5,Mixed,90,70,160
839670,6,Mostly Positive,10,4,14
839730,0,4 user reviews,2,2,4
839820,0,2 user reviews,1,1,2
839850,7,Positive,20,0,20
839870,8,Very Positive,163,9,172
839890,0,7 user reviews,3,4,7
839920,0,2 user reviews,1,1,2
839930,5,Mixed,82,39,121
839940,7,Positive,16,0,16
839960,7,Positive,18,1,19
839970,0,1 user reviews,1,0,1
840010,8,Very Positive,804,96,900
840020,0,3 user reviews,3,0,3
840060,0,2 user reviews,2,0,2
840090,0,2 user reviews,0,2,2
840100,6,Mostly Positive,8,3,11
840130,0,3 user reviews,1,2,3
840140,4,Mostly Negative,56,97,153
840160,0,7 user reviews,7,0,7
840170,0,2 user reviews,0,2,2
840190,0,8 user reviews,4,4,8
840230,0,3 user reviews,3,0,3
840240,0,9 user reviews,7,2,9
840260,0,4 user reviews,3,1,4
840300,0,3 user reviews,3,0,3
840310,7,Positive,13,1,14
840370,6,Mostly Positive,84,29,113
840380,0,3 user reviews,3,0,3
840430,7,Positive,22,2,24
840440,0,4 user reviews,4,0,4
840500,0,3 user reviews,1,2,3
840580,0,2 user reviews,1,1,2
840590,0,6 user reviews,3,3,6
840610,7,Positive,25,0,25
840690,0,6 user reviews,6,0,6
840700,0,8 user reviews,8,0,8
840710,0,7 user reviews,4,3,7
840720,6,Mostly Positive,198,50,248
840730,0,5 user reviews,4,1,5
840750,0,8 user reviews,7,1,8
840760,0,5 user reviews,5,0,5
840770,0,3 user reviews,3,0,3
840790,0,2 user reviews,1,1,2
840800,5,Mixed,1615,747,2362
840860,0,1 user reviews,1,0,1
840910,0,2 user reviews,2,0,2
840920,0,1 user reviews,0,1,1
840930,8,Very Positive,72,9,81
840940,0,1 user reviews,1,0,1
840980,0,5 user reviews,4,1,5
840991,0,2 user reviews,2,0,2
841010,0,2 user reviews,2,0,2
841030,0,6 user reviews,3,3,6
841120,7,Positive,9,2,11
841140,4,Mostly Negative,4,7,11
841150,5,Mixed,8,5,13
841160,0,3 user reviews,2,1,3
841162,0,4 user reviews,2,2,4
841168,0,1 user reviews,1,0,1
841200,0,6 user reviews,5,1,6
841210,0,2 user reviews,2,0,2
841250,6,Mostly Positive,22,8,30
841260,0,6 user reviews,2,4,6
841280,0,1 user reviews,1,0,1
841320,6,Mostly Positive,8,3,11
841340,0,9 user reviews,6,3,9
841350,5,Mixed,14,11,25
841370,5,Mixed,1675,1640,3315
841440,0,2 user reviews,2,0,2
841460,8,Very Positive,110,13,123
841470,0,1 user reviews,1,0,1
841570,0,2 user reviews,1,1,2
841580,0,1 user reviews,1,0,1
841600,8,Very Positive,54,2,56
841660,7,Positive,39,7,46
841680,0,3 user reviews,3,0,3
841690,0,1 user reviews,1,0,1
841740,0,1 user reviews,1,0,1
841770,9,Overwhelmingly Positive,685,34,719
841790,0,1 user reviews,0,1,1
841800,0,3 user reviews,1,2,3
841820,0,3 user reviews,3,0,3
841821,0,1 user reviews,0,1,1
841840,0,9 user reviews,5,4,9
841910,0,1 user reviews,1,0,1
841950,0,7 user reviews,5,2,7
841980,6,Mostly Positive,9,3,12
841990,0,1 user reviews,0,1,1
842000,0,2 user reviews,2,0,2
842020,0,6 user reviews,5,1,6
842030,0,2 user reviews,1,1,2
842050,0,6 user reviews,2,4,6
842070,0,1 user reviews,0,1,1
842100,6,Mostly Positive,397,158,555
842120,0,8 user reviews,7,1,8
842140,7,Positive,26,4,30
842170,7,Positive,30,3,33
842250,4,Mostly Negative,16,27,43
842290,0,1 user reviews,0,1,1
842310,0,2 user reviews,1,1,2
842330,0,4 user reviews,3,1,4
842350,0,1 user reviews,0,1,1
842361,0,1 user reviews,1,0,1
842363,0,1 user reviews,1,0,1
842364,0,2 user reviews,2,0,2
842366,0,1 user reviews,0,1,1
842369,0,1 user reviews,0,1,1
842382,0,2 user reviews,2,0,2
842430,0,5 user reviews,5,0,5
842470,0,3 user reviews,3,0,3
842490,0,2 user reviews,1,1,2
842510,0,1 user reviews,0,1,1
842530,0,6 user reviews,2,4,6
842560,0,5 user reviews,0,5,5
842590,0,1 user reviews,1,0,1
842640,0,8 user reviews,3,5,8
842680,7,Positive,31,6,37
842750,7,Positive,23,2,25
842760,0,3 user reviews,3,0,3
842770,0,7 user reviews,7,0,7
842780,8,Very Positive,64,16,80
842810,8,Very Positive,55,7,62
842820,0,1 user reviews,1,0,1
842850,7,Positive,9,2,11
842870,0,2 user reviews,1,1,2
842910,8,Very Positive,308,27,335
842950,0,4 user reviews,4,0,4
842951,0,2 user reviews,2,0,2
842960,0,2 user reviews,2,0,2
842990,0,4 user reviews,4,0,4
843000,0,1 user reviews,0,1,1
843010,6,Mostly Positive,13,5,18
843040,5,Mixed,4,6,10
843080,0,1 user reviews,1,0,1
843120,0,6 user reviews,6,0,6
843160,0,7 user reviews,4,3,7
843170,7,Positive,27,0,27
843190,0,3 user reviews,0,3,3
843250,5,Mixed,8,4,12
843260,9,Overwhelmingly Positive,509,19,528
843270,0,7 user reviews,4,3,7
843340,0,3 user reviews,2,1,3
843360,5,Mixed,4,6,10
843370,0,8 user reviews,8,0,8
843380,9,Overwhelmingly Positive,2521,72,2593
843400,0,1 user reviews,0,1,1
843420,0,3 user reviews,1,2,3
843430,8,Very Positive,57,4,61
843440,8,Very Positive,64,4,68
843510,7,Positive,14,3,17
843520,6,Mostly Positive,11,4,15
843580,0,1 user reviews,0,1,1
843590,0,3 user reviews,3,0,3
843640,7,Positive,16,3,19
843650,0,1 user reviews,1,0,1
843710,0,1 user reviews,1,0,1
843720,0,7 user reviews,5,2,7
843730,5,Mixed,16,7,23
843740,6,Mostly Positive,8,3,11
843760,0,2 user reviews,1,1,2
843780,0,4 user reviews,3,1,4
843820,0,5 user reviews,2,3,5
843840,7,Positive,9,1,10
843860,4,Mostly Negative,10,19,29
843870,5,Mixed,9,6,15
843890,5,Mixed,18,9,27
843900,8,Very Positive,43,9,52
843930,0,3 user reviews,3,0,3
843980,0,1 user reviews,1,0,1
843990,0,3 user reviews,3,0,3
844040,8,Very Positive,67,14,81
844050,7,Positive,26,6,32
844090,0,6 user reviews,0,6,6
844130,7,Positive,21,0,21
844140,6,Mostly Positive,7,3,10
844160,0,8 user reviews,8,0,8
844180,6,Mostly Positive,22,6,28
844190,7,Positive,21,1,22
844210,5,Mixed,23,10,33
844240,0,1 user reviews,1,0,1
844250,0,4 user reviews,0,4,4
844290,0,5 user reviews,1,4,5
844300,0,8 user reviews,3,5,8
844310,0,9 user reviews,3,6,9
844330,5,Mixed,73,40,113
844340,0,3 user reviews,2,1,3
844350,0,1 user reviews,1,0,1
844380,7,Positive,11,1,12
844420,8,Very Positive,70,14,84
844440,0,7 user reviews,7,0,7
844500,6,Mostly Positive,21,9,30
844510,0,4 user reviews,4,0,4
844550,0,4 user reviews,4,0,4
844590,9,Overwhelmingly Positive,1245,27,1272
844610,0,5 user reviews,1,4,5
844620,0,1 user reviews,1,0,1
844660,8,Very Positive,277,4,281
844750,5,Mixed,15,16,31
844760,0,4 user reviews,3,1,4
844810,6,Mostly Positive,159,58,217
844820,0,2 user reviews,1,1,2
844830,0,5 user reviews,3,2,5
844850,5,Mixed,78,51,129
844860,7,Positive,26,3,29
844870,5,Mixed,22,17,39
844890,6,Mostly Positive,135,49,184
844900,0,5 user reviews,3,2,5
844920,0,6 user reviews,3,3,6
844930,8,Very Positive,395,26,421
844950,0,1 user reviews,1,0,1
844970,0,6 user reviews,6,0,6
844990,0,1 user reviews,0,1,1
845000,7,Positive,16,3,19
845010,6,Mostly Positive,29,8,37
845020,0,6 user reviews,4,2,6
845030,7,Positive,16,0,16
845040,7,Positive,18,4,22
845050,7,Positive,32,3,35
845120,0,1 user reviews,1,0,1
845140,0,3 user reviews,1,2,3
845142,0,1 user reviews,1,0,1
845143,0,3 user reviews,2,1,3
845144,0,1 user reviews,1,0,1
845147,0,1 user reviews,0,1,1
845148,0,1 user reviews,1,0,1
845149,0,5 user reviews,5,0,5
845150,0,9 user reviews,8,1,9
845190,0,1 user reviews,1,0,1
845200,0,3 user reviews,0,3,3
845210,0,2 user reviews,1,1,2
845270,7,Positive,45,1,46
845290,0,2 user reviews,1,1,2
845330,0,9 user reviews,3,6,9
845340,0,1 user reviews,1,0,1
845350,0,3 user reviews,2,1,3
845380,5,Mixed,13,9,22
845390,0,5 user reviews,3,2,5
845400,0,9 user reviews,2,7,9
845410,0,3 user reviews,1,2,3
845420,0,9 user reviews,5,4,9
845440,0,7 user reviews,0,7,7
845460,0,3 user reviews,1,2,3
845480,0,3 user reviews,0,3,3
845490,5,Mixed,22,12,34
845500,0,3 user reviews,0,3,3
845520,0,9 user reviews,3,6,9
845530,4,Mostly Negative,9,17,26
845570,0,2 user reviews,0,2,2
845580,0,1 user reviews,1,0,1
845582,0,1 user reviews,1,0,1
845590,0,9 user reviews,4,5,9
845600,0,4 user reviews,3,1,4
845630,0,8 user reviews,5,3,8
845640,8,Very Positive,246,29,275
845650,0,1 user reviews,1,0,1
845690,7,Positive,30,1,31
845700,0,3 user reviews,3,0,3
845730,0,8 user reviews,7,1,8
845750,0,7 user reviews,7,0,7
845800,0,1 user reviews,1,0,1
845820,0,3 user reviews,2,1,3
845840,7,Positive,13,0,13
845860,0,5 user reviews,4,1,5
845870,0,1 user reviews,0,1,1
845880,8,Very Positive,108,7,115
845900,6,Mostly Positive,25,8,33
845910,0,3 user reviews,3,0,3
845940,0,8 user reviews,7,1,8
845960,0,9 user reviews,4,5,9
845970,0,7 user reviews,4,3,7
845980,0,2 user reviews,1,1,2
846010,5,Mixed,8,4,12
846020,0,5 user reviews,3,2,5
846030,8,Very Positive,68,9,77
846050,5,Mixed,11,15,26
846080,7,Positive,16,2,18
846100,0,1 user reviews,1,0,1
846110,8,Very Positive,199,19,218
846120,0,1 user reviews,0,1,1
846130,0,4 user reviews,4,0,4
846200,5,Mixed,15,14,29
846220,0,1 user reviews,1,0,1
846250,0,4 user reviews,2,2,4
846310,0,3 user reviews,2,1,3
846330,0,1 user reviews,1,0,1
846360,0,1 user reviews,1,0,1
846400,0,1 user reviews,0,1,1
846421,0,1 user reviews,0,1,1
846470,8,Very Positive,846,59,905
846490,0,2 user reviews,2,0,2
846530,0,1 user reviews,0,1,1
846580,0,1 user reviews,1,0,1
846590,0,1 user reviews,1,0,1
846650,0,1 user reviews,1,0,1
846670,0,3 user reviews,3,0,3
846690,7,Positive,16,4,20
846700,7,Positive,12,1,13
846710,7,Positive,15,3,18
846720,0,3 user reviews,3,0,3
846730,5,Mixed,34,17,51
846790,6,Mostly Positive,7,3,10
846800,8,Very Positive,191,25,216
846820,5,Mixed,11,6,17
846830,5,Mixed,8,6,14
846850,0,5 user reviews,1,4,5
846870,8,Very Positive,210,20,230
846880,8,Very Positive,155,9,164
847010,0,1 user reviews,1,0,1
847210,7,Positive,10,0,10
847230,0,4 user reviews,3,1,4
847240,0,9 user reviews,7,2,9
847260,4,Mostly Negative,4,7,11
847290,7,Positive,20,2,22
847300,0,5 user reviews,2,3,5
847310,0,6 user reviews,2,4,6
847360,8,Very Positive,143,20,163
847370,8,Very Positive,2320,225,2545
847390,0,5 user reviews,4,1,5
847420,0,1 user reviews,0,1,1
847421,0,1 user reviews,0,1,1
847422,0,1 user reviews,1,0,1
847423,0,6 user reviews,5,1,6
847450,0,3 user reviews,2,1,3
847480,0,1 user reviews,1,0,1
847530,7,Positive,18,0,18
847540,0,2 user reviews,2,0,2
847560,0,6 user reviews,6,0,6
847570,0,3 user reviews,1,2,3
847580,0,6 user reviews,1,5,6
847590,0,7 user reviews,6,1,7
847660,0,7 user reviews,2,5,7
847750,0,3 user reviews,3,0,3
847810,0,1 user reviews,1,0,1
847820,0,1 user reviews,1,0,1
847860,0,2 user reviews,1,1,2
847900,0,2 user reviews,2,0,2
847940,0,2 user reviews,2,0,2
847950,7,Positive,23,5,28
848010,6,Mostly Positive,60,22,82
848020,7,Positive,43,2,45
848030,8,Very Positive,88,20,108
848060,7,Positive,23,2,25
848100,0,1 user reviews,1,0,1
848110,0,4 user reviews,2,2,4
848150,0,2 user reviews,0,2,2
848200,7,Positive,10,2,12
848230,0,3 user reviews,2,1,3
848260,0,7 user reviews,3,4,7
848270,0,3 user reviews,2,1,3
848280,7,Positive,23,0,23
848300,5,Mixed,10,8,18
848310,5,Mixed,26,28,54
848320,0,8 user reviews,8,0,8
848330,0,5 user reviews,5,0,5
848350,8,Very Positive,1342,116,1458
848410,6,Mostly Positive,11,3,14
848430,0,2 user reviews,1,1,2
848450,8,Very Positive,11774,835,12609
848470,0,1 user reviews,1,0,1
848520,7,Positive,13,1,14
848530,7,Positive,9,2,11
848550,0,4 user reviews,3,1,4
848610,0,2 user reviews,0,2,2
848630,0,3 user reviews,2,1,3
848660,0,3 user reviews,3,0,3
848710,0,5 user reviews,3,2,5
848730,0,4 user reviews,0,4,4
848740,0,1 user reviews,1,0,1
848760,0,1 user reviews,1,0,1
848770,0,8 user reviews,8,0,8
848790,0,7 user reviews,4,3,7
848810,0,1 user reviews,1,0,1
848890,0,5 user reviews,1,4,5
848920,0,1 user reviews,1,0,1
848930,7,Positive,23,1,24
848960,0,2 user reviews,1,1,2
848970,0,2 user reviews,2,0,2
848990,0,4 user reviews,4,0,4
848991,0,1 user reviews,1,0,1
849000,0,5 user reviews,5,0,5
849070,0,5 user reviews,1,4,5
849140,0,1 user reviews,1,0,1
849210,7,Positive,12,1,13
849230,0,3 user reviews,2,1,3
849260,5,Mixed,14,11,25
849261,5,Mixed,15,11,26
849262,5,Mixed,34,28,62
849270,0,5 user reviews,5,0,5
849300,5,Mixed,11,8,19
849301,5,Mixed,5,6,11
849302,5,Mixed,7,6,13
849303,5,Mixed,10,6,16
849304,4,Mostly Negative,5,8,13
849305,4,Mostly Negative,5,9,14
849306,4,Mostly Negative,19,29,48
849307,5,Mixed,24,13,37
849308,5,Mixed,19,9,28
849309,6,Mostly Positive,19,5,24
849310,5,Mixed,9,8,17
849311,6,Mostly Positive,15,5,20
849390,0,2 user reviews,1,1,2
849420,0,2 user reviews,0,2,2
849520,0,7 user reviews,6,1,7
849540,0,3 user reviews,3,0,3
849560,6,Mostly Positive,8,3,11
849600,0,6 user reviews,3,3,6
849620,0,6 user reviews,4,2,6
849630,0,5 user reviews,5,0,5
849670,7,Positive,14,3,17
849680,7,Positive,15,0,15
849690,0,4 user reviews,2,2,4
849740,8,Very Positive,309,20,329
849790,6,Mostly Positive,13,4,17
849800,0,4 user reviews,4,0,4
849840,0,2 user reviews,1,1,2
849860,0,5 user reviews,0,5,5
849870,0,1 user reviews,0,1,1
849920,0,4 user reviews,4,0,4
849930,0,5 user reviews,5,0,5
849931,0,4 user reviews,4,0,4
849940,5,Mixed,13,9,22
849970,0,1 user reviews,0,1,1
849980,0,1 user reviews,1,0,1
850000,8,Very Positive,67,10,77
850010,5,Mixed,186,135,321
850040,7,Positive,12,0,12
850050,6,Mostly Positive,34,13,47
850060,5,Mixed,16,7,23
850210,6,Mostly Positive,76,26,102
850250,0,5 user reviews,1,4,5
850260,7,Positive,9,2,11
850280,0,1 user reviews,1,0,1
850281,0,1 user reviews,1,0,1
850340,0,1 user reviews,1,0,1
850450,5,Mixed,67,49,116
850630,6,Mostly Positive,50,15,65
850690,5,Mixed,35,23,58
850740,0,2 user reviews,1,1,2
850780,5,Mixed,9,4,13
850810,0,2 user reviews,2,0,2
850830,0,4 user reviews,0,4,4
850840,0,4 user reviews,3,1,4
850850,0,8 user reviews,8,0,8
850880,0,2 user reviews,2,0,2
850920,0,5 user reviews,5,0,5
850930,0,1 user reviews,1,0,1
850940,0,8 user reviews,3,5,8
850950,0,3 user reviews,1,2,3
850960,0,4 user reviews,1,3,4
850980,7,Positive,38,5,43
851000,7,Positive,35,4,39
851010,0,3 user reviews,0,3,3
851040,0,2 user reviews,1,1,2
851050,4,Mostly Negative,4,7,11
851100,9,Overwhelmingly Positive,2302,51,2353
851150,7,Positive,28,5,33
851180,7,Positive,25,5,30
851200,6,Mostly Positive,7,3,10
851250,0,5 user reviews,2,3,5
851270,0,1 user reviews,1,0,1
851271,0,1 user reviews,1,0,1
851272,0,1 user reviews,1,0,1
851273,0,1 user reviews,1,0,1
851279,0,1 user reviews,1,0,1
851280,5,Mixed,39,17,56
851350,0,9 user reviews,4,5,9
851370,0,8 user reviews,4,4,8
851520,0,5 user reviews,2,3,5
851570,0,3 user reviews,0,3,3
851580,0,3 user reviews,2,1,3
851601,0,1 user reviews,0,1,1
851640,7,Positive,30,4,34
851670,8,Very Positive,144,6,150
851710,0,4 user reviews,2,2,4
851730,7,Positive,39,3,42
851770,0,1 user reviews,1,0,1
851790,6,Mostly Positive,12,4,16
851800,7,Positive,40,6,46
851820,5,Mixed,15,7,22
851840,0,7 user reviews,7,0,7
851850,8,Very Positive,4955,485,5440
851860,0,5 user reviews,5,0,5
851870,0,5 user reviews,5,0,5
851880,0,9 user reviews,6,3,9
851890,8,Very Positive,199,23,222
851920,0,4 user reviews,1,3,4
851930,6,Mostly Positive,151,58,209
851940,0,8 user reviews,3,5,8
851950,7,Positive,21,3,24
851980,5,Mixed,5,5,10
852000,0,3 user reviews,2,1,3
852090,7,Positive,31,0,31
852110,8,Very Positive,214,8,222
852160,5,Mixed,6,6,12
852180,5,Mixed,4,6,10
852190,0,4 user reviews,4,0,4
852220,8,Very Positive,59,12,71
852300,6,Mostly Positive,87,27,114
852320,0,1 user reviews,1,0,1
852390,0,9 user reviews,9,0,9
852480,8,Very Positive,471,28,499
852530,0,1 user reviews,1,0,1
852570,0,2 user reviews,1,1,2
852580,0,1 user reviews,1,0,1
852590,0,2 user reviews,1,1,2
852630,0,4 user reviews,3,1,4
852650,0,1 user reviews,0,1,1
852660,0,6 user reviews,4,2,6
852720,5,Mixed,7,4,11
852760,0,1 user reviews,1,0,1
852790,7,Positive,17,4,21
852900,7,Positive,18,1,19
852910,8,Very Positive,53,9,62
852920,0,1 user reviews,1,0,1
852991,0,2 user reviews,1,1,2
852992,0,3 user reviews,2,1,3
852993,0,1 user reviews,1,0,1
852994,0,1 user reviews,1,0,1
852995,0,5 user reviews,4,1,5
853014,0,1 user reviews,0,1,1
853020,0,4 user reviews,1,3,4
853040,0,5 user reviews,3,2,5
853110,7,Positive,14,1,15
853120,0,4 user reviews,2,2,4
853140,6,Mostly Positive,159,42,201
853170,0,1 user reviews,1,0,1
853180,0,1 user reviews,0,1,1
853200,7,Positive,39,5,44
853210,0,9 user reviews,4,5,9
853220,0,1 user reviews,0,1,1
853240,5,Mixed,56,33,89
853260,0,3 user reviews,3,0,3
853280,0,3 user reviews,2,1,3
853290,0,1 user reviews,1,0,1
853300,0,8 user reviews,7,1,8
853310,7,Positive,12,1,13
853330,0,1 user reviews,1,0,1
853360,8,Very Positive,126,26,152
853380,5,Mixed,9,4,13
853410,0,3 user reviews,3,0,3
853480,7,Positive,15,2,17
853500,8,Very Positive,266,35,301
853550,8,Very Positive,1432,98,1530
853580,0,3 user reviews,0,3,3
853590,0,5 user reviews,5,0,5
853610,0,2 user reviews,2,0,2
853620,0,6 user reviews,3,3,6
853700,0,1 user reviews,1,0,1
853760,0,2 user reviews,0,2,2
853770,8,Very Positive,1542,169,1711
853830,0,1 user reviews,1,0,1
853850,0,3 user reviews,2,1,3
853860,7,Positive,27,5,32
853940,0,6 user reviews,2,4,6
854030,0,7 user reviews,2,5,7
854050,0,1 user reviews,0,1,1
854060,0,1 user reviews,1,0,1
854070,6,Mostly Positive,48,18,66
854120,0,4 user reviews,4,0,4
854150,0,1 user reviews,1,0,1
854160,0,6 user reviews,0,6,6
854190,5,Mixed,10,5,15
854220,0,6 user reviews,6,0,6
854230,0,1 user reviews,1,0,1
854240,0,2 user reviews,2,0,2
854250,7,Positive,29,5,34
854290,7,Positive,10,0,10
854390,0,2 user reviews,2,0,2
854400,5,Mixed,6,4,10
854450,7,Positive,11,0,11
854500,0,2 user reviews,2,0,2
854510,0,1 user reviews,0,1,1
854550,5,Mixed,5,7,12
854570,8,Very Positive,220,28,248
854650,0,1 user reviews,0,1,1
854670,0,1 user reviews,1,0,1
854680,0,2 user reviews,1,1,2
854690,5,Mixed,5,6,11
854710,0,2 user reviews,0,2,2
854740,0,4 user reviews,2,2,4
854750,6,Mostly Positive,39,10,49
854770,5,Mixed,28,28,56
854780,0,1 user reviews,0,1,1
854810,0,7 user reviews,1,6,7
854830,0,7 user reviews,7,0,7
854860,8,Very Positive,258,17,275
854870,7,Positive,9,1,10
854890,5,Mixed,18,14,32
854940,8,Very Positive,117,6,123
854950,0,2 user reviews,2,0,2
854960,7,Positive,28,5,33
854961,0,2 user reviews,2,0,2
855030,0,4 user reviews,2,2,4
855050,0,5 user reviews,3,2,5
855100,0,5 user reviews,3,2,5
855160,0,2 user reviews,0,2,2
855170,4,Mostly Negative,7,11,18
855190,6,Mostly Positive,17,7,24
855220,0,2 user reviews,2,0,2
855230,0,1 user reviews,1,0,1
855250,0,2 user reviews,2,0,2
855260,0,1 user reviews,1,0,1
855270,0,1 user reviews,1,0,1
855280,0,1 user reviews,1,0,1
855290,0,1 user reviews,1,0,1
855300,0,1 user reviews,1,0,1
855310,0,1 user reviews,1,0,1
855320,5,Mixed,6,8,14
855330,0,1 user reviews,1,0,1
855340,0,1 user reviews,1,0,1
855350,0,1 user reviews,1,0,1
855360,0,2 user reviews,2,0,2
855400,0,1 user reviews,1,0,1
855410,0,1 user reviews,1,0,1
855420,0,1 user reviews,1,0,1
855430,0,1 user reviews,1,0,1
855440,0,1 user reviews,1,0,1
855450,0,1 user reviews,1,0,1
855460,0,1 user reviews,1,0,1
855470,0,1 user reviews,1,0,1
855490,0,4 user reviews,2,2,4
855510,0,1 user reviews,1,0,1
855530,0,6 user reviews,5,1,6
855620,0,1 user reviews,1,0,1
855630,7,Positive,33,6,39
855640,8,Very Positive,208,8,216
855650,0,2 user reviews,2,0,2
855700,0,3 user reviews,3,0,3
855730,0,1 user reviews,1,0,1
855760,0,1 user reviews,1,0,1
855770,0,1 user reviews,1,0,1
855800,0,1 user reviews,1,0,1
855850,8,Very Positive,46,8,54
855860,8,Very Positive,381,48,429
855940,0,9 user reviews,3,6,9
855970,5,Mixed,7,6,13
856010,5,Mixed,11,8,19
856040,0,1 user reviews,1,0,1
856080,0,7 user reviews,4,3,7
856100,0,2 user reviews,2,0,2
856110,0,8 user reviews,7,1,8
856120,7,Positive,28,3,31
856130,5,Mixed,24,21,45
856142,0,1 user reviews,1,0,1
856160,0,1 user reviews,1,0,1
856170,0,4 user reviews,3,1,4
856210,6,Mostly Positive,47,18,65
856220,0,7 user reviews,5,2,7
856240,0,1 user reviews,1,0,1
856260,0,4 user reviews,0,4,4
856270,0,4 user reviews,4,0,4
856320,5,Mixed,14,10,24
856350,0,1 user reviews,0,1,1
856370,0,1 user reviews,1,0,1
856380,0,1 user reviews,1,0,1
856390,0,1 user reviews,1,0,1
856400,0,5 user reviews,3,2,5
856410,0,4 user reviews,0,4,4
856430,0,9 user reviews,3,6,9
856440,0,5 user reviews,2,3,5
856450,7,Positive,12,1,13
856490,5,Mixed,6,5,11
856540,7,Positive,41,1,42
856550,0,1 user reviews,1,0,1
856560,0,1 user reviews,1,0,1
856570,7,Positive,11,0,11
856610,7,Positive,18,3,21
856650,0,5 user reviews,5,0,5
856670,0,1 user reviews,1,0,1
856750,0,5 user reviews,4,1,5
856760,0,3 user reviews,1,2,3
856790,0,5 user reviews,1,4,5
856840,0,1 user reviews,0,1,1
856850,7,Positive,38,9,47
856880,0,9 user reviews,7,2,9
856900,0,3 user reviews,3,0,3
856910,0,1 user reviews,1,0,1
856920,0,3 user reviews,3,0,3
856930,0,1 user reviews,1,0,1
856940,0,1 user reviews,1,0,1
856950,0,1 user reviews,1,0,1
856960,0,3 user reviews,3,0,3
856980,0,7 user reviews,2,5,7
856990,5,Mixed,14,12,26
857010,5,Mixed,10,5,15
857020,0,5 user reviews,3,2,5
857050,5,Mixed,8,6,14
857060,5,Mixed,22,24,46
857080,7,Positive,36,6,42
857110,0,1 user reviews,0,1,1
857140,0,5 user reviews,3,2,5
857180,5,Mixed,16,9,25
857200,7,Positive,19,2,21
857240,0,4 user reviews,0,4,4
857280,7,Positive,11,0,11
857300,0,7 user reviews,6,1,7
857320,7,Positive,40,7,47
857370,0,9 user reviews,5,4,9
857380,0,1 user reviews,1,0,1
857381,0,1 user reviews,1,0,1
857390,0,3 user reviews,0,3,3
857420,0,9 user reviews,7,2,9
857450,8,Very Positive,106,3,109
857460,0,6 user reviews,6,0,6
857470,7,Positive,12,3,15
857480,0,7 user reviews,7,0,7
857500,7,Positive,28,1,29
857510,0,2 user reviews,1,1,2
857520,0,5 user reviews,2,3,5
857540,0,7 user reviews,6,1,7
857570,0,3 user reviews,0,3,3
857600,0,3 user reviews,2,1,3
857630,0,3 user reviews,1,2,3
857680,6,Mostly Positive,37,10,47
857690,8,Very Positive,47,4,51
857700,0,4 user reviews,1,3,4
857710,0,1 user reviews,1,0,1
857740,0,2 user reviews,2,0,2
857770,0,2 user reviews,2,0,2
857850,0,5 user reviews,3,2,5
857860,0,5 user reviews,5,0,5
857880,0,1 user reviews,1,0,1
857900,0,6 user reviews,4,2,6
857940,0,9 user reviews,7,2,9
857950,0,5 user reviews,3,2,5
857970,0,2 user reviews,2,0,2
857980,8,Very Positive,1523,202,1725
858010,0,1 user reviews,0,1,1
858040,7,Positive,18,4,22
858050,7,Positive,31,0,31
858080,0,2 user reviews,1,1,2
858100,7,Positive,16,4,20
858170,0,3 user reviews,3,0,3
858180,0,6 user reviews,1,5,6
858210,9,Overwhelmingly Positive,1544,23,1567
858230,0,2 user reviews,2,0,2
858240,7,Positive,16,3,19
858250,6,Mostly Positive,9,3,12
858260,9,Overwhelmingly Positive,1047,45,1092
858270,0,1 user reviews,1,0,1
858300,0,2 user reviews,1,1,2
858320,0,1 user reviews,1,0,1
858360,7,Positive,41,5,46
858420,0,5 user reviews,2,3,5
858440,0,2 user reviews,1,1,2
858590,5,Mixed,254,139,393
858630,7,Positive,34,5,39
858680,6,Mostly Positive,28,9,37
858690,0,8 user reviews,3,5,8
858760,8,Very Positive,274,5,279
858780,5,Mixed,8,7,15
858810,8,Very Positive,4964,807,5771
858830,0,9 user reviews,9,0,9
858840,0,2 user reviews,1,1,2
858860,7,Positive,26,1,27
858870,7,Positive,9,2,11
858880,7,Positive,19,0,19
858930,0,7 user reviews,2,5,7
858940,7,Positive,49,0,49
858960,0,6 user reviews,5,1,6
858970,0,1 user reviews,1,0,1
858980,0,1 user reviews,1,0,1
859040,6,Mostly Positive,25,7,32
859050,0,1 user reviews,1,0,1
859130,7,Positive,34,0,34
859150,0,4 user reviews,3,1,4
859200,0,3 user reviews,3,0,3
859300,0,3 user reviews,3,0,3
859310,0,1 user reviews,0,1,1
859340,5,Mixed,162,96,258
859350,7,Positive,11,1,12
859370,7,Positive,12,0,12
859380,0,3 user reviews,2,1,3
859420,0,1 user reviews,1,0,1
859430,0,1 user reviews,1,0,1
859440,5,Mixed,6,7,13
859460,0,1 user reviews,0,1,1
859500,0,4 user reviews,1,3,4
859530,0,1 user reviews,1,0,1
859560,0,4 user reviews,2,2,4
859570,8,Very Positive,1904,299,2203
859580,5,Mixed,4394,3878,8272
859600,0,1 user reviews,1,0,1
859610,0,1 user reviews,1,0,1
859640,7,Positive,21,3,24
859660,0,2 user reviews,2,0,2
859680,9,Overwhelmingly Positive,499,16,515
859700,7,Positive,35,5,40
859740,7,Positive,17,4,21
859820,0,3 user reviews,3,0,3
859870,0,2 user reviews,1,1,2
859900,0,4 user reviews,1,3,4
859920,0,1 user reviews,0,1,1
859950,0,1 user reviews,1,0,1
859960,0,8 user reviews,8,0,8
859970,0,1 user reviews,1,0,1
859990,7,Positive,24,1,25
860030,0,2 user reviews,2,0,2
860070,0,9 user reviews,6,3,9
860080,0,6 user reviews,6,0,6
860090,6,Mostly Positive,11,3,14
860190,3,Negative,2,9,11
860260,0,4 user reviews,1,3,4
860320,0,3 user reviews,2,1,3
860340,0,6 user reviews,3,3,6
860350,0,4 user reviews,1,3,4
860400,0,2 user reviews,1,1,2
860430,0,1 user reviews,0,1,1
860440,5,Mixed,13,7,20
860450,5,Mixed,11,6,17
860480,0,3 user reviews,1,2,3
860490,0,1 user reviews,1,0,1
860500,5,Mixed,5,5,10
860530,0,8 user reviews,6,2,8
860550,0,4 user reviews,4,0,4
860570,0,4 user reviews,0,4,4
860580,0,1 user reviews,0,1,1
860590,0,3 user reviews,3,0,3
860600,0,4 user reviews,3,1,4
860620,4,Mostly Negative,20,45,65
860630,0,1 user reviews,1,0,1
860640,5,Mixed,12,12,24
860650,6,Mostly Positive,38,12,50
860660,0,8 user reviews,5,3,8
860680,0,3 user reviews,2,1,3
860720,0,3 user reviews,3,0,3
860770,0,8 user reviews,4,4,8
860790,0,5 user reviews,4,1,5
860820,0,6 user reviews,2,4,6
860860,5,Mixed,30,14,44
860870,0,1 user reviews,1,0,1
860880,0,6 user reviews,6,0,6
860890,8,Very Positive,961,91,1052
860900,3,Negative,3,13,16
860910,6,Mostly Positive,101,40,141
860950,9,Overwhelmingly Positive,982,30,1012
860980,0,3 user reviews,2,1,3
860981,0,1 user reviews,0,1,1
860990,5,Mixed,9,5,14
861010,0,5 user reviews,5,0,5
861030,5,Mixed,6,5,11
861080,0,4 user reviews,2,2,4
861090,0,8 user reviews,7,1,8
861100,0,5 user reviews,4,1,5
861110,0,1 user reviews,1,0,1
861160,0,4 user reviews,2,2,4
861180,3,Negative,1,9,10
861190,4,Mostly Negative,4,9,13
861200,0,1 user reviews,1,0,1
861230,0,2 user reviews,1,1,2
861240,0,4 user reviews,4,0,4
861270,7,Positive,15,2,17
861280,0,1 user reviews,1,0,1
861290,0,4 user reviews,2,2,4
861300,7,Positive,19,0,19
861320,0,4 user reviews,2,2,4
861330,7,Positive,16,0,16
861350,5,Mixed,30,23,53
861540,8,Very Positive,2292,228,2520
861550,0,7 user reviews,6,1,7
861640,0,3 user reviews,2,1,3
861641,0,5 user reviews,2,3,5
861642,0,2 user reviews,2,0,2
861650,8,Very Positive,3353,543,3896
861670,0,5 user reviews,4,1,5
861710,7,Positive,11,1,12
861720,5,Mixed,4,6,10
861730,0,1 user reviews,0,1,1
861731,0,2 user reviews,2,0,2
861732,5,Mixed,6,6,12
861740,0,3 user reviews,1,2,3
861750,0,1 user reviews,1,0,1
861760,5,Mixed,25,17,42
861860,0,2 user reviews,2,0,2
861870,6,Mostly Positive,7,3,10
861871,0,3 user reviews,2,1,3
861872,0,4 user reviews,3,1,4
861880,0,6 user reviews,6,0,6
861881,7,Positive,13,3,16
861882,0,2 user reviews,2,0,2
861883,0,2 user reviews,2,0,2
861884,0,2 user reviews,2,0,2
861885,0,5 user reviews,5,0,5
861887,0,6 user reviews,4,2,6
861888,7,Positive,8,2,10
861889,5,Mixed,12,9,21
861960,0,2 user reviews,2,0,2
862110,7,Positive,19,0,19
862120,0,5 user reviews,1,4,5
862130,7,Positive,11,0,11
862150,0,5 user reviews,3,2,5
862190,0,2 user reviews,0,2,2
862210,4,Mostly Negative,4,10,14
862250,0,1 user reviews,1,0,1
862260,5,Mixed,9,5,14
862280,0,6 user reviews,2,4,6
862300,0,7 user reviews,5,2,7
862370,0,1 user reviews,0,1,1
862390,5,Mixed,52,25,77
862450,0,8 user reviews,6,2,8
862460,7,Positive,11,0,11
862480,8,Very Positive,239,21,260
862490,0,1 user reviews,1,0,1
862500,0,2 user reviews,0,2,2
862520,3,Negative,0,13,13
862570,8,Very Positive,226,6,232
862580,6,Mostly Positive,191,52,243
862590,0,5 user reviews,0,5,5
862640,0,1 user reviews,1,0,1
862650,0,4 user reviews,0,4,4
862660,0,8 user reviews,3,5,8
862690,0,1 user reviews,1,0,1
862700,0,1 user reviews,1,0,1
862740,0,7 user reviews,6,1,7
862760,0,1 user reviews,1,0,1
862770,7,Positive,13,3,16
862790,0,2 user reviews,2,0,2
862800,8,Very Positive,514,52,566
862810,0,9 user reviews,7,2,9
862850,0,3 user reviews,1,2,3
862880,0,5 user reviews,2,3,5
862920,7,Positive,16,1,17
862940,3,Negative,2,9,11
862990,0,3 user reviews,0,3,3
863150,0,5 user reviews,3,2,5
863180,0,3 user reviews,3,0,3
863181,0,1 user reviews,1,0,1
863190,0,1 user reviews,1,0,1
863210,0,5 user reviews,5,0,5
863270,0,1 user reviews,1,0,1
863280,0,3 user reviews,2,1,3
863290,0,1 user reviews,1,0,1
863310,0,2 user reviews,2,0,2
863380,5,Mixed,6,5,11
863420,4,Mostly Negative,8,13,21
863430,0,4 user reviews,4,0,4
863460,5,Mixed,17,15,32
863470,7,Positive,12,0,12
863490,5,Mixed,18,11,29
863520,0,6 user reviews,6,0,6
863550,8,Very Positive,7746,750,8496
863570,8,Very Positive,215,42,257
863580,0,9 user reviews,3,6,9
863590,8,Very Positive,780,57,837
863620,0,1 user reviews,1,0,1
863660,0,2 user reviews,1,1,2
863690,0,1 user reviews,0,1,1
863730,0,1 user reviews,1,0,1
863760,0,1 user reviews,1,0,1
863810,0,7 user reviews,5,2,7
863840,0,1 user reviews,0,1,1
863870,0,2 user reviews,1,1,2
863900,0,6 user reviews,6,0,6
863980,5,Mixed,9,8,17
864010,0,6 user reviews,4,2,6
864020,0,3 user reviews,2,1,3
864060,8,Very Positive,312,17,329
864080,0,1 user reviews,1,0,1
864100,8,Very Positive,88,6,94
864110,0,3 user reviews,2,1,3
864130,6,Mostly Positive,20,6,26
864150,0,9 user reviews,5,4,9
864160,6,Mostly Positive,108,31,139
864190,0,1 user reviews,1,0,1
864200,0,1 user reviews,0,1,1
864220,0,3 user reviews,3,0,3
864300,8,Very Positive,64,5,69
864310,0,1 user reviews,1,0,1
864360,0,1 user reviews,1,0,1
864370,0,2 user reviews,2,0,2
864430,0,4 user reviews,3,1,4
864450,0,8 user reviews,6,2,8
864500,0,2 user reviews,2,0,2
864510,6,Mostly Positive,12,4,16
864530,0,5 user reviews,3,2,5
864540,7,Positive,40,8,48
864550,6,Mostly Positive,36,11,47
864570,0,9 user reviews,7,2,9
864600,0,2 user reviews,2,0,2
864610,6,Mostly Positive,16,5,21
864660,0,2 user reviews,1,1,2
864680,8,Very Positive,67,5,72
864730,6,Mostly Positive,29,10,39
864740,0,6 user reviews,6,0,6
864760,0,3 user reviews,1,2,3
864790,5,Mixed,6,4,10
864810,0,6 user reviews,3,3,6
864850,0,3 user reviews,2,1,3
864860,7,Positive,12,1,13
864880,0,5 user reviews,3,2,5
864940,4,Mostly Negative,3,9,12
864960,0,2 user reviews,2,0,2
864970,7,Positive,32,7,39
864980,7,Positive,23,2,25
865040,8,Very Positive,101,6,107
865060,0,6 user reviews,6,0,6
865070,0,2 user reviews,0,2,2
865090,8,Very Positive,279,29,308
865120,0,1 user reviews,0,1,1
865160,5,Mixed,10,9,19
865170,0,3 user reviews,3,0,3
865180,0,3 user reviews,1,2,3
865190,5,Mixed,7,4,11
865210,0,1 user reviews,1,0,1
865220,7,Positive,17,1,18
865250,6,Mostly Positive,62,21,83
865260,0,2 user reviews,2,0,2
865270,8,Very Positive,75,5,80
865290,0,1 user reviews,1,0,1
865310,5,Mixed,4,6,10
865320,0,9 user reviews,6,3,9
865330,0,2 user reviews,1,1,2
865360,8,Very Positive,1264,135,1399
865390,4,Mostly Negative,11,19,30
865540,8,Very Positive,455,13,468
865630,0,3 user reviews,3,0,3
865670,6,Mostly Positive,521,157,678
865720,0,1 user reviews,0,1,1
865750,0,1 user reviews,1,0,1
865760,0,1 user reviews,1,0,1
865800,0,2 user reviews,2,0,2
865820,8,Very Positive,74,10,84
865830,7,Positive,38,4,42
865850,5,Mixed,8,6,14
865860,0,2 user reviews,0,2,2
865870,0,4 user reviews,2,2,4
865930,0,8 user reviews,7,1,8
865940,7,Positive,24,5,29
865970,0,1 user reviews,1,0,1
865980,6,Mostly Positive,52,15,67
865990,0,3 user reviews,2,1,3
866010,7,Positive,31,7,38
866100,0,3 user reviews,1,2,3
866150,0,3 user reviews,2,1,3
866180,0,4 user reviews,0,4,4
866190,8,Very Positive,89,10,99
866211,0,1 user reviews,0,1,1
866212,0,3 user reviews,3,0,3
866260,5,Mixed,6,8,14
866280,0,2 user reviews,0,2,2
866310,6,Mostly Positive,11,4,15
866320,0,2 user reviews,2,0,2
866340,0,1 user reviews,0,1,1
866400,7,Positive,28,7,35
866420,7,Positive,15,1,16
866450,0,2 user reviews,2,0,2
866500,0,3 user reviews,3,0,3
866510,5,Mixed,20,17,37
866520,6,Mostly Positive,7,3,10
866540,0,3 user reviews,3,0,3
866600,0,2 user reviews,2,0,2
866630,0,1 user reviews,0,1,1
866670,0,1 user reviews,0,1,1
866700,0,3 user reviews,2,1,3
866710,0,3 user reviews,2,1,3
866720,0,2 user reviews,2,0,2
866730,0,2 user reviews,2,0,2
866750,0,2 user reviews,2,0,2
866770,0,7 user reviews,3,4,7
866790,0,1 user reviews,1,0,1
866800,8,Very Positive,3146,318,3464
867010,0,2 user reviews,2,0,2
867020,0,1 user reviews,1,0,1
867050,5,Mixed,17,9,26
867070,0,1 user reviews,1,0,1
867110,0,3 user reviews,3,0,3
867120,5,Mixed,8,5,13
867140,5,Mixed,11,5,16
867180,7,Positive,26,3,29
867200,0,1 user reviews,1,0,1
867220,0,1 user reviews,0,1,1
867240,7,Positive,22,3,25
867250,0,9 user reviews,9,0,9
867290,5,Mixed,801,516,1317
867380,8,Very Positive,109,9,118
867390,0,1 user reviews,1,0,1
867400,8,Very Positive,52,8,60
867420,5,Mixed,8,5,13
867470,0,1 user reviews,0,1,1
867480,5,Mixed,7,6,13
867490,7,Positive,33,7,40
867510,0,2 user reviews,2,0,2
867530,0,1 user reviews,1,0,1
867540,0,4 user reviews,2,2,4
867550,0,2 user reviews,1,1,2
867570,0,1 user reviews,0,1,1
867580,0,4 user reviews,1,3,4
867590,0,3 user reviews,2,1,3
867600,0,1 user reviews,1,0,1
867610,5,Mixed,10,9,19
867620,0,7 user reviews,0,7,7
867640,0,5 user reviews,3,2,5
867700,7,Positive,30,6,36
867710,0,1 user reviews,1,0,1
867730,0,8 user reviews,3,5,8
867790,0,2 user reviews,2,0,2
867800,0,5 user reviews,3,2,5
867850,0,3 user reviews,1,2,3
867860,0,6 user reviews,6,0,6
867920,0,1 user reviews,1,0,1
867940,0,1 user reviews,0,1,1
867980,7,Positive,24,1,25
868000,0,3 user reviews,0,3,3
868010,0,3 user reviews,3,0,3
868040,0,1 user reviews,1,0,1
868060,7,Positive,26,5,31
868080,7,Positive,26,5,31
868111,0,1 user reviews,1,0,1
868130,0,1 user reviews,1,0,1
868150,8,Very Positive,96,10,106
868210,0,1 user reviews,1,0,1
868230,6,Mostly Positive,18,6,24
868240,0,1 user reviews,1,0,1
868260,5,Mixed,8,6,14
868280,7,Positive,41,3,44
868310,7,Positive,31,6,37
868311,7,Positive,16,2,18
868312,6,Mostly Positive,21,7,28
868340,7,Positive,10,1,11
868350,0,3 user reviews,0,3,3
868360,8,Very Positive,1075,215,1290
868380,5,Mixed,44,32,76
868390,0,1 user reviews,0,1,1
868400,0,3 user reviews,1,2,3
868410,4,Mostly Negative,10,16,26
868422,6,Mostly Positive,28,11,39
868423,6,Mostly Positive,12,4,16
868424,5,Mixed,26,18,44
868430,0,3 user reviews,3,0,3
868440,0,3 user reviews,3,0,3
868460,0,1 user reviews,0,1,1
868470,0,2 user reviews,0,2,2
868480,0,3 user reviews,2,1,3
868500,7,Positive,11,0,11
868510,0,1 user reviews,1,0,1
868520,9,Overwhelmingly Positive,734,25,759
868550,5,Mixed,9,4,13
868560,0,4 user reviews,3,1,4
868570,5,Mixed,12,6,18
868580,7,Positive,23,5,28
868600,0,1 user reviews,1,0,1
868660,0,6 user reviews,5,1,6
868710,3,Negative,1,9,10
868730,0,1 user reviews,1,0,1
868770,0,1 user reviews,1,0,1
868780,7,Positive,22,2,24
868820,0,4 user reviews,4,0,4
868870,0,6 user reviews,6,0,6
868880,0,4 user reviews,3,1,4
868890,5,Mixed,7,4,11
868910,0,1 user reviews,1,0,1
868920,0,4 user reviews,2,2,4
868930,0,7 user reviews,7,0,7
868960,0,1 user reviews,0,1,1
868970,0,4 user reviews,1,3,4
868980,8,Very Positive,412,10,422
869030,0,2 user reviews,2,0,2
869060,5,Mixed,33,44,77
869080,0,1 user reviews,1,0,1
869100,0,6 user reviews,5,1,6
869120,0,4 user reviews,4,0,4
869130,0,3 user reviews,1,2,3
869160,0,2 user reviews,2,0,2
869170,7,Positive,23,4,27
869241,0,1 user reviews,0,1,1
869280,0,7 user reviews,1,6,7
869290,0,8 user reviews,8,0,8
869300,7,Positive,9,1,10
869340,0,4 user reviews,0,4,4
869350,8,Very Positive,51,3,54
869370,0,2 user reviews,2,0,2
869390,7,Positive,13,0,13
869420,0,2 user reviews,0,2,2
869440,0,3 user reviews,3,0,3
869470,0,5 user reviews,5,0,5
869500,0,1 user reviews,1,0,1
869530,0,2 user reviews,2,0,2
869540,0,3 user reviews,2,1,3
869550,7,Positive,10,1,11
869560,0,4 user reviews,2,2,4
869620,7,Positive,10,2,12
869660,0,1 user reviews,0,1,1
869670,7,Positive,15,1,16
869680,0,5 user reviews,0,5,5
869690,7,Positive,21,0,21
869750,0,3 user reviews,2,1,3
869780,6,Mostly Positive,8,3,11
869830,7,Positive,24,3,27
869840,0,5 user reviews,4,1,5
869850,0,7 user reviews,7,0,7
869870,0,4 user reviews,4,0,4
869910,0,4 user reviews,4,0,4
869930,0,1 user reviews,0,1,1
870010,0,2 user reviews,0,2,2
870020,0,3 user reviews,3,0,3
870030,0,1 user reviews,1,0,1
870080,6,Mostly Positive,20,6,26
870090,0,3 user reviews,3,0,3
870100,0,1 user reviews,0,1,1
870110,0,5 user reviews,2,3,5
870120,0,6 user reviews,2,4,6
870140,0,7 user reviews,6,1,7
870160,0,3 user reviews,2,1,3
870180,0,7 user reviews,4,3,7
870190,0,3 user reviews,3,0,3
870200,8,Very Positive,529,53,582
870240,0,2 user reviews,2,0,2
870260,0,7 user reviews,7,0,7
870270,5,Mixed,16,7,23
870271,0,3 user reviews,3,0,3
870272,0,5 user reviews,5,0,5
870273,0,3 user reviews,3,0,3
870276,0,1 user reviews,1,0,1
870277,0,4 user reviews,3,1,4
870280,0,7 user reviews,6,1,7
870290,6,Mostly Positive,195,62,257
870345,0,1 user reviews,1,0,1
870390,0,4 user reviews,3,1,4
870400,0,4 user reviews,2,2,4
870420,8,Very Positive,213,31,244
870430,0,2 user reviews,0,2,2
870450,0,1 user reviews,0,1,1
870460,0,1 user reviews,0,1,1
870461,0,1 user reviews,0,1,1
870462,0,1 user reviews,0,1,1
870470,0,1 user reviews,1,0,1
870510,0,2 user reviews,2,0,2
870520,0,1 user reviews,0,1,1
870580,0,4 user reviews,3,1,4
870590,0,3 user reviews,3,0,3
870600,0,8 user reviews,8,0,8
870620,0,1 user reviews,0,1,1
870650,0,1 user reviews,0,1,1
870670,0,5 user reviews,5,0,5
870680,0,2 user reviews,1,1,2
870690,8,Very Positive,65,4,69
870730,7,Positive,30,3,33
870750,0,2 user reviews,2,0,2
870780,8,Very Positive,2862,284,3146
870800,0,5 user reviews,5,0,5
870920,0,2 user reviews,2,0,2
870990,0,3 user reviews,1,2,3
871100,0,6 user reviews,6,0,6
871140,0,1 user reviews,0,1,1
871150,0,3 user reviews,2,1,3
871190,7,Positive,17,1,18
871200,8,Very Positive,208,25,233
871230,0,8 user reviews,5,3,8
871260,0,3 user reviews,2,1,3
871280,7,Positive,15,0,15
871290,0,4 user reviews,3,1,4
871300,0,1 user reviews,0,1,1
871310,6,Mostly Positive,9,3,12
871330,0,4 user reviews,4,0,4
871390,0,4 user reviews,3,1,4
871420,8,Very Positive,165,34,199
871510,0,4 user reviews,3,1,4
871530,6,Mostly Positive,329,86,415
871570,0,1 user reviews,1,0,1
871580,0,2 user reviews,2,0,2
871590,0,6 user reviews,4,2,6
871650,7,Positive,27,1,28
871651,0,9 user reviews,3,6,9
871710,0,7 user reviews,3,4,7
871720,0,3 user reviews,3,0,3
871810,0,8 user reviews,4,4,8
871850,0,5 user reviews,4,1,5
871860,0,1 user reviews,0,1,1
871870,5,Mixed,6,4,10
871900,0,9 user reviews,9,0,9
871920,0,2 user reviews,2,0,2
871930,8,Very Positive,369,27,396
871950,8,Very Positive,100,16,116
871990,5,Mixed,86,59,145
872040,0,6 user reviews,6,0,6
872060,6,Mostly Positive,7,3,10
872070,0,3 user reviews,3,0,3
872090,5,Mixed,7,6,13
872110,7,Positive,13,1,14
872130,8,Very Positive,237,20,257
872180,0,3 user reviews,2,1,3
872220,0,1 user reviews,1,0,1
872240,0,1 user reviews,1,0,1
872280,4,Mostly Negative,36,60,96
872310,0,1 user reviews,1,0,1
872330,0,1 user reviews,0,1,1
872350,5,Mixed,17,15,32
872360,0,3 user reviews,2,1,3
872370,0,1 user reviews,1,0,1
872380,0,9 user reviews,8,1,9
872400,0,5 user reviews,1,4,5
872410,5,Mixed,190,131,321
872470,7,Positive,14,1,15
872490,0,6 user reviews,3,3,6
872530,0,2 user reviews,1,1,2
872550,0,4 user reviews,2,2,4
872580,0,9 user reviews,9,0,9
872630,0,8 user reviews,1,7,8
872680,5,Mixed,50,26,76
872690,0,4 user reviews,2,2,4
872700,0,1 user reviews,1,0,1
872730,0,7 user reviews,6,1,7
872750,8,Very Positive,88,8,96
872770,0,7 user reviews,5,2,7
872790,8,Very Positive,2094,321,2415
872810,7,Positive,17,2,19
872820,8,Very Positive,65,13,78
872990,0,4 user reviews,2,2,4
873030,7,Positive,20,5,25
873050,0,1 user reviews,0,1,1
873070,7,Positive,16,1,17
873120,0,6 user reviews,4,2,6
873140,0,1 user reviews,0,1,1
873160,0,1 user reviews,0,1,1
873180,0,1 user reviews,0,1,1
873190,7,Positive,26,2,28
873200,8,Very Positive,99,4,103
873210,0,1 user reviews,0,1,1
873220,5,Mixed,37,24,61
873240,8,Very Positive,252,32,284
873290,0,5 user reviews,5,0,5
873320,0,1 user reviews,0,1,1
873390,7,Positive,15,1,16
873410,6,Mostly Positive,11,3,14
873470,0,2 user reviews,2,0,2
873490,0,1 user reviews,1,0,1
873500,0,3 user reviews,2,1,3
873560,7,Positive,14,1,15
873590,0,2 user reviews,1,1,2
873610,6,Mostly Positive,22,6,28
873710,0,2 user reviews,0,2,2
873740,0,1 user reviews,0,1,1
873780,0,3 user reviews,3,0,3
873790,0,9 user reviews,7,2,9
873830,0,1 user reviews,1,0,1
873840,5,Mixed,99,45,144
873850,0,4 user reviews,0,4,4
873860,0,1 user reviews,0,1,1
873870,7,Positive,10,2,12
873871,6,Mostly Positive,7,3,10
873880,7,Positive,28,6,34
873890,8,Very Positive,76,5,81
873900,0,9 user reviews,7,2,9
873930,7,Positive,11,2,13
873940,8,Very Positive,897,144,1041
873970,5,Mixed,7,5,12
873980,5,Mixed,30,17,47
874010,6,Mostly Positive,12,4,16
874020,0,5 user reviews,2,3,5
874040,6,Mostly Positive,44,13,57
874060,0,3 user reviews,3,0,3
874080,0,1 user reviews,1,0,1
874090,0,2 user reviews,2,0,2
874130,0,1 user reviews,1,0,1
874140,0,3 user reviews,1,2,3
874200,0,2 user reviews,2,0,2
874230,5,Mixed,11,5,16
874240,0,4 user reviews,1,3,4
874250,0,2 user reviews,2,0,2
874270,5,Mixed,7,4,11
874310,4,Mostly Negative,222,468,690
874330,0,2 user reviews,0,2,2
874340,5,Mixed,20,10,30
874341,5,Mixed,17,25,42
874342,7,Positive,26,2,28
874343,4,Mostly Negative,7,18,25
874344,8,Very Positive,82,12,94
874345,5,Mixed,21,26,47
874360,5,Mixed,46,47,93
874370,0,8 user reviews,5,3,8
874380,4,Mostly Negative,4,8,12
874390,8,Very Positive,479,16,495
874460,6,Mostly Positive,32,13,45
874640,0,5 user reviews,1,4,5
874661,7,Positive,39,8,47
874690,0,2 user reviews,2,0,2
874700,0,3 user reviews,3,0,3
874710,0,2 user reviews,2,0,2
874720,0,3 user reviews,2,1,3
874730,0,1 user reviews,1,0,1
874740,0,5 user reviews,5,0,5
874750,0,2 user reviews,1,1,2
874770,0,5 user reviews,5,0,5
874780,0,2 user reviews,1,1,2
874800,0,6 user reviews,5,1,6
874810,0,1 user reviews,1,0,1
874830,0,7 user reviews,0,7,7
874890,0,2 user reviews,2,0,2
874893,0,3 user reviews,3,0,3
874940,0,2 user reviews,1,1,2
874960,0,1 user reviews,1,0,1
874970,0,1 user reviews,0,1,1
875010,0,1 user reviews,0,1,1
875070,0,1 user reviews,1,0,1
875080,0,5 user reviews,5,0,5
875090,0,1 user reviews,1,0,1
875110,7,Positive,12,2,14
875150,0,3 user reviews,2,1,3
875151,0,2 user reviews,2,0,2
875152,0,2 user reviews,2,0,2
875160,0,6 user reviews,5,1,6
875240,6,Mostly Positive,44,13,57
875250,0,1 user reviews,1,0,1
875260,0,9 user reviews,1,8,9
875270,0,4 user reviews,3,1,4
875310,5,Mixed,22,12,34
875360,0,2 user reviews,0,2,2
875371,0,1 user reviews,1,0,1
875430,5,Mixed,11,7,18
875440,0,5 user reviews,2,3,5
875460,7,Positive,11,2,13
875500,0,1 user reviews,0,1,1
875510,0,4 user reviews,3,1,4
875540,0,9 user reviews,5,4,9
875550,0,3 user reviews,0,3,3
875620,0,4 user reviews,4,0,4
875621,0,1 user reviews,1,0,1
875660,0,3 user reviews,3,0,3
875670,0,1 user reviews,0,1,1
875760,6,Mostly Positive,70,22,92
875780,0,2 user reviews,1,1,2
875800,6,Mostly Positive,49,14,63
875810,0,1 user reviews,1,0,1
875830,7,Positive,18,3,21
875850,0,1 user reviews,1,0,1
875890,0,7 user reviews,6,1,7
875930,0,6 user reviews,5,1,6
875950,2,Very Negative,7,81,88
875960,2,Very Negative,5,62,67
876130,0,2 user reviews,2,0,2
876140,0,4 user reviews,1,3,4
876180,0,3 user reviews,3,0,3
876190,5,Mixed,15,7,22
876200,0,4 user reviews,3,1,4
876210,0,2 user reviews,1,1,2
876220,0,8 user reviews,7,1,8
876260,0,2 user reviews,2,0,2
876270,0,1 user reviews,1,0,1
876290,0,2 user reviews,1,1,2
876300,0,4 user reviews,4,0,4
876310,0,5 user reviews,5,0,5
876320,7,Positive,23,2,25
876360,7,Positive,11,0,11
876380,0,2 user reviews,2,0,2
876410,0,1 user reviews,0,1,1
876450,0,5 user reviews,3,2,5
876480,0,3 user reviews,3,0,3
876500,0,9 user reviews,8,1,9
876540,0,2 user reviews,1,1,2
876550,0,1 user reviews,1,0,1
876650,8,Very Positive,393,27,420
876780,0,4 user reviews,3,1,4
876840,0,2 user reviews,1,1,2
876850,0,4 user reviews,4,0,4
876860,0,1 user reviews,0,1,1
876870,0,2 user reviews,1,1,2
876880,0,7 user reviews,3,4,7
876910,0,2 user reviews,1,1,2
876930,0,5 user reviews,3,2,5
876980,7,Positive,16,0,16
877040,0,2 user reviews,1,1,2
877060,0,2 user reviews,2,0,2
877080,5,Mixed,39,19,58
877150,0,2 user reviews,1,1,2
877190,0,7 user reviews,3,4,7
877200,8,Very Positive,1310,269,1579
877230,0,9 user reviews,5,4,9
877250,0,3 user reviews,2,1,3
877260,0,7 user reviews,3,4,7
877270,0,3 user reviews,2,1,3
877310,0,1 user reviews,1,0,1
877330,0,4 user reviews,3,1,4
877360,5,Mixed,39,17,56
877380,0,5 user reviews,4,1,5
877440,0,7 user reviews,7,0,7
877470,0,2 user reviews,1,1,2
877480,0,5 user reviews,5,0,5
877510,0,7 user reviews,4,3,7
877550,7,Positive,9,1,10
877570,0,2 user reviews,2,0,2
877590,0,2 user reviews,0,2,2
877620,0,6 user reviews,6,0,6
877680,0,4 user reviews,2,2,4
877710,0,1 user reviews,1,0,1
877730,0,6 user reviews,3,3,6
877780,0,7 user reviews,5,2,7
877800,0,2 user reviews,2,0,2
877810,8,Very Positive,242,18,260
877840,7,Positive,23,5,28
877850,7,Positive,38,4,42
877870,0,1 user reviews,1,0,1
877940,0,6 user reviews,6,0,6
877960,0,1 user reviews,0,1,1
877980,0,1 user reviews,0,1,1
878020,7,Positive,26,4,30
878030,0,1 user reviews,1,0,1
878080,5,Mixed,6,4,10
878090,7,Positive,12,1,13
878120,0,2 user reviews,1,1,2
878140,0,1 user reviews,0,1,1
878150,0,5 user reviews,5,0,5
878160,0,8 user reviews,1,7,8
878170,6,Mostly Positive,10,4,14
878180,6,Mostly Positive,7,3,10
878250,7,Positive,14,0,14
878270,0,5 user reviews,2,3,5
878290,7,Positive,13,2,15
878300,0,2 user reviews,1,1,2
878330,0,7 user reviews,6,1,7
878340,0,1 user reviews,1,0,1
878350,5,Mixed,9,4,13
878380,8,Very Positive,46,8,54
878400,0,1 user reviews,0,1,1
878420,7,Positive,35,8,43
878460,7,Positive,19,2,21
878461,7,Positive,29,5,34
878462,7,Positive,16,3,19
878463,7,Positive,37,1,38
878464,7,Positive,17,2,19
878465,8,Very Positive,49,4,53
878467,8,Very Positive,88,12,100
878470,0,1 user reviews,0,1,1
878510,0,1 user reviews,1,0,1
878520,5,Mixed,12,9,21
878540,0,1 user reviews,0,1,1
878570,0,2 user reviews,0,2,2
878580,6,Mostly Positive,49,14,63
878620,0,1 user reviews,1,0,1
878630,0,1 user reviews,0,1,1
878640,0,7 user reviews,5,2,7
878660,0,4 user reviews,2,2,4
878680,7,Positive,22,2,24
878710,0,8 user reviews,4,4,8
878750,8,Very Positive,1530,124,1654
878770,0,4 user reviews,3,1,4
878780,0,9 user reviews,8,1,9
878810,0,3 user reviews,0,3,3
878820,0,1 user reviews,0,1,1
878890,0,2 user reviews,1,1,2
878910,0,1 user reviews,1,0,1
878920,7,Positive,25,0,25
878950,7,Positive,13,2,15
878980,0,2 user reviews,2,0,2
879000,6,Mostly Positive,60,24,84
879060,0,5 user reviews,3,2,5
879090,0,2 user reviews,1,1,2
879100,0,1 user reviews,1,0,1
879110,0,1 user reviews,1,0,1
879120,0,4 user reviews,2,2,4
879160,5,Mixed,974,498,1472
879200,0,3 user reviews,2,1,3
879240,5,Mixed,17,18,35
879260,0,2 user reviews,2,0,2
879270,0,3 user reviews,3,0,3
879280,0,2 user reviews,1,1,2
879290,7,Positive,11,0,11
879310,0,8 user reviews,4,4,8
879420,5,Mixed,613,288,901
879430,0,3 user reviews,3,0,3
879470,5,Mixed,23,12,35
879510,8,Very Positive,174,9,183
879520,0,4 user reviews,4,0,4
879600,0,5 user reviews,5,0,5
879610,5,Mixed,5,5,10
879620,0,7 user reviews,2,5,7
879660,0,2 user reviews,2,0,2
879670,5,Mixed,18,27,45
879732,0,1 user reviews,1,0,1
879733,0,2 user reviews,2,0,2
879740,0,9 user reviews,8,1,9
880130,7,Positive,36,1,37
880200,0,6 user reviews,2,4,6
880220,0,2 user reviews,1,1,2
880240,0,1 user reviews,1,0,1
880250,0,3 user reviews,3,0,3
880281,7,Positive,29,0,29
880282,0,6 user reviews,6,0,6
880300,6,Mostly Positive,14,6,20
880310,0,6 user reviews,3,3,6
880320,0,1 user reviews,1,0,1
880340,0,2 user reviews,2,0,2
880370,0,4 user reviews,3,1,4
880380,5,Mixed,60,51,111
880400,7,Positive,33,2,35
880470,5,Mixed,8,8,16
880490,7,Positive,34,3,37
880510,8,Very Positive,246,35,281
880520,7,Positive,10,2,12
880521,6,Mostly Positive,16,5,21
880550,0,5 user reviews,4,1,5
880570,0,3 user reviews,3,0,3
880580,8,Very Positive,58,9,67
880610,7,Positive,26,1,27
880620,0,3 user reviews,0,3,3
880640,6,Mostly Positive,206,71,277
880720,0,5 user reviews,5,0,5
880740,0,2 user reviews,2,0,2
880750,5,Mixed,10,12,22
880780,0,6 user reviews,5,1,6
880800,0,5 user reviews,3,2,5
880830,7,Positive,12,1,13
880860,0,9 user reviews,6,3,9
880923,0,1 user reviews,0,1,1
880924,0,1 user reviews,1,0,1
880940,8,Very Positive,5406,559,5965
880950,7,Positive,20,1,21
880990,0,5 user reviews,0,5,5
881040,7,Positive,15,0,15
881050,0,1 user reviews,0,1,1
881060,0,2 user reviews,2,0,2
881080,0,3 user reviews,1,2,3
881090,0,1 user reviews,1,0,1
881100,9,Overwhelmingly Positive,10346,441,10787
881110,0,5 user reviews,4,1,5
881130,7,Positive,24,0,24
881170,0,4 user reviews,2,2,4
881190,0,1 user reviews,1,0,1
881260,0,3 user reviews,3,0,3
881310,0,3 user reviews,2,1,3
881320,5,Mixed,86,42,128
881330,0,2 user reviews,2,0,2
881390,0,4 user reviews,3,1,4
881420,8,Very Positive,179,35,214
881470,0,2 user reviews,2,0,2
881480,7,Positive,11,1,12
881500,5,Mixed,7,4,11
881510,0,4 user reviews,2,2,4
881520,0,7 user reviews,4,3,7
881560,8,Very Positive,181,29,210
881610,0,7 user reviews,1,6,7
881620,0,1 user reviews,1,0,1
881660,0,1 user reviews,1,0,1
881670,0,3 user reviews,2,1,3
881680,6,Mostly Positive,30,10,40
881690,6,Mostly Positive,118,45,163
881730,0,3 user reviews,2,1,3
881750,5,Mixed,9,4,13
881880,0,8 user reviews,3,5,8
881910,0,1 user reviews,0,1,1
881920,5,Mixed,65,28,93
881930,0,5 user reviews,1,4,5
881960,0,1 user reviews,1,0,1
882020,6,Mostly Positive,167,45,212
882040,7,Positive,17,3,20
882070,0,6 user reviews,4,2,6
882080,0,3 user reviews,2,1,3
882100,6,Mostly Positive,6855,2151,9006
882140,8,Very Positive,185,7,192
882150,7,Positive,34,1,35
882200,5,Mixed,5,6,11
882210,7,Positive,19,3,22
882230,0,1 user reviews,1,0,1
882250,8,Very Positive,60,11,71
882270,0,2 user reviews,2,0,2
882290,0,3 user reviews,2,1,3
882330,0,3 user reviews,1,2,3
882390,0,1 user reviews,1,0,1
882460,0,4 user reviews,1,3,4
882560,5,Mixed,28,23,51
882600,0,1 user reviews,1,0,1
882620,0,4 user reviews,4,0,4
882630,0,1 user reviews,1,0,1
882640,7,Positive,17,2,19
882670,0,2 user reviews,2,0,2
882680,7,Positive,10,1,11
882700,0,1 user reviews,1,0,1
882710,8,Very Positive,142,10,152
882750,0,1 user reviews,1,0,1
882760,0,2 user reviews,1,1,2
882790,8,Very Positive,123,5,128
882800,0,1 user reviews,0,1,1
882840,0,2 user reviews,1,1,2
882900,0,9 user reviews,8,1,9
882910,0,6 user reviews,0,6,6
882940,6,Mostly Positive,8,3,11
882960,5,Mixed,10,6,16
883000,0,5 user reviews,2,3,5
883020,7,Positive,10,1,11
883070,7,Positive,40,9,49
883080,7,Positive,36,9,45
883100,8,Very Positive,210,22,232
883130,8,Very Positive,111,17,128
883140,5,Mixed,41,20,61
883150,5,Mixed,224,149,373
883170,0,6 user reviews,2,4,6
883190,0,3 user reviews,3,0,3
883200,0,1 user reviews,1,0,1
883220,5,Mixed,49,25,74
883300,0,6 user reviews,4,2,6
883310,0,4 user reviews,3,1,4
883330,0,5 user reviews,3,2,5
883360,8,Very Positive,175,38,213
883390,0,3 user reviews,2,1,3
883560,0,4 user reviews,4,0,4
883630,0,2 user reviews,2,0,2
883670,5,Mixed,14,10,24
883680,0,1 user reviews,1,0,1
883710,9,Overwhelmingly Positive,19091,514,19605
883790,0,3 user reviews,2,1,3
883800,0,1 user reviews,1,0,1
883810,0,1 user reviews,1,0,1
883830,0,4 user reviews,3,1,4
883930,0,2 user reviews,1,1,2
883960,0,1 user reviews,0,1,1
883970,0,6 user reviews,0,6,6
884000,0,8 user reviews,2,6,8
884030,0,1 user reviews,1,0,1
884080,0,1 user reviews,1,0,1
884140,7,Positive,16,1,17
884141,6,Mostly Positive,33,11,44
884142,7,Positive,11,1,12
884143,6,Mostly Positive,16,5,21
884200,5,Mixed,26,15,41
884260,9,Overwhelmingly Positive,644,23,667
884270,0,2 user reviews,2,0,2
884290,0,4 user reviews,2,2,4
884320,5,Mixed,63,51,114
884340,5,Mixed,15,11,26
884370,0,4 user reviews,3,1,4
884390,0,5 user reviews,1,4,5
884400,7,Positive,10,0,10
884410,5,Mixed,6,4,10
884420,7,Positive,14,1,15
884430,5,Mixed,5,6,11
884440,0,3 user reviews,1,2,3
884460,0,3 user reviews,2,1,3
884470,0,3 user reviews,3,0,3
884500,0,2 user reviews,0,2,2
884530,0,6 user reviews,0,6,6
884590,0,3 user reviews,0,3,3
884620,5,Mixed,47,53,100
884630,0,2 user reviews,2,0,2
884640,5,Mixed,11,11,22
884660,0,2 user reviews,2,0,2
884710,0,1 user reviews,1,0,1
884760,0,3 user reviews,3,0,3
884761,0,2 user reviews,2,0,2
884762,0,2 user reviews,2,0,2
884770,0,4 user reviews,2,2,4
884790,0,1 user reviews,1,0,1
884860,0,2 user reviews,2,0,2
884870,0,3 user reviews,2,1,3
884880,0,6 user reviews,5,1,6
884900,0,1 user reviews,0,1,1
884960,7,Positive,20,2,22
884980,7,Positive,16,0,16
884990,6,Mostly Positive,38,10,48
885000,8,Very Positive,267,19,286
885090,0,9 user reviews,1,8,9
885100,4,Mostly Negative,7,14,21
885110,4,Mostly Negative,4,7,11
885120,7,Positive,41,5,46
885140,0,3 user reviews,1,2,3
885150,8,Very Positive,140,19,159
885170,0,2 user reviews,0,2,2
885180,0,4 user reviews,1,3,4
885190,5,Mixed,9,6,15
885220,0,1 user reviews,1,0,1
885240,0,3 user reviews,2,1,3
885250,0,1 user reviews,1,0,1
885260,0,2 user reviews,2,0,2
885270,5,Mixed,25,14,39
885290,0,4 user reviews,3,1,4
885320,0,5 user reviews,1,4,5
885380,5,Mixed,7,7,14
885390,4,Mostly Negative,6,12,18
885430,0,1 user reviews,1,0,1
885440,6,Mostly Positive,31,10,41
885550,7,Positive,29,4,33
885570,0,3 user reviews,2,1,3
885630,6,Mostly Positive,7,3,10
885660,0,2 user reviews,1,1,2
885780,7,Positive,21,5,26
885790,0,4 user reviews,3,1,4
885810,8,Very Positive,201,5,206
885910,7,Positive,11,0,11
885920,0,2 user reviews,2,0,2
885940,8,Very Positive,66,5,71
885950,8,Very Positive,64,2,66
885960,7,Positive,15,1,16
886010,0,4 user reviews,2,2,4
886020,0,3 user reviews,0,3,3
886040,6,Mostly Positive,90,25,115
886070,7,Positive,35,4,39
886110,7,Positive,11,1,12
886120,0,7 user reviews,3,4,7
886140,0,1 user reviews,1,0,1
886180,6,Mostly Positive,9,3,12
886200,7,Positive,32,0,32
886230,0,3 user reviews,0,3,3
886270,5,Mixed,7,5,12
886280,5,Mixed,5,5,10
886290,0,1 user reviews,1,0,1
886300,0,3 user reviews,3,0,3
886310,0,2 user reviews,0,2,2
886330,0,2 user reviews,1,1,2
886350,0,4 user reviews,3,1,4
886360,7,Positive,9,1,10
886370,5,Mixed,14,12,26
886380,0,4 user reviews,4,0,4
886390,0,1 user reviews,1,0,1
886420,0,1 user reviews,0,1,1
886450,0,1 user reviews,0,1,1
886470,0,7 user reviews,7,0,7
886480,0,1 user reviews,1,0,1
886490,0,5 user reviews,2,3,5
886520,4,Mostly Negative,14,23,37
886590,0,4 user reviews,3,1,4
886600,0,4 user reviews,3,1,4
886610,0,2 user reviews,0,2,2
886630,7,Positive,11,1,12
886670,0,3 user reviews,3,0,3
886710,5,Mixed,13,18,31
886730,5,Mixed,7,7,14
886780,0,2 user reviews,1,1,2
886820,6,Mostly Positive,30,10,40
886830,0,1 user reviews,1,0,1
886900,6,Mostly Positive,316,101,417
886920,5,Mixed,12,7,19
886930,7,Positive,22,0,22
886950,0,6 user reviews,5,1,6
886960,8,Very Positive,105,25,130
886970,7,Positive,16,4,20
887030,0,3 user reviews,2,1,3
887050,0,6 user reviews,5,1,6
887060,6,Mostly Positive,75,22,97
887090,5,Mixed,18,9,27
887120,5,Mixed,34,15,49
887160,0,1 user reviews,1,0,1
887300,0,3 user reviews,3,0,3
887340,6,Mostly Positive,40,14,54
887370,5,Mixed,72,32,104
887380,5,Mixed,467,369,836
887400,7,Positive,14,0,14
887420,7,Positive,13,1,14
887510,7,Positive,16,0,16
887520,0,5 user reviews,3,2,5
887530,8,Very Positive,51,12,63
887550,7,Positive,11,1,12
887660,0,3 user reviews,2,1,3
887690,0,5 user reviews,2,3,5
887710,0,3 user reviews,2,1,3
887720,5,Mixed,57,44,101
887730,6,Mostly Positive,15,5,20
887750,0,1 user reviews,1,0,1
887780,6,Mostly Positive,10,4,14
887800,5,Mixed,123,76,199
887820,6,Mostly Positive,14,6,20
887850,0,8 user reviews,7,1,8
887890,0,6 user reviews,6,0,6
887900,7,Positive,12,1,13
887910,0,2 user reviews,1,1,2
887930,0,2 user reviews,2,0,2
887940,0,1 user reviews,1,0,1
887950,0,1 user reviews,1,0,1
887960,0,9 user reviews,4,5,9
887970,6,Mostly Positive,7,3,10
888000,7,Positive,16,0,16
888010,6,Mostly Positive,15,4,19
888040,8,Very Positive,116,11,127
888130,6,Mostly Positive,27,8,35
888210,0,2 user reviews,2,0,2
888220,0,4 user reviews,4,0,4
888240,0,4 user reviews,3,1,4
888250,0,1 user reviews,0,1,1
888260,8,Very Positive,95,10,105
888310,0,2 user reviews,2,0,2
888360,0,5 user reviews,5,0,5
888370,0,9 user reviews,7,2,9
888380,0,2 user reviews,1,1,2
888400,0,3 user reviews,0,3,3
888514,0,1 user reviews,1,0,1
888515,0,1 user reviews,0,1,1
888560,0,1 user reviews,0,1,1
888570,0,1 user reviews,1,0,1
888610,0,8 user reviews,4,4,8
888620,0,1 user reviews,0,1,1
888630,7,Positive,41,3,44
888640,0,1 user reviews,1,0,1
888650,6,Mostly Positive,53,16,69
888690,5,Mixed,6,6,12
888701,7,Positive,10,2,12
888710,0,3 user reviews,2,1,3
888740,0,1 user reviews,0,1,1
888750,0,1 user reviews,1,0,1
888770,5,Mixed,327,472,799
888790,8,Very Positive,237,8,245
888810,0,5 user reviews,1,4,5
888820,0,5 user reviews,4,1,5
888850,0,3 user reviews,3,0,3
888851,0,5 user reviews,4,1,5
888852,0,8 user reviews,5,3,8
888853,0,3 user reviews,3,0,3
888854,0,6 user reviews,4,2,6
888855,5,Mixed,9,5,14
888856,0,2 user reviews,2,0,2
888857,0,3 user reviews,3,0,3
888858,0,5 user reviews,4,1,5
888859,0,1 user reviews,0,1,1
888870,0,8 user reviews,2,6,8
888872,5,Mixed,12,6,18
888880,0,1 user reviews,0,1,1
888900,0,4 user reviews,4,0,4
888970,0,7 user reviews,2,5,7
888990,7,Positive,11,0,11
889030,0,3 user reviews,3,0,3
889040,6,Mostly Positive,74,25,99
889070,0,1 user reviews,1,0,1
889080,8,Very Positive,162,13,175
889100,0,1 user reviews,1,0,1
889120,0,1 user reviews,1,0,1
889150,0,1 user reviews,1,0,1
889170,7,Positive,20,5,25
889260,0,9 user reviews,9,0,9
889280,7,Positive,9,1,10
889290,0,1 user reviews,1,0,1
889330,0,2 user reviews,1,1,2
889340,5,Mixed,6,5,11
889380,0,2 user reviews,1,1,2
889400,7,Positive,11,0,11
889440,0,1 user reviews,1,0,1
889450,0,3 user reviews,3,0,3
889460,0,8 user reviews,5,3,8
889470,0,3 user reviews,1,2,3
889480,8,Very Positive,333,22,355
889510,8,Very Positive,330,23,353
889520,7,Positive,22,3,25
889600,6,Mostly Positive,73,22,95
889630,0,2 user reviews,1,1,2
889640,0,1 user reviews,1,0,1
889700,7,Positive,29,2,31
889710,7,Positive,30,5,35
889720,5,Mixed,7,5,12
889760,0,1 user reviews,0,1,1
889770,8,Very Positive,47,9,56
889790,0,3 user reviews,2,1,3
889800,0,5 user reviews,5,0,5
889820,7,Positive,33,1,34
889890,6,Mostly Positive,29,10,39
889902,5,Mixed,20,18,38
889903,5,Mixed,27,16,43
889920,8,Very Positive,345,67,412
889921,6,Mostly Positive,204,64,268
889970,0,3 user reviews,0,3,3
889990,0,2 user reviews,0,2,2
890130,0,3 user reviews,3,0,3
890180,5,Mixed,13,12,25
890210,0,1 user reviews,0,1,1
890220,7,Positive,22,4,26
890250,0,6 user reviews,4,2,6
890280,7,Positive,14,3,17
890290,0,8 user reviews,5,3,8
890310,7,Positive,18,0,18
890340,0,7 user reviews,7,0,7
890420,0,1 user reviews,1,0,1
890480,0,6 user reviews,4,2,6
890500,5,Mixed,16,8,24
890520,7,Positive,21,3,24
890570,5,Mixed,80,38,118
890590,0,6 user reviews,6,0,6
890630,0,1 user reviews,1,0,1
890640,0,5 user reviews,3,2,5
890680,0,1 user reviews,0,1,1
890700,7,Positive,12,1,13
890710,6,Mostly Positive,12,4,16
890720,8,Very Positive,238,13,251
890740,0,5 user reviews,4,1,5
890750,8,Very Positive,52,0,52
890800,0,1 user reviews,1,0,1
890900,0,1 user reviews,1,0,1
890910,0,1 user reviews,1,0,1
890940,5,Mixed,9,4,13
890970,8,Very Positive,83,17,100
891050,0,3 user reviews,2,1,3
891090,0,4 user reviews,1,3,4
891100,0,7 user reviews,3,4,7
891110,0,4 user reviews,4,0,4
891120,0,5 user reviews,2,3,5
891220,0,1 user reviews,1,0,1
891230,6,Mostly Positive,23,7,30
891240,5,Mixed,6,4,10
891260,0,1 user reviews,1,0,1
891270,0,6 user reviews,2,4,6
891290,0,1 user reviews,1,0,1
891300,5,Mixed,10,5,15
891301,5,Mixed,18,14,32
891302,5,Mixed,7,10,17
891310,0,8 user reviews,3,5,8
891320,0,6 user reviews,4,2,6
891330,0,1 user reviews,0,1,1
891340,0,2 user reviews,2,0,2
891350,0,6 user reviews,5,1,6
891370,8,Very Positive,86,13,99
891380,0,2 user reviews,1,1,2
891420,5,Mixed,15,7,22
891470,0,1 user reviews,0,1,1
891480,0,1 user reviews,1,0,1
891490,0,8 user reviews,6,2,8
891510,8,Very Positive,51,4,55
891700,0,5 user reviews,2,3,5
891710,0,3 user reviews,3,0,3
891720,0,8 user reviews,6,2,8
891730,5,Mixed,54,34,88
891790,6,Mostly Positive,37,13,50
891810,5,Mixed,52,26,78
891850,0,2 user reviews,2,0,2
891870,6,Mostly Positive,7,3,10
891990,0,1 user reviews,1,0,1
892020,0,3 user reviews,2,1,3
892030,0,7 user reviews,5,2,7
892040,0,7 user reviews,5,2,7
892050,0,1 user reviews,1,0,1
892130,0,3 user reviews,1,2,3
892160,0,3 user reviews,3,0,3
892180,0,2 user reviews,2,0,2
892210,0,3 user reviews,2,1,3
892250,0,2 user reviews,2,0,2
892291,0,1 user reviews,1,0,1
892310,0,3 user reviews,2,1,3
892380,6,Mostly Positive,20,6,26
892397,0,1 user reviews,1,0,1
892398,0,1 user reviews,1,0,1
892400,7,Positive,21,0,21
892420,0,8 user reviews,6,2,8
892440,0,8 user reviews,5,3,8
892470,0,8 user reviews,8,0,8
892490,0,2 user reviews,2,0,2
892510,0,5 user reviews,3,2,5
892550,7,Positive,12,3,15
892580,0,4 user reviews,4,0,4
892630,0,1 user reviews,0,1,1
892640,0,2 user reviews,2,0,2
892650,5,Mixed,9,5,14
892690,7,Positive,36,5,41
892760,7,Positive,23,2,25
892780,7,Positive,15,3,18
892810,0,9 user reviews,7,2,9
892830,0,4 user reviews,4,0,4
892880,0,6 user reviews,6,0,6
892910,0,3 user reviews,2,1,3
892930,0,5 user reviews,3,2,5
892942,0,1 user reviews,1,0,1
892980,7,Positive,9,1,10
892990,7,Positive,20,0,20
893001,0,3 user reviews,1,2,3
893010,6,Mostly Positive,41,15,56
893020,5,Mixed,23,10,33
893030,8,Very Positive,508,121,629
893040,4,Mostly Negative,5,9,14
893050,7,Positive,29,3,32
893060,0,8 user reviews,2,6,8
893070,5,Mixed,5,7,12
893090,0,4 user reviews,2,2,4
893140,0,2 user reviews,1,1,2
893180,8,Very Positive,1759,149,1908
893320,0,1 user reviews,0,1,1
893321,0,2 user reviews,2,0,2
893330,5,Mixed,13,10,23
893420,7,Positive,10,0,10
893450,0,3 user reviews,2,1,3
893460,0,4 user reviews,1,3,4
893470,7,Positive,12,0,12
893500,5,Mixed,7,5,12
893510,0,8 user reviews,3,5,8
893520,5,Mixed,152,72,224
893590,0,2 user reviews,0,2,2
893610,7,Positive,34,4,38
893620,7,Positive,11,1,12
893630,0,2 user reviews,2,0,2
893650,0,4 user reviews,1,3,4
893680,8,Very Positive,942,95,1037
893690,8,Very Positive,52,3,55
893710,0,2 user reviews,2,0,2
893740,0,5 user reviews,5,0,5
893760,0,8 user reviews,8,0,8
893770,7,Positive,34,1,35
893790,8,Very Positive,150,6,156
893800,0,2 user reviews,2,0,2
893840,7,Positive,29,1,30
893850,8,Very Positive,799,73,872
893870,5,Mixed,19,14,33
893900,0,3 user reviews,3,0,3
893940,0,1 user reviews,1,0,1
893950,7,Positive,15,2,17
893960,0,4 user reviews,1,3,4
893980,0,1 user reviews,0,1,1
893981,0,1 user reviews,0,1,1
894000,7,Positive,15,1,16
894010,0,3 user reviews,2,1,3
894070,0,4 user reviews,3,1,4
894080,0,1 user reviews,1,0,1
894120,0,2 user reviews,2,0,2
894160,0,2 user reviews,2,0,2
894270,6,Mostly Positive,21,7,28
894310,0,6 user reviews,6,0,6
894330,0,7 user reviews,5,2,7
894340,0,3 user reviews,3,0,3
894390,5,Mixed,13,6,19
894420,7,Positive,15,0,15
894430,0,7 user reviews,7,0,7
894460,8,Very Positive,56,3,59
894500,0,1 user reviews,1,0,1
894540,6,Mostly Positive,12,5,17
894570,0,3 user reviews,3,0,3
894600,5,Mixed,124,101,225
894610,0,2 user reviews,1,1,2
894630,8,Very Positive,139,30,169
894670,0,5 user reviews,5,0,5
894690,0,5 user reviews,5,0,5
894700,0,8 user reviews,8,0,8
894710,0,9 user reviews,9,0,9
894720,0,2 user reviews,2,0,2
894730,0,6 user reviews,3,3,6
894740,0,4 user reviews,3,1,4
894750,0,4 user reviews,2,2,4
894790,0,1 user reviews,1,0,1
894900,0,6 user reviews,2,4,6
894930,0,2 user reviews,0,2,2
894940,9,Overwhelmingly Positive,1835,87,1922
894950,0,3 user reviews,2,1,3
894970,0,4 user reviews,3,1,4
894980,0,1 user reviews,1,0,1
895000,0,4 user reviews,4,0,4
895040,5,Mixed,50,26,76
895060,4,Mostly Negative,13,21,34
895070,0,1 user reviews,1,0,1
895120,0,4 user reviews,2,2,4
895140,7,Positive,8,2,10
895170,0,3 user reviews,3,0,3
895180,0,2 user reviews,2,0,2
895200,5,Mixed,43,37,80
895220,0,5 user reviews,4,1,5
895260,0,1 user reviews,1,0,1
895270,0,1 user reviews,1,0,1
895280,0,1 user reviews,1,0,1
895300,0,1 user reviews,1,0,1
895330,0,6 user reviews,6,0,6
895370,0,3 user reviews,2,1,3
895400,6,Mostly Positive,5192,1341,6533
895420,7,Positive,28,2,30
895440,0,4 user reviews,3,1,4
895450,0,1 user reviews,1,0,1
895470,6,Mostly Positive,14,5,19
895480,8,Very Positive,53,5,58
895490,5,Mixed,50,28,78
895491,6,Mostly Positive,47,17,64
895492,5,Mixed,48,67,115
895493,5,Mixed,41,23,64
895570,0,1 user reviews,0,1,1
895580,0,5 user reviews,0,5,5
895600,7,Positive,24,3,27
895610,0,5 user reviews,5,0,5
895620,6,Mostly Positive,110,36,146
895690,7,Positive,28,6,34
895710,0,2 user reviews,1,1,2
895720,0,7 user reviews,7,0,7
895740,0,3 user reviews,2,1,3
895750,6,Mostly Positive,7,3,10
895800,0,3 user reviews,3,0,3
895820,0,4 user reviews,3,1,4
895850,0,2 user reviews,2,0,2
895860,0,2 user reviews,2,0,2
895890,0,4 user reviews,3,1,4
895930,0,1 user reviews,1,0,1
895940,0,2 user reviews,1,1,2
895950,0,7 user reviews,4,3,7
895960,0,1 user reviews,0,1,1
896000,0,4 user reviews,4,0,4
896030,5,Mixed,6,6,12
896070,0,6 user reviews,4,2,6
896110,0,2 user reviews,2,0,2
896160,6,Mostly Positive,331,122,453
896180,0,5 user reviews,3,2,5
896190,0,1 user reviews,1,0,1
896230,0,2 user reviews,0,2,2
896240,0,2 user reviews,0,2,2
896340,7,Positive,21,5,26
896350,0,1 user reviews,1,0,1
896370,0,3 user reviews,3,0,3
896380,0,6 user reviews,3,3,6
896400,0,6 user reviews,6,0,6
896420,0,2 user reviews,1,1,2
896440,5,Mixed,25,17,42
896460,8,Very Positive,160,6,166
896500,0,2 user reviews,2,0,2
896510,5,Mixed,9,6,15
896550,7,Positive,14,0,14
896570,0,6 user reviews,4,2,6
896640,7,Positive,10,0,10
896650,0,3 user reviews,2,1,3
896670,0,1 user reviews,1,0,1
896680,5,Mixed,10,11,21
896700,0,3 user reviews,2,1,3
896712,0,2 user reviews,2,0,2
896713,6,Mostly Positive,10,4,14
896715,7,Positive,19,4,23
896716,0,1 user reviews,0,1,1
896717,5,Mixed,12,10,22
896718,0,9 user reviews,4,5,9
896719,7,Positive,18,2,20
896730,0,1 user reviews,1,0,1
896741,0,5 user reviews,3,2,5
896742,0,4 user reviews,3,1,4
896743,0,4 user reviews,4,0,4
896744,0,8 user reviews,7,1,8
896745,0,6 user reviews,4,2,6
896746,0,5 user reviews,3,2,5
896747,0,6 user reviews,3,3,6
896748,5,Mixed,6,5,11
896749,0,2 user reviews,0,2,2
896750,8,Very Positive,58,12,70
896761,0,1 user reviews,1,0,1
896764,0,2 user reviews,2,0,2
896765,0,2 user reviews,2,0,2
896766,0,1 user reviews,1,0,1
896767,0,2 user reviews,1,1,2
896780,0,2 user reviews,2,0,2
896830,0,1 user reviews,1,0,1
896850,0,3 user reviews,1,2,3
896860,0,2 user reviews,0,2,2
896880,5,Mixed,6,4,10
896890,8,Very Positive,238,24,262
896950,0,7 user reviews,4,3,7
896960,6,Mostly Positive,20,7,27
896970,0,4 user reviews,3,1,4
896990,0,4 user reviews,1,3,4
897000,0,1 user reviews,1,0,1
897010,0,1 user reviews,1,0,1
897020,0,5 user reviews,4,1,5
897030,8,Very Positive,401,81,482
897040,5,Mixed,23,14,37
897100,0,4 user reviews,3,1,4
897180,0,2 user reviews,2,0,2
897190,0,1 user reviews,1,0,1
897220,8,Very Positive,232,5,237
897230,0,1 user reviews,1,0,1
897240,0,1 user reviews,1,0,1
897250,0,1 user reviews,1,0,1
897280,0,2 user reviews,1,1,2
897300,5,Mixed,12,8,20
897330,7,Positive,14,0,14
897360,0,1 user reviews,1,0,1
897390,0,2 user reviews,1,1,2
897400,0,4 user reviews,1,3,4
897410,5,Mixed,103,76,179
897420,0,3 user reviews,2,1,3
897440,5,Mixed,23,13,36
897450,5,Mixed,192,137,329
897550,0,6 user reviews,1,5,6
897560,0,1 user reviews,1,0,1
897630,5,Mixed,11,7,18
897640,6,Mostly Positive,15,4,19
897670,8,Very Positive,350,50,400
897690,7,Positive,38,0,38
897700,0,7 user reviews,4,3,7
897760,7,Positive,10,0,10
897770,0,2 user reviews,1,1,2
897800,7,Positive,22,2,24
897820,6,Mostly Positive,151,61,212
897830,7,Positive,12,3,15
897840,0,1 user reviews,0,1,1
897880,0,2 user reviews,1,1,2
897900,0,3 user reviews,3,0,3
897910,0,2 user reviews,1,1,2
897920,0,1 user reviews,1,0,1
897930,8,Very Positive,81,16,97
897950,0,2 user reviews,0,2,2
898000,5,Mixed,12,16,28
898090,0,1 user reviews,1,0,1
898110,0,1 user reviews,1,0,1
898120,0,4 user reviews,2,2,4
898170,0,1 user reviews,0,1,1
898190,0,3 user reviews,3,0,3
898240,0,5 user reviews,5,0,5
898250,0,1 user reviews,1,0,1
898260,7,Positive,11,0,11
898310,0,5 user reviews,5,0,5
898320,0,1 user reviews,0,1,1
898340,0,7 user reviews,2,5,7
898380,0,4 user reviews,3,1,4
898390,5,Mixed,22,11,33
898430,0,1 user reviews,0,1,1
898440,0,4 user reviews,3,1,4
898450,8,Very Positive,69,2,71
898460,6,Mostly Positive,13,4,17
898500,0,3 user reviews,2,1,3
898530,0,5 user reviews,1,4,5
898540,0,3 user reviews,0,3,3
898580,8,Very Positive,116,6,122
898600,0,1 user reviews,0,1,1
898650,8,Very Positive,185,37,222
898690,0,2 user reviews,1,1,2
898700,5,Mixed,9,6,15
898720,6,Mostly Positive,105,27,132
898760,0,1 user reviews,1,0,1
898780,7,Positive,38,6,44
898790,7,Positive,18,0,18
898800,8,Very Positive,71,7,78
898830,0,4 user reviews,4,0,4
898910,7,Positive,11,0,11
898920,6,Mostly Positive,1225,404,1629
898930,0,3 user reviews,3,0,3
898940,0,5 user reviews,3,2,5
898960,6,Mostly Positive,16,5,21
898961,0,7 user reviews,6,1,7
898962,0,9 user reviews,3,6,9
899000,0,2 user reviews,2,0,2
899020,0,3 user reviews,2,1,3
899030,0,2 user reviews,2,0,2
899100,7,Positive,8,2,10
899130,0,5 user reviews,4,1,5
899150,0,2 user reviews,1,1,2
899180,7,Positive,20,3,23
899200,6,Mostly Positive,10,3,13
899240,0,1 user reviews,1,0,1
899270,7,Positive,18,0,18
899280,0,2 user reviews,2,0,2
899310,8,Very Positive,91,19,110
899340,7,Positive,10,0,10
899350,0,2 user reviews,1,1,2
899390,5,Mixed,98,47,145
899410,0,1 user reviews,0,1,1
899411,0,2 user reviews,1,1,2
899440,8,Very Positive,1280,153,1433
899470,7,Positive,46,3,49
899480,6,Mostly Positive,13,5,18
899540,5,Mixed,12,10,22
899570,0,4 user reviews,0,4,4
899590,0,8 user reviews,8,0,8
899630,5,Mixed,6,9,15
899760,0,3 user reviews,3,0,3
899770,8,Very Positive,1403,241,1644
899795,0,1 user reviews,1,0,1
899796,0,1 user reviews,1,0,1
899804,0,1 user reviews,1,0,1
899806,0,2 user reviews,0,2,2
899808,0,1 user reviews,1,0,1
899810,0,1 user reviews,1,0,1
899821,0,1 user reviews,1,0,1
899823,0,1 user reviews,1,0,1
899826,0,1 user reviews,1,0,1
899833,0,2 user reviews,1,1,2
899834,0,4 user reviews,3,1,4
899843,0,1 user reviews,1,0,1
899858,0,2 user reviews,2,0,2
899859,0,1 user reviews,1,0,1
899864,0,1 user reviews,0,1,1
899872,0,1 user reviews,1,0,1
899892,0,1 user reviews,1,0,1
899900,0,7 user reviews,5,2,7
899940,0,7 user reviews,6,1,7
899960,7,Positive,16,1,17
899970,9,Overwhelmingly Positive,488,17,505
899990,0,6 user reviews,0,6,6
900010,5,Mixed,171,95,266
900030,0,1 user reviews,1,0,1
900050,7,Positive,19,4,23
900090,7,Positive,19,1,20
900231,0,1 user reviews,1,0,1
900270,8,Very Positive,1284,85,1369
900290,6,Mostly Positive,16,5,21
900340,0,6 user reviews,4,2,6
900370,0,9 user reviews,6,3,9
900380,0,3 user reviews,3,0,3
900390,0,1 user reviews,1,0,1
900447,6,Mostly Positive,44,13,57
900448,5,Mixed,32,39,71
900449,6,Mostly Positive,37,15,52
900490,7,Positive,19,0,19
900530,0,1 user reviews,1,0,1
900540,0,1 user reviews,1,0,1
900550,0,2 user reviews,2,0,2
900560,0,1 user reviews,1,0,1
900610,0,1 user reviews,1,0,1
900790,7,Positive,16,2,18
900883,9,Overwhelmingly Positive,14817,669,15486
901000,0,2 user reviews,2,0,2
901020,0,2 user reviews,2,0,2
903040,6,Mostly Positive,38,12,50
903110,0,1 user reviews,1,0,1
903150,0,1 user reviews,1,0,1
903160,0,1 user reviews,1,0,1
903180,0,4 user reviews,3,1,4
903240,0,1 user reviews,0,1,1
903243,0,1 user reviews,1,0,1
903460,0,3 user reviews,3,0,3
903580,0,6 user reviews,6,0,6
903610,0,1 user reviews,1,0,1
903620,0,7 user reviews,3,4,7
903670,0,6 user reviews,1,5,6
903680,0,1 user reviews,1,0,1
903710,5,Mixed,12,8,20
903740,0,9 user reviews,3,6,9
903770,0,1 user reviews,1,0,1
903771,0,2 user reviews,2,0,2
903772,0,2 user reviews,0,2,2
903780,0,6 user reviews,5,1,6
903830,5,Mixed,13,7,20
903850,0,5 user reviews,5,0,5
903860,0,2 user reviews,2,0,2
903880,0,6 user reviews,2,4,6
903910,0,5 user reviews,5,0,5
903950,6,Mostly Positive,6930,2045,8975
904050,0,5 user reviews,2,3,5
904120,0,2 user reviews,1,1,2
904122,0,1 user reviews,1,0,1
904123,0,1 user reviews,1,0,1
904126,0,1 user reviews,1,0,1
904130,7,Positive,22,3,25
904160,0,7 user reviews,5,2,7
904170,0,4 user reviews,2,2,4
904260,0,5 user reviews,5,0,5
904310,6,Mostly Positive,25,9,34
904320,0,1 user reviews,1,0,1
904340,0,2 user reviews,1,1,2
904360,8,Very Positive,102,25,127
904370,7,Positive,11,0,11
904380,6,Mostly Positive,80,32,112
904400,7,Positive,22,0,22
904430,0,2 user reviews,2,0,2
904440,5,Mixed,22,11,33
904520,6,Mostly Positive,88,26,114
904530,0,4 user reviews,4,0,4
904540,8,Very Positive,70,9,79
904550,0,1 user reviews,1,0,1
904570,8,Very Positive,56,5,61
904580,7,Positive,24,0,24
904600,5,Mixed,5,6,11
904680,0,2 user reviews,1,1,2
904770,0,2 user reviews,2,0,2
904780,5,Mixed,7,4,11
904810,0,2 user reviews,2,0,2
904860,0,5 user reviews,2,3,5
904890,5,Mixed,6,6,12
904900,5,Mixed,24,12,36
904930,0,2 user reviews,1,1,2
904950,0,2 user reviews,0,2,2
904960,6,Mostly Positive,95,33,128
904990,5,Mixed,7,5,12
905020,0,2 user reviews,1,1,2
905050,7,Positive,10,2,12
905060,0,8 user reviews,2,6,8
905070,0,4 user reviews,4,0,4
905090,5,Mixed,7,9,16
905120,0,1 user reviews,1,0,1
905130,0,2 user reviews,2,0,2
905150,0,8 user reviews,4,4,8
905210,0,1 user reviews,1,0,1
905220,0,4 user reviews,4,0,4
905270,0,1 user reviews,0,1,1
905300,0,5 user reviews,1,4,5
905330,0,2 user reviews,2,0,2
905340,8,Very Positive,473,17,490
905350,0,4 user reviews,4,0,4
905370,5,Mixed,317,179,496
905380,0,1 user reviews,1,0,1
905450,5,Mixed,151,67,218
905490,6,Mostly Positive,69,26,95
905510,0,4 user reviews,4,0,4
905520,0,2 user reviews,0,2,2
905630,0,1 user reviews,0,1,1
905660,7,Positive,13,1,14
905682,0,5 user reviews,5,0,5
905690,0,2 user reviews,2,0,2
905704,0,2 user reviews,2,0,2
905705,0,1 user reviews,1,0,1
905790,0,2 user reviews,2,0,2
905800,0,7 user reviews,4,3,7
905860,0,1 user reviews,0,1,1
905870,0,3 user reviews,3,0,3
905880,0,6 user reviews,5,1,6
905890,0,1 user reviews,1,0,1
905960,0,1 user reviews,1,0,1
906000,5,Mixed,8,7,15
906010,0,5 user reviews,4,1,5
906020,0,2 user reviews,1,1,2
906050,6,Mostly Positive,74,27,101
906100,6,Mostly Positive,841,222,1063
906110,7,Positive,35,0,35
906120,8,Very Positive,102,8,110
906130,0,2 user reviews,1,1,2
906160,0,2 user reviews,1,1,2
906170,0,2 user reviews,1,1,2
906190,0,2 user reviews,2,0,2
906240,0,1 user reviews,0,1,1
906250,0,2 user reviews,0,2,2
906280,0,5 user reviews,5,0,5
906290,0,6 user reviews,6,0,6
906300,7,Positive,44,4,48
906310,0,2 user reviews,2,0,2
906360,0,3 user reviews,2,1,3
906370,0,5 user reviews,5,0,5
906390,7,Positive,15,1,16
906440,0,1 user reviews,1,0,1
906480,0,1 user reviews,1,0,1
906510,7,Positive,26,4,30
906560,0,1 user reviews,0,1,1
906590,7,Positive,27,4,31
906600,7,Positive,30,0,30
906630,0,1 user reviews,0,1,1
906631,0,1 user reviews,1,0,1
906636,0,1 user reviews,0,1,1
906638,0,1 user reviews,1,0,1
906650,0,3 user reviews,3,0,3
906660,0,7 user reviews,4,3,7
906680,0,7 user reviews,5,2,7
906730,7,Positive,17,2,19
906740,5,Mixed,46,20,66
906750,0,1 user reviews,0,1,1
906770,5,Mixed,8,6,14
906790,5,Mixed,23,16,39
906810,5,Mixed,7,8,15
906850,0,2 user reviews,2,0,2
906880,0,3 user reviews,3,0,3
906920,5,Mixed,5,6,11
906950,0,1 user reviews,1,0,1
907020,0,5 user reviews,3,2,5
907040,0,7 user reviews,5,2,7
907080,0,5 user reviews,4,1,5
907150,0,3 user reviews,3,0,3
907190,0,3 user reviews,3,0,3
907210,5,Mixed,18,19,37
907220,0,1 user reviews,0,1,1
907230,0,1 user reviews,1,0,1
907240,0,1 user reviews,1,0,1
907250,0,2 user reviews,1,1,2
907270,8,Very Positive,67,16,83
907280,0,5 user reviews,4,1,5
907320,0,1 user reviews,1,0,1
907350,0,3 user reviews,2,1,3
907370,8,Very Positive,192,12,204
907380,6,Mostly Positive,17,7,24
907410,0,6 user reviews,5,1,6
907420,0,1 user reviews,1,0,1
907440,5,Mixed,11,6,17
907460,0,5 user reviews,2,3,5
907470,8,Very Positive,153,26,179
907510,7,Positive,11,2,13
907540,0,2 user reviews,2,0,2
907560,0,3 user reviews,3,0,3
907590,0,5 user reviews,1,4,5
907600,0,5 user reviews,5,0,5
907620,0,8 user reviews,7,1,8
907670,7,Positive,35,0,35
907680,5,Mixed,13,8,21
907710,5,Mixed,4,6,10
907760,8,Very Positive,44,9,53
907770,6,Mostly Positive,27,11,38
907820,7,Positive,42,5,47
907870,0,2 user reviews,1,1,2
907880,0,1 user reviews,1,0,1
907881,0,3 user reviews,3,0,3
907890,0,4 user reviews,3,1,4
907900,0,2 user reviews,2,0,2
907950,0,7 user reviews,5,2,7
907970,0,4 user reviews,2,2,4
908010,0,1 user reviews,1,0,1
908020,0,2 user reviews,2,0,2
908030,0,1 user reviews,0,1,1
908050,6,Mostly Positive,19,8,27
908070,8,Very Positive,131,16,147
908090,0,2 user reviews,0,2,2
908120,0,1 user reviews,1,0,1
908130,0,6 user reviews,6,0,6
908150,0,1 user reviews,1,0,1
908180,7,Positive,8,2,10
908210,5,Mixed,14,8,22
908211,0,6 user reviews,5,1,6
908212,0,3 user reviews,1,2,3
908213,0,7 user reviews,7,0,7
908221,0,1 user reviews,1,0,1
908222,0,1 user reviews,1,0,1
908223,0,1 user reviews,1,0,1
908224,0,1 user reviews,1,0,1
908225,0,1 user reviews,1,0,1
908230,0,4 user reviews,1,3,4
908260,0,1 user reviews,1,0,1
908290,0,1 user reviews,1,0,1
908310,0,4 user reviews,2,2,4
908350,0,2 user reviews,2,0,2
908400,0,1 user reviews,1,0,1
908460,0,5 user reviews,4,1,5
908471,0,1 user reviews,1,0,1
908472,0,1 user reviews,1,0,1
908473,0,1 user reviews,1,0,1
908474,0,2 user reviews,1,1,2
908520,9,Overwhelmingly Positive,530,8,538
908560,0,4 user reviews,4,0,4
908620,0,1 user reviews,1,0,1
908710,0,3 user reviews,2,1,3
908740,5,Mixed,19,18,37
908750,0,3 user reviews,3,0,3
908790,6,Mostly Positive,25,7,32
908830,0,1 user reviews,1,0,1
908840,0,1 user reviews,1,0,1
908920,0,1 user reviews,0,1,1
908950,0,2 user reviews,0,2,2
908990,7,Positive,13,1,14
909000,5,Mixed,21,20,41
909010,0,4 user reviews,4,0,4
909050,0,6 user reviews,2,4,6
909080,8,Very Positive,83,2,85
909150,7,Positive,43,2,45
909200,0,1 user reviews,1,0,1
909220,7,Positive,9,1,10
909270,0,3 user reviews,2,1,3
909320,8,Very Positive,192,37,229
909330,0,1 user reviews,1,0,1
909420,0,1 user reviews,0,1,1
909460,0,1 user reviews,1,0,1
909480,0,5 user reviews,3,2,5
909490,0,1 user reviews,1,0,1
909510,8,Very Positive,158,37,195
909570,6,Mostly Positive,17,5,22
909580,5,Mixed,4,6,10
909610,7,Positive,28,0,28
909630,5,Mixed,7,5,12
909640,7,Positive,16,0,16
909660,8,Very Positive,86,13,99
909670,7,Positive,11,2,13
909720,6,Mostly Positive,37,14,51
909770,0,1 user reviews,1,0,1
909780,6,Mostly Positive,15,6,21
909820,8,Very Positive,87,5,92
909830,0,9 user reviews,5,4,9
909850,0,4 user reviews,0,4,4
909851,0,6 user reviews,6,0,6
909970,4,Mostly Negative,30,71,101
910150,0,6 user reviews,4,2,6
910200,0,3 user reviews,1,2,3
910220,0,3 user reviews,1,2,3
910250,0,4 user reviews,2,2,4
910280,0,1 user reviews,1,0,1
910290,0,1 user reviews,0,1,1
910370,5,Mixed,5,7,12
910380,0,3 user reviews,3,0,3
910390,0,1 user reviews,1,0,1
910400,0,2 user reviews,1,1,2
910430,0,9 user reviews,3,6,9
910450,5,Mixed,45,41,86
910470,0,7 user reviews,7,0,7
910490,5,Mixed,468,226,694
910530,0,4 user reviews,2,2,4
910540,0,5 user reviews,4,1,5
910590,0,3 user reviews,1,2,3
910630,8,Very Positive,195,2,197
910660,0,7 user reviews,6,1,7
910730,0,6 user reviews,6,0,6
910820,0,1 user reviews,1,0,1
910821,0,1 user reviews,1,0,1
910830,5,Mixed,105,53,158
910850,0,1 user reviews,0,1,1
910880,8,Very Positive,109,25,134
910930,0,5 user reviews,5,0,5
910940,5,Mixed,22,10,32
910990,0,5 user reviews,4,1,5
911000,0,2 user reviews,2,0,2
911010,0,1 user reviews,1,0,1
911040,5,Mixed,6,6,12
911100,0,8 user reviews,8,0,8
911120,0,9 user reviews,9,0,9
911130,0,5 user reviews,1,4,5
911180,0,4 user reviews,2,2,4
911200,0,3 user reviews,1,2,3
911210,0,4 user reviews,1,3,4
911220,8,Very Positive,56,4,60
911230,0,4 user reviews,4,0,4
911240,0,2 user reviews,2,0,2
911270,0,1 user reviews,1,0,1
911280,0,2 user reviews,0,2,2
911290,0,2 user reviews,2,0,2
911310,0,5 user reviews,5,0,5
911400,5,Mixed,556,483,1039
911420,0,4 user reviews,3,1,4
911430,6,Mostly Positive,222,80,302
911440,0,2 user reviews,1,1,2
911480,0,3 user reviews,3,0,3
911510,5,Mixed,6,8,14
911520,7,Positive,22,1,23
911550,6,Mostly Positive,75,22,97
911580,0,2 user reviews,2,0,2
911590,0,5 user reviews,2,3,5
911610,0,4 user reviews,4,0,4
911680,0,6 user reviews,5,1,6
911690,0,1 user reviews,1,0,1
911760,7,Positive,8,2,10
911840,0,5 user reviews,4,1,5
911880,0,2 user reviews,0,2,2
911920,0,2 user reviews,2,0,2
911930,5,Mixed,84,81,165
911950,0,2 user reviews,2,0,2
912020,0,3 user reviews,2,1,3
912070,0,1 user reviews,1,0,1
912110,5,Mixed,18,11,29
912120,0,1 user reviews,0,1,1
912170,7,Positive,10,1,11
912190,6,Mostly Positive,12,5,17
912270,0,8 user reviews,8,0,8
912370,6,Mostly Positive,33,11,44
912390,0,7 user reviews,7,0,7
912420,0,7 user reviews,3,4,7
912450,6,Mostly Positive,22,8,30
912460,7,Positive,29,3,32
912470,0,3 user reviews,3,0,3
912500,0,2 user reviews,2,0,2
912540,7,Positive,30,1,31
912550,7,Positive,18,2,20
912570,8,Very Positive,91,22,113
912580,0,2 user reviews,2,0,2
912590,0,2 user reviews,1,1,2
912650,0,1 user reviews,1,0,1
912660,0,9 user reviews,6,3,9
912760,0,3 user reviews,2,1,3
912790,0,2 user reviews,1,1,2
912820,0,5 user reviews,4,1,5
912831,0,3 user reviews,3,0,3
912850,0,2 user reviews,2,0,2
912900,0,3 user reviews,2,1,3
912920,7,Positive,15,0,15
912930,7,Positive,19,0,19
913000,0,1 user reviews,1,0,1
913060,8,Very Positive,196,12,208
913090,7,Positive,29,1,30
913100,0,9 user reviews,8,1,9
913110,7,Positive,27,0,27
913120,0,3 user reviews,3,0,3
913130,0,4 user reviews,4,0,4
913150,0,1 user reviews,1,0,1
913160,0,1 user reviews,1,0,1
913180,0,9 user reviews,4,5,9
913210,0,1 user reviews,1,0,1
913250,0,2 user reviews,0,2,2
913260,0,3 user reviews,2,1,3
913280,0,7 user reviews,5,2,7
913330,7,Positive,19,3,22
913340,5,Mixed,9,4,13
913350,0,1 user reviews,0,1,1
913420,0,1 user reviews,1,0,1
913440,0,4 user reviews,3,1,4
913500,0,3 user reviews,3,0,3
913550,0,2 user reviews,2,0,2
913590,7,Positive,14,2,16
913650,0,4 user reviews,3,1,4
913670,0,3 user reviews,3,0,3
913680,0,1 user reviews,1,0,1
913710,5,Mixed,17,8,25
913740,9,Overwhelmingly Positive,1842,43,1885
913750,0,8 user reviews,5,3,8
913770,0,1 user reviews,1,0,1
913780,2,Very Negative,10,43,53
913810,7,Positive,21,0,21
913820,5,Mixed,8,12,20
913830,0,6 user reviews,4,2,6
913840,0,4 user reviews,4,0,4
913850,6,Mostly Positive,27,11,38
913890,6,Mostly Positive,48,20,68
913910,0,1 user reviews,0,1,1
913930,0,1 user reviews,1,0,1
913970,0,3 user reviews,3,0,3
914000,7,Positive,16,4,20
914010,8,Very Positive,380,74,454
914020,8,Very Positive,331,41,372
914060,0,1 user reviews,1,0,1
914070,0,5 user reviews,1,4,5
914080,7,Positive,8,2,10
914090,0,5 user reviews,3,2,5
914110,5,Mixed,23,22,45
914130,0,6 user reviews,1,5,6
914140,5,Mixed,24,18,42
914160,4,Mostly Negative,5,10,15
914170,6,Mostly Positive,54,14,68
914180,5,Mixed,12,14,26
914190,0,3 user reviews,3,0,3
914200,0,5 user reviews,2,3,5
914220,0,4 user reviews,2,2,4
914230,0,2 user reviews,1,1,2
914260,8,Very Positive,453,81,534
914280,0,4 user reviews,4,0,4
914290,8,Very Positive,86,18,104
914310,0,2 user reviews,2,0,2
914340,0,2 user reviews,1,1,2
914350,0,1 user reviews,1,0,1
914400,7,Positive,22,4,26
914420,0,1 user reviews,1,0,1
914440,0,1 user reviews,1,0,1
914480,0,1 user reviews,1,0,1
914500,0,6 user reviews,3,3,6
914540,0,2 user reviews,2,0,2
914620,6,Mostly Positive,2701,698,3399
914630,0,5 user reviews,3,2,5
914640,5,Mixed,7,4,11
914662,0,1 user reviews,1,0,1
914680,0,4 user reviews,1,3,4
914690,6,Mostly Positive,129,38,167
914700,0,1 user reviews,1,0,1
914710,9,Overwhelmingly Positive,492,13,505
914800,8,Very Positive,697,48,745
914840,0,1 user reviews,0,1,1
914850,8,Very Positive,46,6,52
914900,0,1 user reviews,1,0,1
914950,5,Mixed,9,5,14
914970,5,Mixed,20,16,36
915020,0,3 user reviews,3,0,3
915080,0,8 user reviews,7,1,8
915090,0,3 user reviews,3,0,3
915120,0,1 user reviews,1,0,1
915130,7,Positive,10,0,10
915140,7,Positive,40,4,44
915160,0,7 user reviews,6,1,7
915170,0,1 user reviews,0,1,1
915200,7,Positive,8,2,10
915300,0,1 user reviews,1,0,1
915330,7,Positive,17,3,20
915360,0,1 user reviews,1,0,1
915380,0,2 user reviews,2,0,2
915390,0,3 user reviews,2,1,3
915420,0,2 user reviews,2,0,2
915440,5,Mixed,7,5,12
915460,8,Very Positive,680,49,729
915490,5,Mixed,39,22,61
915540,0,5 user reviews,3,2,5
915560,0,4 user reviews,3,1,4
915590,0,1 user reviews,1,0,1
915600,8,Very Positive,96,14,110
915630,5,Mixed,4,6,10
915631,0,2 user reviews,2,0,2
915650,0,3 user reviews,1,2,3
915652,5,Mixed,15,17,32
915653,4,Mostly Negative,5,8,13
915670,5,Mixed,47,46,93
915710,5,Mixed,17,13,30
915730,0,3 user reviews,3,0,3
915820,0,5 user reviews,5,0,5
915850,0,4 user reviews,4,0,4
915860,0,1 user reviews,1,0,1
915930,0,2 user reviews,2,0,2
916000,8,Very Positive,81,13,94
916010,0,2 user reviews,2,0,2
916030,0,7 user reviews,7,0,7
916040,7,Positive,32,1,33
916050,0,5 user reviews,4,1,5
916060,7,Positive,26,3,29
916070,0,1 user reviews,1,0,1
916071,0,1 user reviews,0,1,1
916100,6,Mostly Positive,20,8,28
916160,6,Mostly Positive,17,7,24
916180,0,8 user reviews,6,2,8
916190,0,9 user reviews,8,1,9
916220,0,2 user reviews,2,0,2
916240,0,5 user reviews,5,0,5
916260,0,3 user reviews,0,3,3
916280,0,2 user reviews,2,0,2
916290,0,3 user reviews,3,0,3
916320,0,8 user reviews,8,0,8
916340,0,1 user reviews,0,1,1
916370,0,1 user reviews,1,0,1
916380,0,5 user reviews,4,1,5
916410,0,3 user reviews,2,1,3
916430,4,Mostly Negative,44,79,123
916440,8,Very Positive,932,168,1100
916470,0,1 user reviews,0,1,1
916510,0,6 user reviews,4,2,6
916540,0,4 user reviews,3,1,4
916580,7,Positive,9,2,11
916600,0,1 user reviews,1,0,1
916640,0,4 user reviews,0,4,4
916730,8,Very Positive,788,42,830
916771,0,2 user reviews,1,1,2
916780,0,3 user reviews,2,1,3
916840,8,Very Positive,2270,285,2555
916860,0,5 user reviews,1,4,5
916880,0,1 user reviews,0,1,1
916900,8,Very Positive,51,6,57
916930,5,Mixed,65,86,151
916950,7,Positive,13,1,14
916960,0,4 user reviews,4,0,4
917000,5,Mixed,7,4,11
917013,0,7 user reviews,7,0,7
917014,0,1 user reviews,1,0,1
917050,0,1 user reviews,0,1,1
917080,0,2 user reviews,2,0,2
917090,0,3 user reviews,1,2,3
917130,0,1 user reviews,1,0,1
917150,6,Mostly Positive,311,116,427
917190,0,4 user reviews,4,0,4
917200,0,5 user reviews,2,3,5
917290,8,Very Positive,73,1,74
917380,0,6 user reviews,6,0,6
917390,7,Positive,14,2,16
917500,0,1 user reviews,1,0,1
917600,0,4 user reviews,1,3,4
917690,7,Positive,12,0,12
917740,8,Very Positive,60,9,69
917770,0,1 user reviews,1,0,1
917800,0,1 user reviews,0,1,1
917810,0,1 user reviews,1,0,1
917830,0,9 user reviews,7,2,9
917840,8,Very Positive,128,5,133
917850,6,Mostly Positive,7,3,10
917870,0,1 user reviews,1,0,1
917890,0,1 user reviews,0,1,1
917900,0,1 user reviews,1,0,1
917910,0,5 user reviews,4,1,5
917920,8,Very Positive,42,9,51
918060,0,6 user reviews,3,3,6
918070,6,Mostly Positive,19,7,26
918080,0,9 user reviews,5,4,9
918110,0,5 user reviews,5,0,5
918180,0,8 user reviews,7,1,8
918260,0,3 user reviews,2,1,3
918300,0,1 user reviews,1,0,1
918320,0,4 user reviews,2,2,4
918380,8,Very Positive,98,8,106
918430,6,Mostly Positive,15,5,20
918440,0,1 user reviews,0,1,1
918450,0,1 user reviews,1,0,1
918490,0,6 user reviews,6,0,6
918500,0,8 user reviews,7,1,8
918530,8,Very Positive,88,7,95
918590,4,Mostly Negative,3,7,10
918610,0,1 user reviews,0,1,1
918620,0,1 user reviews,1,0,1
918670,7,Positive,29,0,29
918680,0,5 user reviews,2,3,5
918690,0,2 user reviews,2,0,2
918700,0,1 user reviews,1,0,1
918720,0,2 user reviews,0,2,2
918740,0,2 user reviews,2,0,2
918792,0,1 user reviews,1,0,1
918793,0,2 user reviews,1,1,2
918794,0,1 user reviews,1,0,1
918820,8,Very Positive,293,20,313
918870,0,1 user reviews,0,1,1
918900,5,Mixed,5,6,11
918950,7,Positive,11,2,13
918970,3,Negative,3,14,17
918990,6,Mostly Positive,26,7,33
919000,0,7 user reviews,6,1,7
919040,0,1 user reviews,0,1,1
919050,0,6 user reviews,5,1,6
919051,0,2 user reviews,2,0,2
919070,0,1 user reviews,1,0,1
919140,0,2 user reviews,1,1,2
919150,0,4 user reviews,3,1,4
919160,6,Mostly Positive,13,4,17
919180,0,1 user reviews,1,0,1
919200,0,8 user reviews,5,3,8
919220,5,Mixed,26,15,41
919240,0,1 user reviews,0,1,1
919260,8,Very Positive,64,11,75
919280,5,Mixed,132,100,232
919300,0,7 user reviews,5,2,7
919320,0,8 user reviews,8,0,8
919340,0,3 user reviews,3,0,3
919370,6,Mostly Positive,169,47,216
919390,6,Mostly Positive,28,9,37
919400,0,2 user reviews,2,0,2
919410,6,Mostly Positive,28,8,36
919450,0,4 user reviews,4,0,4
919560,5,Mixed,10,5,15
919640,6,Mostly Positive,1339,377,1716
919680,8,Very Positive,223,20,243
919690,0,4 user reviews,1,3,4
919720,5,Mixed,7,4,11
919770,7,Positive,10,0,10
919890,0,4 user reviews,4,0,4
920200,7,Positive,15,0,15
920280,0,3 user reviews,3,0,3
920320,8,Very Positive,199,15,214
920350,0,2 user reviews,2,0,2
920352,0,4 user reviews,4,0,4
920353,0,2 user reviews,2,0,2
920460,7,Positive,33,7,40
920490,7,Positive,15,1,16
920510,0,5 user reviews,4,1,5
920520,7,Positive,24,5,29
920530,0,2 user reviews,1,1,2
920560,7,Positive,22,1,23
920561,7,Positive,25,3,28
920562,6,Mostly Positive,18,7,25
920563,7,Positive,19,2,21
920564,7,Positive,48,1,49
920567,8,Very Positive,102,16,118
920568,7,Positive,33,8,41
920571,8,Very Positive,126,8,134
920620,0,4 user reviews,3,1,4
920630,5,Mixed,16,11,27
920680,8,Very Positive,211,52,263
920690,5,Mixed,392,273,665
920700,0,1 user reviews,1,0,1
920710,0,2 user reviews,0,2,2
920770,0,8 user reviews,7,1,8
920780,0,2 user reviews,1,1,2
920800,0,1 user reviews,1,0,1
920820,0,1 user reviews,0,1,1
920840,5,Mixed,45,46,91
920870,0,2 user reviews,2,0,2
920880,0,1 user reviews,1,0,1
920890,0,1 user reviews,1,0,1
920930,0,1 user reviews,1,0,1
920960,0,7 user reviews,4,3,7
921050,0,1 user reviews,0,1,1
921390,6,Mostly Positive,30,12,42
921420,0,2 user reviews,2,0,2
921430,7,Positive,33,1,34
921450,0,3 user reviews,2,1,3
921481,0,1 user reviews,1,0,1
921482,0,2 user reviews,2,0,2
921500,5,Mixed,6,4,10
921520,0,4 user reviews,3,1,4
921530,5,Mixed,34,19,53
921540,0,7 user reviews,6,1,7
921542,0,4 user reviews,4,0,4
921570,8,Very Positive,1272,190,1462
921590,5,Mixed,174,113,287
921630,8,Very Positive,209,36,245
921660,0,1 user reviews,1,0,1
921710,6,Mostly Positive,149,41,190
921730,0,4 user reviews,3,1,4
921740,0,2 user reviews,2,0,2
921770,5,Mixed,6,4,10
921780,5,Mixed,142,78,220
921800,6,Mostly Positive,275,81,356
921870,0,3 user reviews,2,1,3
921890,0,2 user reviews,2,0,2
921900,7,Positive,43,6,49
921950,5,Mixed,101,96,197
921960,0,1 user reviews,0,1,1
921970,4,Mostly Negative,9,30,39
922020,0,4 user reviews,4,0,4
922040,6,Mostly Positive,19,5,24
922100,8,Very Positive,138,5,143
922130,0,2 user reviews,1,1,2
922140,6,Mostly Positive,15,5,20
922150,6,Mostly Positive,16,5,21
922170,0,1 user reviews,1,0,1
922220,0,2 user reviews,1,1,2
922250,7,Positive,11,1,12
922290,7,Positive,15,1,16
922400,8,Very Positive,145,4,149
922410,0,6 user reviews,4,2,6
922430,7,Positive,16,0,16
922470,7,Positive,12,0,12
922500,5,Mixed,139,64,203
922510,0,3 user reviews,3,0,3
922520,0,1 user reviews,1,0,1
922530,7,Positive,11,2,13
922550,6,Mostly Positive,9,3,12
922580,0,1 user reviews,1,0,1
922590,0,1 user reviews,0,1,1
922650,0,4 user reviews,4,0,4
922660,5,Mixed,17,8,25
922670,0,9 user reviews,5,4,9
922700,7,Positive,19,0,19
922710,7,Positive,41,6,47
922800,4,Mostly Negative,5,14,19
922810,0,6 user reviews,4,2,6
922920,6,Mostly Positive,15,4,19
923050,0,1 user reviews,1,0,1
923080,0,2 user reviews,2,0,2
923230,0,6 user reviews,5,1,6
923240,0,1 user reviews,0,1,1
923260,8,Very Positive,65,4,69
923270,0,3 user reviews,0,3,3
923290,0,1 user reviews,1,0,1
923310,0,1 user reviews,1,0,1
923350,0,1 user reviews,0,1,1
923370,0,8 user reviews,8,0,8
923380,0,3 user reviews,3,0,3
923420,7,Positive,14,2,16
923470,8,Very Positive,103,20,123
923480,0,3 user reviews,3,0,3
923530,0,6 user reviews,2,4,6
923550,0,3 user reviews,3,0,3
923570,8,Very Positive,59,3,62
923590,5,Mixed,14,20,34
923630,0,5 user reviews,4,1,5
923650,0,3 user reviews,3,0,3
923670,0,7 user reviews,7,0,7
923690,4,Mostly Negative,3,8,11
923710,6,Mostly Positive,28,10,38
923720,0,1 user reviews,1,0,1
923730,0,4 user reviews,3,1,4
923790,0,2 user reviews,1,1,2
923810,8,Very Positive,75,8,83
923840,0,1 user reviews,1,0,1
923880,0,2 user reviews,1,1,2
923890,5,Mixed,20,15,35
923900,0,5 user reviews,5,0,5
923910,7,Positive,10,0,10
923970,4,Mostly Negative,24,41,65
924020,3,Negative,5,26,31
924040,0,5 user reviews,2,3,5
924051,0,1 user reviews,1,0,1
924070,6,Mostly Positive,40,16,56
924090,0,6 user reviews,3,3,6
924100,5,Mixed,6,7,13
924110,0,5 user reviews,1,4,5
924140,8,Very Positive,1030,170,1200
924150,0,5 user reviews,4,1,5
924151,0,4 user reviews,4,0,4
924181,5,Mixed,7,8,15
924183,0,4 user reviews,2,2,4
924185,0,3 user reviews,2,1,3
924210,0,1 user reviews,1,0,1
924220,8,Very Positive,73,14,87
924250,6,Mostly Positive,27,11,38
924280,0,5 user reviews,5,0,5
924310,6,Mostly Positive,8,3,11
924330,0,4 user reviews,4,0,4
924331,0,2 user reviews,2,0,2
924332,0,1 user reviews,1,0,1
924370,0,8 user reviews,3,5,8
924390,0,2 user reviews,0,2,2
924460,0,2 user reviews,1,1,2
924490,0,1 user reviews,1,0,1
924500,0,1 user reviews,0,1,1
924520,0,1 user reviews,1,0,1
924560,0,2 user reviews,2,0,2
924650,7,Positive,39,5,44
924670,5,Mixed,6,8,14
924740,0,4 user reviews,1,3,4
924770,0,2 user reviews,2,0,2
924780,7,Positive,10,0,10
924790,0,4 user reviews,4,0,4
924800,6,Mostly Positive,14,4,18
924870,0,6 user reviews,5,1,6
924900,7,Positive,19,1,20
924940,7,Positive,14,0,14
924960,0,2 user reviews,1,1,2
924980,8,Very Positive,1100,60,1160
925040,0,8 user reviews,6,2,8
925050,0,1 user reviews,1,0,1
925060,0,3 user reviews,3,0,3
925070,0,2 user reviews,1,1,2
925090,0,4 user reviews,3,1,4
925100,6,Mostly Positive,179,47,226
925110,0,8 user reviews,5,3,8
925170,7,Positive,14,2,16
925180,0,1 user reviews,1,0,1
925190,0,4 user reviews,3,1,4
925191,0,2 user reviews,2,0,2
925280,0,1 user reviews,1,0,1
925340,7,Positive,19,0,19
925360,0,3 user reviews,2,1,3
925370,0,3 user reviews,3,0,3
925440,7,Positive,32,3,35
925460,8,Very Positive,85,3,88
925470,5,Mixed,18,8,26
925490,0,9 user reviews,8,1,9
925520,8,Very Positive,50,7,57
925540,0,1 user reviews,0,1,1
925550,7,Positive,21,1,22
925570,5,Mixed,40,32,72
925580,8,Very Positive,320,27,347
925600,0,1 user reviews,0,1,1
925610,0,1 user reviews,0,1,1
925650,7,Positive,23,0,23
925660,0,2 user reviews,2,0,2
925670,3,Negative,1,10,11
925690,0,4 user reviews,3,1,4
925700,0,1 user reviews,0,1,1
925750,8,Very Positive,167,41,208
925760,0,2 user reviews,2,0,2
925825,0,1 user reviews,1,0,1
925826,0,4 user reviews,4,0,4
925827,0,6 user reviews,2,4,6
925863,0,1 user reviews,1,0,1
925880,0,6 user reviews,3,3,6
925910,5,Mixed,6,4,10
925930,8,Very Positive,74,3,77
925940,5,Mixed,37,18,55
926010,5,Mixed,10,10,20
926020,7,Positive,24,0,24
926070,0,1 user reviews,1,0,1
926090,0,4 user reviews,3,1,4
926100,0,3 user reviews,3,0,3
926110,0,2 user reviews,2,0,2
926120,0,3 user reviews,3,0,3
926130,0,2 user reviews,0,2,2
926140,8,Very Positive,628,52,680
926170,7,Positive,12,2,14
926180,5,Mixed,17,10,27
926210,0,7 user reviews,6,1,7
926240,0,1 user reviews,1,0,1
926250,0,7 user reviews,7,0,7
926310,0,1 user reviews,1,0,1
926340,7,Positive,33,1,34
926350,0,3 user reviews,3,0,3
926370,0,4 user reviews,2,2,4
926390,7,Positive,22,5,27
926400,0,5 user reviews,4,1,5
926410,0,6 user reviews,3,3,6
926450,0,5 user reviews,5,0,5
926470,0,9 user reviews,7,2,9
926480,0,1 user reviews,0,1,1
926490,0,1 user reviews,1,0,1
926520,7,Positive,40,4,44
926540,5,Mixed,46,28,74
926580,6,Mostly Positive,177,46,223
926590,0,1 user reviews,1,0,1
926610,0,3 user reviews,3,0,3
926650,0,7 user reviews,6,1,7
926730,4,Mostly Negative,7,15,22
926800,0,6 user reviews,6,0,6
926810,4,Mostly Negative,6,11,17
926820,0,5 user reviews,5,0,5
926860,8,Very Positive,106,7,113
926990,9,Overwhelmingly Positive,1033,50,1083
927080,0,3 user reviews,3,0,3
927190,0,7 user reviews,5,2,7
927240,0,3 user reviews,2,1,3
927250,8,Very Positive,263,26,289
927270,8,Very Positive,362,89,451
927310,0,4 user reviews,3,1,4
927340,0,1 user reviews,1,0,1
927370,0,2 user reviews,2,0,2
927380,9,Overwhelmingly Positive,2248,61,2309
927580,0,2 user reviews,1,1,2
927730,6,Mostly Positive,42,18,60
927840,6,Mostly Positive,11,4,15
927890,8,Very Positive,519,39,558
927930,6,Mostly Positive,12,4,16
928060,4,Mostly Negative,8,16,24
928070,0,9 user reviews,1,8,9
928100,7,Positive,26,2,28
928140,0,3 user reviews,2,1,3
928160,0,4 user reviews,4,0,4
928170,5,Mixed,8,9,17
928180,6,Mostly Positive,11,4,15
928210,0,2 user reviews,1,1,2
928230,0,4 user reviews,3,1,4
928290,0,1 user reviews,0,1,1
928300,7,Positive,31,2,33
928350,0,3 user reviews,3,0,3
928370,0,5 user reviews,5,0,5
928390,8,Very Positive,63,8,71
928410,0,3 user reviews,1,2,3
928440,7,Positive,13,3,16
928460,4,Mostly Negative,3,7,10
928480,0,9 user reviews,9,0,9
928520,6,Mostly Positive,39,11,50
928600,8,Very Positive,3926,389,4315
928610,4,Mostly Negative,5,9,14
928660,0,7 user reviews,7,0,7
928670,7,Positive,11,1,12
928680,0,9 user reviews,9,0,9
928830,0,5 user reviews,4,1,5
928840,5,Mixed,16,8,24
928880,4,Mostly Negative,5,12,17
928970,0,8 user reviews,8,0,8
929010,5,Mixed,349,415,764
929030,0,7 user reviews,3,4,7
929060,5,Mixed,52,24,76
929080,0,1 user reviews,0,1,1
929100,8,Very Positive,62,9,71
929101,7,Positive,44,2,46
929102,7,Positive,47,2,49
929103,7,Positive,20,1,21
929106,8,Very Positive,49,11,60
929120,0,6 user reviews,5,1,6
929140,7,Positive,18,2,20
929150,0,1 user reviews,0,1,1
929160,0,2 user reviews,2,0,2
929170,0,6 user reviews,5,1,6
929180,0,1 user reviews,1,0,1
929192,0,1 user reviews,0,1,1
929200,0,6 user reviews,1,5,6
929210,0,1 user reviews,0,1,1
929230,0,6 user reviews,5,1,6
929270,6,Mostly Positive,36,13,49
929290,0,9 user reviews,4,5,9
929300,6,Mostly Positive,18,7,25
929310,0,9 user reviews,8,1,9
929320,7,Positive,12,0,12
929330,0,5 user reviews,3,2,5
929350,0,3 user reviews,3,0,3
929360,0,2 user reviews,2,0,2
929400,0,1 user reviews,1,0,1
929410,0,1 user reviews,1,0,1
929420,0,2 user reviews,2,0,2
929430,0,8 user reviews,5,3,8
929440,0,2 user reviews,2,0,2
929470,0,1 user reviews,1,0,1
929480,0,6 user reviews,5,1,6
929510,0,4 user reviews,2,2,4
929530,0,1 user reviews,0,1,1
929550,0,3 user reviews,2,1,3
929570,0,2 user reviews,1,1,2
929600,6,Mostly Positive,8,3,11
929610,0,1 user reviews,0,1,1
929640,0,3 user reviews,3,0,3
929670,6,Mostly Positive,12,4,16
929680,7,Positive,9,1,10
929800,0,2 user reviews,1,1,2
929850,0,8 user reviews,8,0,8
929880,0,1 user reviews,0,1,1
929910,7,Positive,10,0,10
930010,0,1 user reviews,1,0,1
930020,0,4 user reviews,3,1,4
930030,0,1 user reviews,0,1,1
930100,0,7 user reviews,7,0,7
930200,0,6 user reviews,6,0,6
930290,0,1 user reviews,1,0,1
930300,0,2 user reviews,1,1,2
930310,0,6 user reviews,6,0,6
930320,0,6 user reviews,6,0,6
930430,0,2 user reviews,2,0,2
930460,7,Positive,30,5,35
930480,0,2 user reviews,2,0,2
930500,0,4 user reviews,3,1,4
930600,0,1 user reviews,1,0,1
930620,5,Mixed,40,34,74
930630,7,Positive,12,0,12
930640,0,7 user reviews,7,0,7
930650,0,1 user reviews,0,1,1
930690,0,3 user reviews,3,0,3
930710,0,5 user reviews,4,1,5
930780,8,Very Positive,142,33,175
930850,0,1 user reviews,0,1,1
930910,8,Very Positive,110,1,111
930940,0,2 user reviews,1,1,2
930970,0,1 user reviews,0,1,1
930980,0,4 user reviews,3,1,4
930982,0,9 user reviews,9,0,9
930984,0,5 user reviews,5,0,5
930990,7,Positive,12,0,12
931000,0,4 user reviews,3,1,4
931040,0,2 user reviews,2,0,2
931090,0,6 user reviews,6,0,6
931120,0,4 user reviews,2,2,4
931150,0,2 user reviews,2,0,2
931200,0,3 user reviews,3,0,3
931210,0,2 user reviews,1,1,2
931250,0,5 user reviews,1,4,5
931260,0,3 user reviews,2,1,3
931270,8,Very Positive,188,10,198
931280,8,Very Positive,198,43,241
931310,5,Mixed,22,24,46
931320,7,Positive,11,0,11
931360,0,3 user reviews,2,1,3
931370,0,3 user reviews,3,0,3
931430,0,9 user reviews,4,5,9
931440,0,2 user reviews,0,2,2
931450,0,9 user reviews,8,1,9
931470,0,6 user reviews,5,1,6
931480,0,2 user reviews,1,1,2
931500,8,Very Positive,107,6,113
931530,0,2 user reviews,2,0,2
931540,0,4 user reviews,3,1,4
931560,7,Positive,18,0,18
931570,0,2 user reviews,2,0,2
931620,0,3 user reviews,3,0,3
931630,0,9 user reviews,7,2,9
931640,0,8 user reviews,4,4,8
931670,0,8 user reviews,8,0,8
931800,0,1 user reviews,1,0,1
931820,0,1 user reviews,1,0,1
931830,6,Mostly Positive,7,3,10
931860,7,Positive,26,4,30
931920,7,Positive,18,0,18
931930,7,Positive,32,2,34
931950,8,Very Positive,40,10,50
931960,0,1 user reviews,1,0,1
931980,0,1 user reviews,1,0,1
932120,0,4 user reviews,3,1,4
932160,5,Mixed,4,6,10
932210,5,Mixed,9,5,14
932220,7,Positive,18,1,19
932270,0,3 user reviews,3,0,3
932290,0,2 user reviews,2,0,2
932300,0,1 user reviews,0,1,1
932310,0,8 user reviews,3,5,8
932330,7,Positive,14,2,16
932350,0,2 user reviews,1,1,2
932420,0,7 user reviews,7,0,7
932450,0,6 user reviews,6,0,6
932480,0,6 user reviews,5,1,6
932500,8,Very Positive,85,2,87
932560,0,1 user reviews,1,0,1
932641,0,1 user reviews,0,1,1
932643,0,1 user reviews,1,0,1
932644,0,5 user reviews,1,4,5
932660,6,Mostly Positive,8,3,11
932670,0,2 user reviews,0,2,2
932690,0,4 user reviews,0,4,4
932730,0,5 user reviews,3,2,5
932740,0,1 user reviews,1,0,1
932744,0,1 user reviews,1,0,1
932760,0,6 user reviews,5,1,6
932780,0,5 user reviews,5,0,5
932790,7,Positive,12,3,15
932820,0,4 user reviews,4,0,4
932850,8,Very Positive,330,45,375
932920,0,1 user reviews,0,1,1
932930,0,5 user reviews,3,2,5
932940,5,Mixed,5,5,10
932950,0,1 user reviews,1,0,1
932970,0,4 user reviews,2,2,4
932980,5,Mixed,79,45,124
932990,0,3 user reviews,3,0,3
933020,0,1 user reviews,1,0,1
933030,0,5 user reviews,5,0,5
933050,0,2 user reviews,1,1,2
933060,6,Mostly Positive,12,4,16
933070,0,3 user reviews,1,2,3
933080,5,Mixed,11,8,19
933110,5,Mixed,1614,1029,2643
933130,7,Positive,11,2,13
933140,7,Positive,17,1,18
933160,0,2 user reviews,2,0,2
933210,0,4 user reviews,4,0,4
933230,5,Mixed,17,10,27
933300,0,7 user reviews,5,2,7
933400,0,1 user reviews,1,0,1
933430,0,1 user reviews,1,0,1
933450,5,Mixed,26,12,38
933504,6,Mostly Positive,7,3,10
933510,0,2 user reviews,1,1,2
933512,0,1 user reviews,1,0,1
933524,0,1 user reviews,0,1,1
933525,0,1 user reviews,1,0,1
933526,0,1 user reviews,1,0,1
933528,0,1 user reviews,1,0,1
933529,0,1 user reviews,1,0,1
933530,0,1 user reviews,0,1,1
933531,0,1 user reviews,0,1,1
933532,0,3 user reviews,2,1,3
933552,0,1 user reviews,1,0,1
933556,0,1 user reviews,1,0,1
933557,0,1 user reviews,1,0,1
933558,0,2 user reviews,1,1,2
933560,0,1 user reviews,1,0,1
933566,0,3 user reviews,0,3,3
933570,0,1 user reviews,1,0,1
933600,0,3 user reviews,3,0,3
933610,8,Very Positive,84,20,104
933620,0,7 user reviews,6,1,7
933630,5,Mixed,5,5,10
933660,0,6 user reviews,3,3,6
933690,0,5 user reviews,1,4,5
933700,4,Mostly Negative,11,21,32
933710,0,6 user reviews,2,4,6
933720,2,Very Negative,12,51,63
933753,0,1 user reviews,0,1,1
933770,0,8 user reviews,8,0,8
933790,0,1 user reviews,1,0,1
933820,6,Mostly Positive,504,134,638
933830,0,9 user reviews,6,3,9
933840,0,3 user reviews,1,2,3
933860,6,Mostly Positive,81,23,104
933890,0,1 user reviews,1,0,1
933920,0,8 user reviews,3,5,8
933940,7,Positive,12,3,15
933970,5,Mixed,6,9,15
933980,0,7 user reviews,3,4,7
934070,7,Positive,30,0,30
934120,5,Mixed,4,6,10
934130,0,1 user reviews,0,1,1
934170,0,3 user reviews,3,0,3
934180,0,7 user reviews,4,3,7
934220,0,6 user reviews,3,3,6
934410,7,Positive,13,0,13
934430,0,1 user reviews,1,0,1
934470,0,1 user reviews,0,1,1
934540,5,Mixed,12,8,20
934550,0,1 user reviews,1,0,1
934590,0,2 user reviews,0,2,2
934600,0,4 user reviews,2,2,4
934630,7,Positive,9,1,10
934650,0,8 user reviews,5,3,8
934660,0,6 user reviews,3,3,6
934680,0,8 user reviews,6,2,8
934690,0,2 user reviews,1,1,2
934780,6,Mostly Positive,261,98,359
934800,0,1 user reviews,1,0,1
934810,0,1 user reviews,1,0,1
934920,0,1 user reviews,1,0,1
934930,8,Very Positive,170,38,208
934950,0,7 user reviews,4,3,7
934990,5,Mixed,7,4,11
935010,0,1 user reviews,1,0,1
935070,7,Positive,37,6,43
935080,0,4 user reviews,4,0,4
935180,0,4 user reviews,1,3,4
935190,0,8 user reviews,4,4,8
935240,0,1 user reviews,0,1,1
935250,0,4 user reviews,4,0,4
935270,8,Very Positive,160,21,181
935320,0,1 user reviews,1,0,1
935350,0,2 user reviews,1,1,2
935360,7,Positive,13,3,16
935400,8,Very Positive,63,9,72
935430,0,9 user reviews,5,4,9
935440,0,7 user reviews,7,0,7
935460,0,3 user reviews,0,3,3
935490,0,4 user reviews,2,2,4
935500,0,6 user reviews,2,4,6
935510,0,6 user reviews,3,3,6
935511,7,Positive,10,0,10
935512,0,5 user reviews,4,1,5
935513,0,8 user reviews,6,2,8
935514,0,1 user reviews,1,0,1
935540,0,1 user reviews,1,0,1
935560,7,Positive,20,3,23
935570,5,Mixed,7,7,14
935580,8,Very Positive,124,11,135
935590,0,2 user reviews,2,0,2
935610,0,4 user reviews,1,3,4
935640,7,Positive,14,1,15
935680,0,2 user reviews,0,2,2
935700,0,6 user reviews,2,4,6
935720,0,3 user reviews,1,2,3
935750,7,Positive,8,2,10
935790,0,4 user reviews,3,1,4
935810,0,4 user reviews,1,3,4
935860,0,2 user reviews,2,0,2
935880,8,Very Positive,498,34,532
935910,0,8 user reviews,6,2,8
935930,8,Very Positive,105,14,119
935940,0,3 user reviews,0,3,3
935950,0,1 user reviews,1,0,1
935960,0,4 user reviews,0,4,4
935980,5,Mixed,12,11,23
936000,0,1 user reviews,1,0,1
936010,0,5 user reviews,3,2,5
936020,0,2 user reviews,2,0,2
936030,7,Positive,14,1,15
936040,0,3 user reviews,2,1,3
936070,0,2 user reviews,2,0,2
936080,0,1 user reviews,1,0,1
936090,0,2 user reviews,1,1,2
936100,0,7 user reviews,1,6,7
936140,5,Mixed,73,35,108
936160,8,Very Positive,80,9,89
936170,0,3 user reviews,3,0,3
936180,6,Mostly Positive,26,9,35
936190,7,Positive,28,1,29
936210,0,1 user reviews,1,0,1
936370,0,1 user reviews,1,0,1
936490,5,Mixed,55,57,112
936500,6,Mostly Positive,66,20,86
936510,0,2 user reviews,1,1,2
936530,6,Mostly Positive,30,10,40
936560,0,2 user reviews,1,1,2
936600,0,1 user reviews,1,0,1
936610,7,Positive,24,5,29
936620,5,Mixed,13,9,22
936630,0,6 user reviews,6,0,6
936650,7,Positive,25,0,25
936670,5,Mixed,20,24,44
936700,7,Positive,15,0,15
936720,8,Very Positive,319,29,348
936740,7,Positive,13,2,15
936800,0,4 user reviews,1,3,4
936810,0,3 user reviews,0,3,3
936820,0,2 user reviews,1,1,2
936930,0,9 user reviews,4,5,9
936960,6,Mostly Positive,82,33,115
936980,5,Mixed,24,11,35
937050,0,5 user reviews,4,1,5
937070,0,1 user reviews,1,0,1
937090,0,1 user reviews,1,0,1
937140,0,2 user reviews,2,0,2
937160,0,1 user reviews,1,0,1
937170,8,Very Positive,156,12,168
937210,7,Positive,12,2,14
937300,8,Very Positive,48,4,52
937320,0,1 user reviews,1,0,1
937360,0,2 user reviews,1,1,2
937390,0,1 user reviews,1,0,1
937490,7,Positive,15,0,15
937520,0,6 user reviews,6,0,6
937530,7,Positive,24,6,30
937570,7,Positive,18,0,18
937580,8,Very Positive,103,1,104
937620,0,1 user reviews,0,1,1
937630,0,4 user reviews,4,0,4
937720,0,4 user reviews,4,0,4
937730,5,Mixed,13,6,19
937740,0,6 user reviews,2,4,6
937770,0,8 user reviews,6,2,8
937780,0,2 user reviews,0,2,2
937791,0,1 user reviews,1,0,1
937792,0,1 user reviews,1,0,1
937820,0,2 user reviews,1,1,2
937850,8,Very Positive,58,3,61
937860,0,1 user reviews,0,1,1
937870,7,Positive,13,3,16
937880,0,1 user reviews,0,1,1
937890,6,Mostly Positive,92,28,120
937891,5,Mixed,148,210,358
937940,5,Mixed,17,10,27
937950,5,Mixed,13,14,27
937970,0,4 user reviews,2,2,4
938000,0,4 user reviews,2,2,4
938030,7,Positive,18,0,18
938070,0,7 user reviews,7,0,7
938100,0,3 user reviews,3,0,3
938120,0,1 user reviews,1,0,1
938170,0,4 user reviews,4,0,4
938210,0,1 user reviews,0,1,1
938220,8,Very Positive,160,13,173
938240,7,Positive,13,2,15
938250,0,8 user reviews,5,3,8
938260,0,3 user reviews,3,0,3
938270,6,Mostly Positive,11,3,14
938280,0,2 user reviews,2,0,2
938300,5,Mixed,27,17,44
938310,7,Positive,25,0,25
938320,0,8 user reviews,4,4,8
938350,0,6 user reviews,4,2,6
938360,0,1 user reviews,1,0,1
938380,5,Mixed,45,20,65
938390,3,Negative,1,9,10
938400,5,Mixed,7,5,12
938410,0,5 user reviews,5,0,5
938460,8,Very Positive,144,9,153
938480,0,9 user reviews,8,1,9
938490,7,Positive,15,2,17
938500,4,Mostly Negative,22,56,78
938510,0,1 user reviews,1,0,1
938520,0,1 user reviews,0,1,1
938560,8,Very Positive,354,46,400
938590,0,1 user reviews,0,1,1
938600,0,5 user reviews,4,1,5
938610,0,1 user reviews,1,0,1
938630,0,2 user reviews,2,0,2
938640,0,5 user reviews,3,2,5
938721,0,1 user reviews,1,0,1
938740,0,6 user reviews,5,1,6
938760,0,7 user reviews,4,3,7
938820,0,1 user reviews,0,1,1
938840,0,2 user reviews,0,2,2
938870,0,1 user reviews,0,1,1
938890,0,8 user reviews,6,2,8
938940,0,7 user reviews,2,5,7
938960,0,4 user reviews,4,0,4
938980,0,4 user reviews,4,0,4
939000,8,Very Positive,135,33,168
939050,0,5 user reviews,4,1,5
939051,0,8 user reviews,5,3,8
939060,7,Positive,8,2,10
939100,6,Mostly Positive,284,105,389
939120,5,Mixed,23,15,38
939150,0,2 user reviews,2,0,2
939160,5,Mixed,8,4,12
939180,5,Mixed,13,11,24
939200,0,2 user reviews,2,0,2
939230,0,8 user reviews,6,2,8
939240,0,4 user reviews,2,2,4
939350,7,Positive,33,8,41
939360,7,Positive,25,5,30
939390,4,Mostly Negative,3,10,13
939400,8,Very Positive,198,16,214
939410,0,3 user reviews,1,2,3
939450,6,Mostly Positive,17,6,23
939510,5,Mixed,629,386,1015
939520,5,Mixed,389,392,781
939540,0,1 user reviews,1,0,1
939560,0,2 user reviews,2,0,2
939600,8,Very Positive,108,12,120
939620,7,Positive,17,0,17
939730,0,2 user reviews,1,1,2
939750,0,3 user reviews,1,2,3
939790,8,Very Positive,66,3,69
939810,0,2 user reviews,0,2,2
939830,0,6 user reviews,6,0,6
939840,5,Mixed,25,21,46
939850,6,Mostly Positive,1104,453,1557
939920,0,7 user reviews,2,5,7
939930,0,6 user reviews,2,4,6
939940,5,Mixed,8,5,13
939960,6,Mostly Positive,4576,1312,5888
939990,6,Mostly Positive,77,23,100
940010,0,3 user reviews,3,0,3
940140,0,6 user reviews,6,0,6
940150,7,Positive,12,1,13
940180,0,1 user reviews,1,0,1
940190,0,4 user reviews,2,2,4
940220,8,Very Positive,643,62,705
940240,0,1 user reviews,1,0,1
940300,6,Mostly Positive,22,8,30
940310,8,Very Positive,98,20,118
940320,0,2 user reviews,2,0,2
940330,0,1 user reviews,0,1,1
940350,0,1 user reviews,0,1,1
940390,0,2 user reviews,1,1,2
940410,0,1 user reviews,1,0,1
940460,0,1 user reviews,1,0,1
940480,0,1 user reviews,1,0,1
940520,0,4 user reviews,1,3,4
940530,0,3 user reviews,3,0,3
940580,5,Mixed,13,10,23
940590,0,1 user reviews,1,0,1
940600,0,1 user reviews,0,1,1
940620,0,1 user reviews,1,0,1
940630,0,1 user reviews,0,1,1
940640,0,2 user reviews,2,0,2
940650,5,Mixed,11,7,18
940680,8,Very Positive,125,16,141
940700,0,1 user reviews,1,0,1
940710,8,Very Positive,71,3,74
940730,0,3 user reviews,3,0,3
940731,0,4 user reviews,4,0,4
940732,0,1 user reviews,1,0,1
940733,0,1 user reviews,1,0,1
940734,0,1 user reviews,1,0,1
940735,0,1 user reviews,1,0,1
940736,0,2 user reviews,2,0,2
940739,0,1 user reviews,0,1,1
940740,0,1 user reviews,1,0,1
940750,0,2 user reviews,2,0,2
940770,0,2 user reviews,2,0,2
940780,0,5 user reviews,5,0,5
940790,7,Positive,10,2,12
940800,0,5 user reviews,5,0,5
940810,0,3 user reviews,1,2,3
940830,0,3 user reviews,3,0,3
940850,0,1 user reviews,1,0,1
940870,7,Positive,17,4,21
940910,8,Very Positive,266,40,306
940920,0,5 user reviews,4,1,5
940990,0,1 user reviews,1,0,1
941000,0,5 user reviews,5,0,5
941020,7,Positive,30,4,34
941030,0,2 user reviews,2,0,2
941040,0,5 user reviews,3,2,5
941050,0,1 user reviews,1,0,1
941100,7,Positive,16,0,16
941150,0,2 user reviews,1,1,2
941160,0,9 user reviews,7,2,9
941200,0,1 user reviews,0,1,1
941220,7,Positive,14,0,14
941300,0,2 user reviews,2,0,2
941320,0,5 user reviews,3,2,5
941340,0,1 user reviews,1,0,1
941350,0,3 user reviews,2,1,3
941390,0,2 user reviews,2,0,2
941410,0,2 user reviews,2,0,2
941440,0,1 user reviews,1,0,1
941480,8,Very Positive,60,13,73
941490,7,Positive,17,1,18
941540,7,Positive,11,0,11
941550,0,1 user reviews,1,0,1
941560,0,1 user reviews,1,0,1
941570,7,Positive,36,4,40
941620,0,2 user reviews,2,0,2
941630,0,1 user reviews,1,0,1
941650,0,5 user reviews,5,0,5
941730,6,Mostly Positive,25,8,33
941790,0,6 user reviews,5,1,6
941800,0,1 user reviews,1,0,1
941850,5,Mixed,37,26,63
941920,5,Mixed,10,7,17
941951,0,2 user reviews,2,0,2
941952,7,Positive,21,3,24
941953,0,3 user reviews,3,0,3
941954,0,5 user reviews,5,0,5
941955,0,9 user reviews,9,0,9
941956,0,6 user reviews,6,0,6
941957,0,4 user reviews,4,0,4
941958,0,6 user reviews,6,0,6
941959,7,Positive,12,0,12
941960,0,8 user reviews,8,0,8
941961,7,Positive,14,1,15
941962,0,2 user reviews,1,1,2
941964,0,2 user reviews,2,0,2
941966,0,1 user reviews,0,1,1
941967,0,3 user reviews,3,0,3
941968,0,1 user reviews,0,1,1
941970,0,2 user reviews,0,2,2
941971,0,2 user reviews,1,1,2
941972,0,1 user reviews,0,1,1
941973,0,1 user reviews,1,0,1
941980,0,1 user reviews,1,0,1
942020,0,4 user reviews,4,0,4
942030,0,3 user reviews,3,0,3
942050,7,Positive,11,2,13
942060,7,Positive,30,2,32
942140,0,1 user reviews,0,1,1
942180,0,3 user reviews,3,0,3
942190,6,Mostly Positive,10,3,13
942200,7,Positive,20,0,20
942210,0,4 user reviews,3,1,4
942230,7,Positive,10,2,12
942240,0,7 user reviews,6,1,7
942250,7,Positive,13,3,16
942270,7,Positive,14,1,15
942280,7,Positive,11,1,12
942290,5,Mixed,161,105,266
942300,0,7 user reviews,3,4,7
942340,0,1 user reviews,0,1,1
942353,0,1 user reviews,0,1,1
942380,0,3 user reviews,3,0,3
942430,0,3 user reviews,3,0,3
942480,0,5 user reviews,2,3,5
942520,0,6 user reviews,6,0,6
942530,0,1 user reviews,1,0,1
942540,0,6 user reviews,6,0,6
942580,5,Mixed,7,10,17
942590,0,4 user reviews,3,1,4
942760,0,4 user reviews,0,4,4
942770,0,3 user reviews,1,2,3
942800,7,Positive,21,4,25
942850,8,Very Positive,71,7,78
942870,0,1 user reviews,1,0,1
942900,4,Mostly Negative,4,8,12
942970,8,Very Positive,1176,80,1256
943030,0,2 user reviews,0,2,2
943070,0,1 user reviews,1,0,1
943080,0,2 user reviews,0,2,2
943130,4,Mostly Negative,34,57,91
943140,8,Very Positive,75,16,91
943150,5,Mixed,239,280,519
943190,7,Positive,18,2,20
943200,6,Mostly Positive,10,4,14
943230,0,4 user reviews,3,1,4
943260,8,Very Positive,133,32,165
943380,5,Mixed,30,14,44
943410,8,Very Positive,60,6,66
943420,6,Mostly Positive,8,3,11
943440,0,2 user reviews,1,1,2
943510,0,3 user reviews,3,0,3
943520,0,7 user reviews,7,0,7
943590,0,4 user reviews,4,0,4
943680,0,8 user reviews,3,5,8
943690,0,1 user reviews,1,0,1
943740,5,Mixed,134,72,206
943810,7,Positive,11,2,13
943830,5,Mixed,6,5,11
943831,0,3 user reviews,1,2,3
943840,0,4 user reviews,2,2,4
943842,0,1 user reviews,1,0,1
943844,0,4 user reviews,4,0,4
943860,7,Positive,13,2,15
943871,0,1 user reviews,0,1,1
943900,6,Mostly Positive,15,5,20
943920,0,3 user reviews,3,0,3
943950,0,5 user reviews,5,0,5
943970,0,2 user reviews,1,1,2
943980,5,Mixed,12,7,19
944010,8,Very Positive,113,5,118
944020,7,Positive,21,0,21
944030,0,1 user reviews,1,0,1
944070,7,Positive,27,4,31
944071,6,Mostly Positive,53,20,73
944080,7,Positive,16,0,16
944100,0,8 user reviews,6,2,8
944180,7,Positive,25,5,30
944200,0,1 user reviews,1,0,1
944220,8,Very Positive,302,14,316
944260,0,3 user reviews,1,2,3
944290,5,Mixed,329,236,565
944300,0,4 user reviews,4,0,4
944330,8,Very Positive,125,31,156
944340,7,Positive,24,1,25
944350,0,9 user reviews,7,2,9
944380,0,4 user reviews,2,2,4
944420,0,2 user reviews,0,2,2
944440,0,2 user reviews,2,0,2
944500,0,3 user reviews,2,1,3
944530,0,8 user reviews,7,1,8
944590,7,Positive,16,0,16
944610,0,2 user reviews,2,0,2
944640,0,3 user reviews,2,1,3
944650,7,Positive,12,3,15
944690,7,Positive,10,1,11
944710,0,1 user reviews,0,1,1
944740,0,2 user reviews,0,2,2
944770,0,2 user reviews,2,0,2
944810,7,Positive,9,1,10
944830,0,1 user reviews,1,0,1
944860,0,5 user reviews,3,2,5
944910,0,9 user reviews,7,2,9
944920,8,Very Positive,100,20,120
945070,0,2 user reviews,0,2,2
945100,0,7 user reviews,7,0,7
945140,5,Mixed,18,10,28
945160,5,Mixed,11,6,17
945240,0,5 user reviews,5,0,5
945280,0,5 user reviews,5,0,5
945340,7,Positive,16,2,18
945360,9,Overwhelmingly Positive,168027,5771,173798
945390,0,1 user reviews,1,0,1
945402,0,1 user reviews,1,0,1
945440,8,Very Positive,78,6,84
945450,0,1 user reviews,1,0,1
945460,8,Very Positive,82,9,91
945480,0,2 user reviews,2,0,2
945482,0,1 user reviews,1,0,1
945483,0,1 user reviews,1,0,1
945490,0,1 user reviews,1,0,1
945530,0,1 user reviews,1,0,1
945580,7,Positive,19,0,19
945590,0,5 user reviews,4,1,5
945680,6,Mostly Positive,36,15,51
945700,0,8 user reviews,0,8,8
945710,6,Mostly Positive,304,105,409
945720,7,Positive,10,1,11
945780,0,1 user reviews,1,0,1
945790,0,1 user reviews,1,0,1
945820,0,1 user reviews,0,1,1
945830,6,Mostly Positive,10,3,13
945831,0,9 user reviews,4,5,9
945832,0,7 user reviews,6,1,7
945890,4,Mostly Negative,5,8,13
945910,0,2 user reviews,0,2,2
945950,0,4 user reviews,2,2,4
946000,7,Positive,10,1,11
946010,8,Very Positive,53,9,62
946070,0,4 user reviews,2,2,4
946080,0,1 user reviews,1,0,1
946090,6,Mostly Positive,156,50,206
946110,8,Very Positive,42,10,52
946170,0,1 user reviews,1,0,1
946180,0,1 user reviews,1,0,1
946190,0,1 user reviews,1,0,1
946210,0,3 user reviews,0,3,3
946300,0,2 user reviews,2,0,2
946310,0,4 user reviews,4,0,4
946340,0,6 user reviews,5,1,6
946380,7,Positive,9,1,10
946400,0,1 user reviews,1,0,1
946430,8,Very Positive,104,4,108
946460,7,Positive,11,2,13
946500,0,3 user reviews,1,2,3
946550,5,Mixed,7,6,13
946560,7,Positive,34,2,36
946600,3,Negative,3,19,22
946610,7,Positive,36,7,43
946650,7,Positive,15,3,18
946660,8,Very Positive,77,14,91
946670,4,Mostly Negative,8,16,24
946700,5,Mixed,11,6,17
946780,7,Positive,17,2,19
946800,5,Mixed,13,8,21
946810,0,1 user reviews,0,1,1
946820,0,3 user reviews,3,0,3
946860,0,8 user reviews,8,0,8
946870,0,6 user reviews,6,0,6
946930,0,1 user reviews,1,0,1
946940,0,1 user reviews,1,0,1
946950,0,1 user reviews,1,0,1
946970,0,3 user reviews,3,0,3
946990,5,Mixed,33,17,50
947000,8,Very Positive,46,7,53
947060,0,2 user reviews,2,0,2
947070,0,2 user reviews,2,0,2
947250,0,2 user reviews,2,0,2
947260,0,2 user reviews,2,0,2
947270,0,1 user reviews,0,1,1
947290,0,7 user reviews,6,1,7
947300,8,Very Positive,398,53,451
947310,0,1 user reviews,0,1,1
947330,0,1 user reviews,1,0,1
947360,0,2 user reviews,2,0,2
947390,0,3 user reviews,2,1,3
947400,0,1 user reviews,1,0,1
947430,0,1 user reviews,1,0,1
947450,0,7 user reviews,7,0,7
947470,0,1 user reviews,0,1,1
947490,0,3 user reviews,2,1,3
947510,6,Mostly Positive,580,239,819
947550,0,2 user reviews,2,0,2
947600,8,Very Positive,244,28,272
947650,8,Very Positive,94,2,96
947660,7,Positive,34,0,34
947670,7,Positive,27,0,27
947680,0,2 user reviews,2,0,2
947700,0,6 user reviews,6,0,6
947730,0,1 user reviews,1,0,1
947820,7,Positive,11,0,11
947830,0,2 user reviews,1,1,2
947880,0,1 user reviews,1,0,1
947930,7,Positive,15,3,18
947950,0,5 user reviews,3,2,5
947960,0,2 user reviews,2,0,2
947970,0,7 user reviews,5,2,7
948020,7,Positive,19,2,21
948070,0,2 user reviews,1,1,2
948100,0,5 user reviews,5,0,5
948120,0,3 user reviews,0,3,3
948200,0,2 user reviews,0,2,2
948220,6,Mostly Positive,11,3,14
948240,0,8 user reviews,8,0,8
948250,0,1 user reviews,1,0,1
948320,6,Mostly Positive,28,12,40
948330,0,2 user reviews,1,1,2
948360,0,1 user reviews,1,0,1
948430,7,Positive,14,1,15
948470,5,Mixed,9,7,16
948630,8,Very Positive,344,48,392
948640,6,Mostly Positive,99,32,131
948650,0,2 user reviews,1,1,2
948660,0,2 user reviews,1,1,2
948680,8,Very Positive,161,17,178
948690,0,1 user reviews,0,1,1
948710,6,Mostly Positive,8,3,11
948720,0,9 user reviews,5,4,9
948730,0,3 user reviews,2,1,3
948740,8,Very Positive,1095,76,1171
948770,0,2 user reviews,2,0,2
948830,0,3 user reviews,3,0,3
948900,8,Very Positive,71,6,77
948960,7,Positive,24,6,30
948990,7,Positive,10,0,10
949030,7,Positive,17,2,19
949070,0,5 user reviews,4,1,5
949080,7,Positive,18,3,21
949081,6,Mostly Positive,10,3,13
949150,0,6 user reviews,5,1,6
949170,0,3 user reviews,1,2,3
949210,5,Mixed,11,5,16
949221,0,2 user reviews,1,1,2
949250,0,3 user reviews,3,0,3
949290,8,Very Positive,273,11,284
949450,0,2 user reviews,2,0,2
949500,5,Mixed,17,8,25
949510,0,1 user reviews,0,1,1
949520,0,1 user reviews,0,1,1
949530,6,Mostly Positive,18,5,23
949600,8,Very Positive,91,2,93
949610,0,1 user reviews,1,0,1
949630,5,Mixed,11,7,18
949640,0,2 user reviews,2,0,2
949641,0,1 user reviews,1,0,1
949642,0,1 user reviews,1,0,1
949650,0,8 user reviews,8,0,8
949670,7,Positive,12,1,13
949680,0,8 user reviews,4,4,8
949700,0,2 user reviews,1,1,2
949710,0,3 user reviews,0,3,3
949750,0,2 user reviews,1,1,2
949770,7,Positive,15,1,16
949780,0,1 user reviews,1,0,1
949790,7,Positive,37,5,42
949800,5,Mixed,10,6,16
949810,0,5 user reviews,1,4,5
949820,0,3 user reviews,3,0,3
949870,7,Positive,29,7,36
949880,0,8 user reviews,4,4,8
949890,0,4 user reviews,3,1,4
949930,0,1 user reviews,0,1,1
949960,0,9 user reviews,3,6,9
949970,0,3 user reviews,2,1,3
949990,7,Positive,10,2,12
950050,6,Mostly Positive,41,13,54
950130,0,4 user reviews,3,1,4
950140,7,Positive,30,3,33
950160,0,3 user reviews,1,2,3
950200,0,1 user reviews,1,0,1
950210,6,Mostly Positive,21,7,28
950300,7,Positive,38,3,41
950310,0,6 user reviews,6,0,6
950330,0,1 user reviews,0,1,1
950360,5,Mixed,17,18,35
950370,0,8 user reviews,4,4,8
950400,5,Mixed,8,7,15
950490,0,1 user reviews,1,0,1
950510,0,1 user reviews,0,1,1
950530,0,1 user reviews,1,0,1
950556,0,6 user reviews,6,0,6
950557,6,Mostly Positive,11,3,14
950558,7,Positive,9,1,10
950559,0,8 user reviews,6,2,8
950560,0,7 user reviews,7,0,7
950561,0,5 user reviews,5,0,5
950562,0,7 user reviews,5,2,7
950590,0,1 user reviews,1,0,1
950670,5,Mixed,1332,855,2187
950700,5,Mixed,14,9,23
950740,8,Very Positive,93,13,106
950750,0,1 user reviews,1,0,1
950760,7,Positive,10,0,10
950810,0,5 user reviews,3,2,5
950820,7,Positive,18,2,20
950850,7,Positive,18,3,21
950860,0,1 user reviews,1,0,1
950890,0,3 user reviews,3,0,3
950950,0,1 user reviews,0,1,1
950990,5,Mixed,45,24,69
951000,8,Very Positive,305,18,323
951010,0,4 user reviews,3,1,4
951030,0,5 user reviews,3,2,5
951050,0,2 user reviews,2,0,2
951110,0,2 user reviews,1,1,2
951130,0,2 user reviews,2,0,2
951140,0,4 user reviews,3,1,4
951160,0,1 user reviews,0,1,1
951190,0,3 user reviews,3,0,3
951220,0,2 user reviews,2,0,2
951240,6,Mostly Positive,22,7,29
951260,6,Mostly Positive,75,19,94
951320,0,5 user reviews,1,4,5
951330,6,Mostly Positive,26,8,34
951350,0,1 user reviews,1,0,1
951360,0,3 user reviews,2,1,3
951370,7,Positive,12,3,15
951420,0,1 user reviews,1,0,1
951430,8,Very Positive,88,12,100
951440,8,Very Positive,692,145,837
951450,0,4 user reviews,2,2,4
951460,7,Positive,14,1,15
951500,0,6 user reviews,1,5,6
951510,0,9 user reviews,5,4,9
951550,0,1 user reviews,0,1,1
951610,0,2 user reviews,2,0,2
951640,5,Mixed,6,6,12
951650,7,Positive,32,1,33
951660,0,3 user reviews,3,0,3
951664,0,1 user reviews,1,0,1
951670,8,Very Positive,144,29,173
951680,0,9 user reviews,7,2,9
951700,0,9 user reviews,8,1,9
951740,7,Positive,34,5,39
951750,7,Positive,22,1,23
951760,0,6 user reviews,1,5,6
951780,0,2 user reviews,0,2,2
951830,7,Positive,10,0,10
951870,0,2 user reviews,1,1,2
951920,0,1 user reviews,0,1,1
951940,7,Positive,21,4,25
952010,0,8 user reviews,4,4,8
952020,5,Mixed,6,8,14
952030,0,8 user reviews,1,7,8
952040,8,Very Positive,343,54,397
952050,0,9 user reviews,9,0,9
952060,6,Mostly Positive,6305,2156,8461
952070,5,Mixed,491,669,1160
952080,7,Positive,8,2,10
952130,0,5 user reviews,5,0,5
952200,7,Positive,40,5,45
952230,0,3 user reviews,2,1,3
952290,0,9 user reviews,9,0,9
952330,0,2 user reviews,2,0,2
952390,0,4 user reviews,1,3,4
952400,0,9 user reviews,7,2,9
952420,7,Positive,10,0,10
952460,5,Mixed,11,6,17
952490,7,Positive,12,0,12
952540,8,Very Positive,63,7,70
952570,0,3 user reviews,1,2,3
952650,0,3 user reviews,1,2,3
952651,0,1 user reviews,0,1,1
952670,0,3 user reviews,3,0,3
952680,0,1 user reviews,0,1,1
952860,8,Very Positive,143,33,176
952890,8,Very Positive,70,12,82
952891,7,Positive,23,1,24
952892,7,Positive,14,0,14
952900,0,1 user reviews,1,0,1
952910,0,1 user reviews,1,0,1
952920,0,9 user reviews,6,3,9
952930,0,5 user reviews,3,2,5
952950,6,Mostly Positive,42,12,54
953020,0,4 user reviews,1,3,4
953050,0,9 user reviews,1,8,9
953060,5,Mixed,5,6,11
953080,7,Positive,12,0,12
953120,0,1 user reviews,0,1,1
953150,0,2 user reviews,1,1,2
953190,0,1 user reviews,0,1,1
953220,0,1 user reviews,1,0,1
953230,8,Very Positive,82,7,89
953240,0,2 user reviews,1,1,2
953270,7,Positive,34,5,39
953340,0,1 user reviews,1,0,1
953370,5,Mixed,47,33,80
953450,7,Positive,19,1,20
953490,8,Very Positive,4611,322,4933
953580,5,Mixed,191,136,327
953610,0,9 user reviews,5,4,9
953640,0,1 user reviews,0,1,1
953660,6,Mostly Positive,31,13,44
953681,0,4 user reviews,3,1,4
953690,7,Positive,11,2,13
953700,0,1 user reviews,1,0,1
953740,0,5 user reviews,3,2,5
953750,0,1 user reviews,0,1,1
953790,0,1 user reviews,0,1,1
953800,0,1 user reviews,1,0,1
953820,0,4 user reviews,4,0,4
953840,6,Mostly Positive,87,22,109
953870,5,Mixed,30,16,46
953900,7,Positive,20,4,24
953920,0,1 user reviews,1,0,1
953940,6,Mostly Positive,91,28,119
953950,0,6 user reviews,6,0,6
953980,0,3 user reviews,2,1,3
953981,0,6 user reviews,2,4,6
953990,5,Mixed,13,6,19
954000,5,Mixed,9,6,15
954010,0,4 user reviews,4,0,4
954030,0,9 user reviews,7,2,9
954060,8,Very Positive,82,3,85
954080,6,Mostly Positive,21,9,30
954101,0,5 user reviews,4,1,5
954103,7,Positive,11,0,11
954150,7,Positive,22,4,26
954240,0,3 user reviews,3,0,3
954270,7,Positive,17,4,21
954280,8,Very Positive,62,5,67
954420,0,2 user reviews,2,0,2
954530,5,Mixed,7,7,14
954560,7,Positive,14,1,15
954590,7,Positive,13,2,15
954600,0,2 user reviews,2,0,2
954601,0,1 user reviews,1,0,1
954602,0,5 user reviews,4,1,5
954603,0,9 user reviews,7,2,9
954606,0,1 user reviews,1,0,1
954609,0,1 user reviews,1,0,1
954610,6,Mostly Positive,131,50,181
954650,8,Very Positive,543,100,643
954690,0,4 user reviews,4,0,4
954720,0,8 user reviews,5,3,8
954740,8,Very Positive,2682,208,2890
954800,0,1 user reviews,1,0,1
954810,5,Mixed,10,6,16
954860,0,8 user reviews,7,1,8
954870,8,Very Positive,316,40,356
954880,6,Mostly Positive,12,4,16
954920,0,2 user reviews,2,0,2
954950,0,1 user reviews,1,0,1
954970,0,2 user reviews,0,2,2
955050,8,Very Positive,3494,333,3827
955060,5,Mixed,187,111,298
955070,5,Mixed,5,7,12
955120,0,1 user reviews,1,0,1
955130,7,Positive,28,2,30
955170,0,4 user reviews,3,1,4
955180,0,2 user reviews,2,0,2
955182,0,1 user reviews,1,0,1
955190,0,4 user reviews,4,0,4
955210,0,1 user reviews,1,0,1
955250,0,6 user reviews,5,1,6
955260,0,9 user reviews,7,2,9
955300,0,1 user reviews,0,1,1
955320,8,Very Positive,61,4,65
955360,5,Mixed,5,5,10
955370,7,Positive,10,1,11
955380,0,6 user reviews,1,5,6
955400,7,Positive,19,2,21
955410,7,Positive,10,0,10
955470,7,Positive,23,2,25
955490,0,4 user reviews,3,1,4
955540,0,1 user reviews,1,0,1
955550,0,2 user reviews,2,0,2
955560,8,Very Positive,428,33,461
955570,0,1 user reviews,1,0,1
955580,5,Mixed,16,9,25
955590,0,1 user reviews,1,0,1
955600,0,3 user reviews,1,2,3
955610,0,3 user reviews,3,0,3
955640,7,Positive,16,2,18
955670,0,4 user reviews,3,1,4
955700,0,3 user reviews,3,0,3
955710,0,6 user reviews,6,0,6
955740,8,Very Positive,204,4,208
955790,0,6 user reviews,6,0,6
955830,0,2 user reviews,2,0,2
955840,0,1 user reviews,1,0,1
955860,0,3 user reviews,2,1,3
955890,0,1 user reviews,0,1,1
955900,8,Very Positive,124,11,135
955980,0,1 user reviews,0,1,1
955990,0,3 user reviews,2,1,3
956000,0,1 user reviews,1,0,1
956010,7,Positive,9,2,11
956030,8,Very Positive,217,17,234
956060,4,Mostly Negative,9,15,24
956070,0,7 user reviews,7,0,7
956090,0,5 user reviews,5,0,5
956100,0,6 user reviews,5,1,6
956150,0,2 user reviews,0,2,2
956200,0,3 user reviews,3,0,3
956210,0,4 user reviews,3,1,4
956240,0,1 user reviews,1,0,1
956310,0,5 user reviews,5,0,5
956350,0,2 user reviews,2,0,2
956360,0,5 user reviews,5,0,5
956380,0,5 user reviews,5,0,5
956390,0,1 user reviews,1,0,1
956400,0,1 user reviews,1,0,1
956430,0,2 user reviews,1,1,2
956450,8,Very Positive,194,15,209
956480,0,4 user reviews,1,3,4
956500,7,Positive,21,3,24
956550,0,4 user reviews,2,2,4
956560,7,Positive,18,1,19
956590,0,1 user reviews,0,1,1
956600,6,Mostly Positive,33,12,45
956620,0,6 user reviews,5,1,6
956640,0,2 user reviews,2,0,2
956650,0,1 user reviews,1,0,1
956680,8,Very Positive,714,82,796
956726,0,1 user reviews,1,0,1
956769,0,1 user reviews,1,0,1
956990,0,2 user reviews,2,0,2
957050,5,Mixed,28,38,66
957070,0,9 user reviews,8,1,9
957080,0,5 user reviews,2,3,5
957110,7,Positive,13,2,15
957120,0,8 user reviews,8,0,8
957122,0,3 user reviews,2,1,3
957124,0,4 user reviews,4,0,4
957126,0,7 user reviews,5,2,7
957280,0,1 user reviews,1,0,1
957350,0,1 user reviews,1,0,1
957390,0,3 user reviews,2,1,3
957410,5,Mixed,8,8,16
957430,6,Mostly Positive,8,3,11
957440,6,Mostly Positive,12,4,16
957530,0,1 user reviews,1,0,1
957537,0,1 user reviews,1,0,1
957538,0,1 user reviews,1,0,1
957570,0,7 user reviews,7,0,7
957630,0,3 user reviews,3,0,3
957680,0,8 user reviews,8,0,8
957690,6,Mostly Positive,142,55,197
957695,0,1 user reviews,1,0,1
957710,5,Mixed,67,38,105
957720,8,Very Positive,128,22,150
957730,0,1 user reviews,1,0,1
957770,0,3 user reviews,3,0,3
957780,5,Mixed,7,5,12
957790,6,Mostly Positive,530,168,698
957820,7,Positive,20,2,22
957850,0,3 user reviews,3,0,3
957890,0,7 user reviews,6,1,7
957930,0,1 user reviews,0,1,1
957970,0,1 user reviews,0,1,1
958050,7,Positive,20,3,23
958090,0,2 user reviews,2,0,2
958130,0,2 user reviews,0,2,2
958200,0,2 user reviews,2,0,2
958210,5,Mixed,14,7,21
958220,0,2 user reviews,2,0,2
958230,0,8 user reviews,1,7,8
958280,5,Mixed,5,5,10
958300,0,7 user reviews,5,2,7
958310,0,4 user reviews,2,2,4
958320,5,Mixed,46,27,73
958370,8,Very Positive,129,13,142
958380,0,2 user reviews,2,0,2
958381,0,2 user reviews,2,0,2
958400,5,Mixed,244,214,458
958480,6,Mostly Positive,196,57,253
958490,0,4 user reviews,3,1,4
958640,0,1 user reviews,1,0,1
958690,0,7 user reviews,7,0,7
958730,0,2 user reviews,0,2,2
958740,8,Very Positive,47,10,57
958790,0,5 user reviews,5,0,5
958870,0,1 user reviews,1,0,1
958880,7,Positive,18,2,20
958900,0,1 user reviews,0,1,1
958950,0,1 user reviews,1,0,1
958960,0,6 user reviews,0,6,6
958980,7,Positive,11,1,12
958990,0,2 user reviews,1,1,2
959000,7,Positive,33,2,35
959020,0,3 user reviews,3,0,3
959030,0,5 user reviews,3,2,5
959050,7,Positive,22,2,24
959060,0,1 user reviews,1,0,1
959090,0,2 user reviews,2,0,2
959130,0,5 user reviews,4,1,5
959150,7,Positive,12,2,14
959160,7,Positive,15,0,15
959200,0,8 user reviews,5,3,8
959260,0,2 user reviews,1,1,2
959340,0,1 user reviews,0,1,1
959350,7,Positive,11,1,12
959400,0,4 user reviews,4,0,4
959410,7,Positive,40,1,41
959520,5,Mixed,169,84,253
959540,0,2 user reviews,1,1,2
959590,0,1 user reviews,1,0,1
959710,0,6 user reviews,6,0,6
959730,0,3 user reviews,3,0,3
959770,0,4 user reviews,2,2,4
959830,0,2 user reviews,2,0,2
959850,0,3 user reviews,2,1,3
959870,0,1 user reviews,1,0,1
959890,8,Very Positive,51,3,54
959920,0,6 user reviews,3,3,6
960030,0,5 user reviews,5,0,5
960040,6,Mostly Positive,18,6,24
960090,9,Overwhelmingly Positive,23546,1071,24617
960120,0,1 user reviews,0,1,1
960140,0,1 user reviews,1,0,1
960150,0,5 user reviews,3,2,5
960170,8,Very Positive,881,155,1036
960190,8,Very Positive,48,12,60
960200,0,4 user reviews,2,2,4
960220,0,5 user reviews,5,0,5
960240,0,2 user reviews,2,0,2
960300,0,1 user reviews,0,1,1
960310,7,Positive,39,0,39
960360,6,Mostly Positive,10,4,14
960420,7,Positive,21,1,22
960550,0,4 user reviews,4,0,4
960590,0,7 user reviews,5,2,7
960600,0,2 user reviews,1,1,2
960610,0,6 user reviews,1,5,6
960660,0,2 user reviews,1,1,2
960680,4,Mostly Negative,5,9,14
960690,9,Overwhelmingly Positive,1659,72,1731
960700,0,3 user reviews,3,0,3
960710,7,Positive,43,4,47
960740,5,Mixed,23,17,40
960820,0,2 user reviews,2,0,2
960831,8,Very Positive,51,9,60
960900,0,5 user reviews,4,1,5
960910,8,Very Positive,407,92,499
960920,4,Mostly Negative,83,148,231
960980,8,Very Positive,188,35,223
960990,8,Very Positive,753,104,857
961000,0,2 user reviews,2,0,2
961010,7,Positive,9,1,10
961040,5,Mixed,9,8,17
961060,0,3 user reviews,2,1,3
961110,0,2 user reviews,2,0,2
961150,5,Mixed,15,10,25
961220,0,7 user reviews,6,1,7
961230,0,1 user reviews,1,0,1
961240,0,1 user reviews,0,1,1
961410,0,1 user reviews,1,0,1
961420,6,Mostly Positive,15,5,20
961490,8,Very Positive,82,13,95
961510,7,Positive,19,3,22
961560,0,2 user reviews,1,1,2
961570,0,1 user reviews,1,0,1
961580,0,1 user reviews,1,0,1
961620,8,Very Positive,76,10,86
961630,0,1 user reviews,1,0,1
961640,7,Positive,15,1,16
961660,8,Very Positive,70,2,72
961700,0,6 user reviews,4,2,6
961710,0,1 user reviews,0,1,1
961720,0,2 user reviews,0,2,2
961730,0,5 user reviews,2,3,5
961740,0,2 user reviews,1,1,2
961840,7,Positive,18,4,22
961850,0,1 user reviews,1,0,1
961860,5,Mixed,22,10,32
961920,0,1 user reviews,0,1,1
961930,8,Very Positive,182,24,206
961980,0,1 user reviews,1,0,1
961990,0,6 user reviews,6,0,6
962050,0,3 user reviews,1,2,3
962060,0,1 user reviews,1,0,1
962130,8,Very Positive,5853,781,6634
962150,7,Positive,13,3,16
962220,7,Positive,9,1,10
962250,0,1 user reviews,1,0,1
962280,0,1 user reviews,1,0,1
962306,0,1 user reviews,0,1,1
962370,0,1 user reviews,1,0,1
962380,0,1 user reviews,1,0,1
962400,8,Very Positive,298,38,336
962500,0,1 user reviews,1,0,1
962510,0,5 user reviews,4,1,5
962540,0,8 user reviews,6,2,8
962580,6,Mostly Positive,141,47,188
962610,0,2 user reviews,2,0,2
962630,5,Mixed,7,7,14
962680,0,1 user reviews,1,0,1
962710,0,4 user reviews,2,2,4
962730,8,Very Positive,5633,829,6462
962750,6,Mostly Positive,141,42,183
962850,4,Mostly Negative,7,12,19
962860,0,2 user reviews,0,2,2
962921,0,1 user reviews,1,0,1
962924,0,1 user reviews,1,0,1
962960,0,4 user reviews,4,0,4
962970,5,Mixed,28,13,41
963000,8,Very Positive,651,35,686
963020,0,1 user reviews,1,0,1
963040,0,1 user reviews,0,1,1
963060,0,4 user reviews,4,0,4
963110,0,3 user reviews,0,3,3
963150,0,1 user reviews,0,1,1
963170,0,1 user reviews,0,1,1
963200,0,4 user reviews,1,3,4
963230,7,Positive,15,1,16
963260,0,6 user reviews,5,1,6
963280,7,Positive,45,3,48
963300,5,Mixed,10,8,18
963330,8,Very Positive,46,7,53
963370,0,4 user reviews,2,2,4
963400,5,Mixed,77,34,111
963450,8,Very Positive,213,36,249
963470,0,2 user reviews,2,0,2
963490,0,4 user reviews,3,1,4
963500,4,Mostly Negative,2,8,10
963570,0,2 user reviews,2,0,2
963660,0,6 user reviews,4,2,6
963680,7,Positive,15,1,16
963690,8,Very Positive,422,31,453
963710,9,Overwhelmingly Positive,1145,55,1200
963860,0,5 user reviews,4,1,5
963900,0,6 user reviews,4,2,6
963930,8,Very Positive,793,195,988
963960,0,2 user reviews,2,0,2
964050,0,2 user reviews,0,2,2
964070,0,2 user reviews,2,0,2
964080,5,Mixed,15,7,22
964100,0,1 user reviews,1,0,1
964110,0,2 user reviews,2,0,2
964130,7,Positive,36,8,44
964170,0,1 user reviews,0,1,1
964210,0,4 user reviews,4,0,4
964220,0,3 user reviews,3,0,3
964230,0,9 user reviews,7,2,9
964340,0,5 user reviews,4,1,5
964350,0,1 user reviews,1,0,1
964370,0,2 user reviews,2,0,2
964390,0,7 user reviews,2,5,7
964420,0,1 user reviews,0,1,1
964460,6,Mostly Positive,8,3,11
964530,0,2 user reviews,1,1,2
964570,8,Very Positive,116,24,140
964590,0,2 user reviews,2,0,2
964630,0,1 user reviews,1,0,1
964650,6,Mostly Positive,169,47,216
964700,0,6 user reviews,5,1,6
964750,0,3 user reviews,1,2,3
964770,0,5 user reviews,3,2,5
964810,0,3 user reviews,3,0,3
964880,0,1 user reviews,1,0,1
964920,0,2 user reviews,0,2,2
964930,0,1 user reviews,1,0,1
964990,7,Positive,25,1,26
965000,0,3 user reviews,1,2,3
965010,7,Positive,18,2,20
965030,0,4 user reviews,3,1,4
965060,0,9 user reviews,5,4,9
965080,0,1 user reviews,0,1,1
965110,0,2 user reviews,1,1,2
965120,0,1 user reviews,0,1,1
965130,0,2 user reviews,1,1,2
965220,8,Very Positive,382,50,432
965230,8,Very Positive,286,43,329
965240,0,2 user reviews,2,0,2
965300,6,Mostly Positive,66,17,83
965310,5,Mixed,63,30,93
965320,5,Mixed,58,55,113
965340,7,Positive,9,1,10
965350,0,1 user reviews,1,0,1
965410,0,3 user reviews,2,1,3
965430,0,2 user reviews,2,0,2
965470,0,7 user reviews,7,0,7
965480,8,Very Positive,112,27,139
965490,7,Positive,11,0,11
965510,0,6 user reviews,6,0,6
965580,8,Very Positive,550,34,584
965590,8,Very Positive,68,0,68
965600,8,Very Positive,72,6,78
965610,7,Positive,22,2,24
965640,7,Positive,28,5,33
965670,8,Very Positive,131,9,140
965680,8,Very Positive,76,6,82
965730,0,1 user reviews,0,1,1
965810,8,Very Positive,61,7,68
965820,0,6 user reviews,6,0,6
965830,8,Very Positive,45,5,50
965840,0,2 user reviews,1,1,2
965860,0,6 user reviews,6,0,6
965900,0,1 user reviews,1,0,1
965940,0,6 user reviews,3,3,6
965960,0,2 user reviews,2,0,2
966000,5,Mixed,11,5,16
966010,7,Positive,13,1,14
966020,0,4 user reviews,4,0,4
966050,0,1 user reviews,0,1,1
966070,7,Positive,24,2,26
966090,7,Positive,12,3,15
966140,0,1 user reviews,0,1,1
966180,0,3 user reviews,3,0,3
966210,0,5 user reviews,4,1,5
966240,0,3 user reviews,2,1,3
966250,0,1 user reviews,1,0,1
966320,8,Very Positive,492,7,499
966330,8,Very Positive,587,119,706
966350,7,Positive,33,0,33
966360,7,Positive,14,0,14
966370,0,3 user reviews,1,2,3
966400,7,Positive,16,3,19
966430,6,Mostly Positive,126,34,160
966490,0,1 user reviews,1,0,1
966497,0,1 user reviews,1,0,1
966529,0,1 user reviews,1,0,1
966530,5,Mixed,16,13,29
966560,5,Mixed,29,21,50
966580,0,3 user reviews,3,0,3
966590,0,7 user reviews,7,0,7
966600,0,1 user reviews,0,1,1
966610,8,Very Positive,85,21,106
966630,7,Positive,37,1,38
966660,0,7 user reviews,6,1,7
966670,7,Positive,12,1,13
966680,8,Very Positive,165,9,174
966690,7,Positive,29,5,34
966720,5,Mixed,8,4,12
966750,0,1 user reviews,0,1,1
966760,0,3 user reviews,2,1,3
966840,0,3 user reviews,3,0,3
966841,0,2 user reviews,1,1,2
966842,0,1 user reviews,1,0,1
966843,0,1 user reviews,1,0,1
966845,0,1 user reviews,1,0,1
966870,0,4 user reviews,4,0,4
967050,8,Very Positive,3856,400,4256
967060,0,1 user reviews,1,0,1
967100,0,4 user reviews,3,1,4
967130,8,Very Positive,40,10,50
967150,0,1 user reviews,0,1,1
967170,0,8 user reviews,0,8,8
967180,0,1 user reviews,0,1,1
967210,0,1 user reviews,1,0,1
967240,7,Positive,30,7,37
967250,6,Mostly Positive,71,22,93
967271,0,1 user reviews,1,0,1
967272,0,3 user reviews,2,1,3
967274,0,2 user reviews,1,1,2
967275,4,Mostly Negative,3,10,13
967276,0,1 user reviews,0,1,1
967278,0,1 user reviews,0,1,1
967279,0,4 user reviews,1,3,4
967280,0,6 user reviews,6,0,6
967281,0,5 user reviews,3,2,5
967282,7,Positive,12,1,13
967283,0,3 user reviews,2,1,3
967285,0,1 user reviews,1,0,1
967287,0,4 user reviews,2,2,4
967289,0,3 user reviews,1,2,3
967290,0,2 user reviews,2,0,2
967300,0,1 user reviews,1,0,1
967320,0,1 user reviews,0,1,1
967330,8,Very Positive,45,6,51
967350,0,5 user reviews,4,1,5
967370,0,6 user reviews,5,1,6
967380,7,Positive,38,6,44
967400,0,6 user reviews,3,3,6
967410,6,Mostly Positive,48,18,66
967430,0,4 user reviews,2,2,4
967440,0,5 user reviews,1,4,5
967450,0,3 user reviews,1,2,3
967910,0,2 user reviews,2,0,2
967940,0,2 user reviews,2,0,2
968170,7,Positive,10,0,10
968210,0,3 user reviews,3,0,3
968250,8,Very Positive,113,13,126
968270,0,3 user reviews,3,0,3
968290,7,Positive,32,2,34
968300,0,6 user reviews,6,0,6
968320,0,2 user reviews,2,0,2
968350,7,Positive,27,0,27
968360,0,6 user reviews,4,2,6
968370,7,Positive,26,4,30
968380,0,3 user reviews,2,1,3
968390,8,Very Positive,47,7,54
968450,0,3 user reviews,1,2,3
968460,0,6 user reviews,4,2,6
968470,0,8 user reviews,8,0,8
968490,0,2 user reviews,2,0,2
968540,0,5 user reviews,1,4,5
968570,0,2 user reviews,1,1,2
968580,0,3 user reviews,1,2,3
968680,0,1 user reviews,1,0,1
968730,7,Positive,8,2,10
968760,7,Positive,24,3,27
968790,8,Very Positive,158,33,191
968820,6,Mostly Positive,25,9,34
968830,0,4 user reviews,3,1,4
968840,0,5 user reviews,3,2,5
968870,6,Mostly Positive,70,27,97
968880,0,5 user reviews,4,1,5
968910,0,1 user reviews,1,0,1
968911,0,3 user reviews,3,0,3
968920,0,4 user reviews,1,3,4
968940,4,Mostly Negative,6,11,17
968950,6,Mostly Positive,15,6,21
968960,0,1 user reviews,1,0,1
968970,6,Mostly Positive,223,70,293
968990,0,2 user reviews,1,1,2
969020,8,Very Positive,73,14,87
969030,0,1 user reviews,1,0,1
969060,0,2 user reviews,1,1,2
969130,0,5 user reviews,5,0,5
969140,0,3 user reviews,2,1,3
969200,0,1 user reviews,0,1,1
969220,0,4 user reviews,4,0,4
969230,0,4 user reviews,1,3,4
969250,0,9 user reviews,7,2,9
969270,7,Positive,10,0,10
969340,0,3 user reviews,3,0,3
969350,0,3 user reviews,3,0,3
969480,7,Positive,21,0,21
969530,0,3 user reviews,3,0,3
969540,0,8 user reviews,7,1,8
969560,5,Mixed,10,5,15
969570,5,Mixed,12,17,29
969580,0,8 user reviews,4,4,8
969590,0,9 user reviews,7,2,9
969680,0,1 user reviews,1,0,1
969690,7,Positive,12,1,13
969700,8,Very Positive,126,7,133
969710,5,Mixed,7,6,13
969730,0,1 user reviews,1,0,1
969740,0,4 user reviews,4,0,4
969770,0,1 user reviews,1,0,1
969780,0,1 user reviews,1,0,1
969790,0,1 user reviews,1,0,1
969860,0,2 user reviews,0,2,2
969870,0,4 user reviews,1,3,4
969880,5,Mixed,11,7,18
969890,0,6 user reviews,6,0,6
969900,0,5 user reviews,4,1,5
969940,0,2 user reviews,0,2,2
969950,0,3 user reviews,1,2,3
969970,5,Mixed,7,6,13
969990,9,Overwhelmingly Positive,4384,161,4545
970000,0,2 user reviews,1,1,2
970060,7,Positive,13,0,13
970070,7,Positive,35,0,35
970090,0,5 user reviews,5,0,5
970100,7,Positive,10,1,11
970110,0,5 user reviews,5,0,5
970130,5,Mixed,7,4,11
970140,7,Positive,16,2,18
970150,0,5 user reviews,1,4,5
970170,0,3 user reviews,3,0,3
970190,5,Mixed,20,14,34
970200,0,3 user reviews,3,0,3
970240,0,4 user reviews,4,0,4
970260,0,3 user reviews,1,2,3
970300,0,4 user reviews,4,0,4
970360,0,1 user reviews,0,1,1
970400,6,Mostly Positive,20,8,28
970440,0,3 user reviews,3,0,3
970470,0,2 user reviews,2,0,2
970510,0,5 user reviews,5,0,5
970550,0,1 user reviews,0,1,1
970560,8,Very Positive,102,1,103
970570,8,Very Positive,410,36,446
970580,0,6 user reviews,5,1,6
970600,5,Mixed,8,4,12
970640,7,Positive,12,1,13
970650,0,2 user reviews,0,2,2
970660,3,Negative,4,27,31
970670,0,2 user reviews,2,0,2
970690,0,1 user reviews,0,1,1
970710,0,8 user reviews,3,5,8
970760,0,3 user reviews,3,0,3
970810,0,2 user reviews,2,0,2
970830,8,Very Positive,442,93,535
970850,0,5 user reviews,5,0,5
970870,0,6 user reviews,5,1,6
970880,0,3 user reviews,3,0,3
970890,0,3 user reviews,3,0,3
970900,0,3 user reviews,3,0,3
970910,0,2 user reviews,2,0,2
970930,0,1 user reviews,1,0,1
970940,0,5 user reviews,1,4,5
970960,6,Mostly Positive,155,49,204
970970,3,Negative,1,10,11
971060,0,8 user reviews,4,4,8
971070,0,7 user reviews,6,1,7
971080,0,1 user reviews,1,0,1
971090,0,3 user reviews,1,2,3
971100,0,2 user reviews,2,0,2
971120,5,Mixed,41,18,59
971130,0,2 user reviews,2,0,2
971150,0,1 user reviews,1,0,1
971240,0,1 user reviews,1,0,1
971242,0,3 user reviews,2,1,3
971250,0,1 user reviews,1,0,1
971251,0,2 user reviews,2,0,2
971280,0,2 user reviews,2,0,2
971350,5,Mixed,25,22,47
971430,7,Positive,39,1,40
971460,5,Mixed,19,14,33
971480,7,Positive,15,3,18
971500,7,Positive,13,0,13
971540,0,5 user reviews,5,0,5
971570,0,2 user reviews,1,1,2
971600,7,Positive,16,0,16
971610,0,4 user reviews,3,1,4
971620,8,Very Positive,192,35,227
971630,5,Mixed,24,23,47
971640,0,1 user reviews,1,0,1
971650,5,Mixed,13,13,26
971680,8,Very Positive,318,14,332
971690,7,Positive,23,0,23
971740,0,3 user reviews,3,0,3
971750,0,3 user reviews,2,1,3
971760,5,Mixed,18,27,45
971770,0,2 user reviews,2,0,2
971780,0,3 user reviews,3,0,3
971790,5,Mixed,240,187,427
971880,0,7 user reviews,5,2,7
971900,0,4 user reviews,1,3,4
971910,0,1 user reviews,0,1,1
971924,8,Very Positive,56,3,59
971925,8,Very Positive,124,15,139
971950,0,1 user reviews,1,0,1
971995,7,Positive,38,3,41
971996,9,Overwhelmingly Positive,769,22,791
971998,8,Very Positive,139,9,148
971999,8,Very Positive,81,6,87
972080,0,3 user reviews,3,0,3
972150,0,2 user reviews,2,0,2
972160,7,Positive,15,2,17
972170,5,Mixed,159,73,232
972180,0,4 user reviews,2,2,4
972230,0,4 user reviews,2,2,4
972260,0,2 user reviews,1,1,2
972261,0,2 user reviews,1,1,2
972280,0,5 user reviews,3,2,5
972290,0,7 user reviews,5,2,7
972350,7,Positive,32,4,36
972351,4,Mostly Negative,23,52,75
972370,6,Mostly Positive,24,9,33
972420,0,1 user reviews,1,0,1
972430,0,6 user reviews,3,3,6
972480,0,2 user reviews,1,1,2
972520,0,3 user reviews,3,0,3
972620,0,2 user reviews,1,1,2
972650,0,1 user reviews,1,0,1
972660,9,Overwhelmingly Positive,1763,77,1840
972740,6,Mostly Positive,104,27,131
972760,7,Positive,13,3,16
972770,7,Positive,31,1,32
972890,0,1 user reviews,1,0,1
972910,7,Positive,9,2,11
972920,4,Mostly Negative,3,10,13
972940,0,3 user reviews,3,0,3
973000,5,Mixed,19,12,31
973040,0,3 user reviews,1,2,3
973050,7,Positive,19,3,22
973060,0,7 user reviews,6,1,7
973090,5,Mixed,27,24,51
973100,0,7 user reviews,7,0,7
973110,0,3 user reviews,1,2,3
973170,0,5 user reviews,4,1,5
973220,8,Very Positive,69,2,71
973240,5,Mixed,17,8,25
973260,0,4 user reviews,1,3,4
973270,0,1 user reviews,1,0,1
973300,0,6 user reviews,6,0,6
973360,0,1 user reviews,1,0,1
973370,0,1 user reviews,1,0,1
973410,0,7 user reviews,7,0,7
973440,0,2 user reviews,2,0,2
973550,0,2 user reviews,1,1,2
973580,6,Mostly Positive,917,276,1193
973590,0,7 user reviews,4,3,7
973600,7,Positive,38,9,47
973610,0,2 user reviews,2,0,2
973611,0,4 user reviews,4,0,4
973640,0,2 user reviews,0,2,2
973700,5,Mixed,21,10,31
973720,0,2 user reviews,0,2,2
973740,0,2 user reviews,2,0,2
973750,0,8 user reviews,6,2,8
973760,8,Very Positive,2122,298,2420
973770,0,1 user reviews,0,1,1
973800,5,Mixed,9,10,19
973830,0,1 user reviews,1,0,1
973840,0,1 user reviews,1,0,1
973850,7,Positive,18,1,19
973910,6,Mostly Positive,23,7,30
974040,0,4 user reviews,3,1,4
974110,0,8 user reviews,8,0,8
974160,0,2 user reviews,1,1,2
974180,0,8 user reviews,5,3,8
974240,0,3 user reviews,2,1,3
974250,0,1 user reviews,0,1,1
974270,0,1 user reviews,1,0,1
974290,0,9 user reviews,8,1,9
974300,7,Positive,11,0,11
974301,0,5 user reviews,5,0,5
974310,0,1 user reviews,1,0,1
974320,0,7 user reviews,3,4,7
974330,0,4 user reviews,1,3,4
974350,0,1 user reviews,1,0,1
974351,0,4 user reviews,1,3,4
974353,0,2 user reviews,2,0,2
974354,0,1 user reviews,1,0,1
974362,0,1 user reviews,1,0,1
974364,0,1 user reviews,1,0,1
974370,0,8 user reviews,3,5,8
974390,7,Positive,12,2,14
974400,5,Mixed,7,10,17
974430,0,1 user reviews,1,0,1
974450,0,1 user reviews,1,0,1
974530,0,4 user reviews,2,2,4
974570,8,Very Positive,46,9,55
974600,0,7 user reviews,6,1,7
974610,6,Mostly Positive,36,14,50
974620,0,8 user reviews,4,4,8
974650,7,Positive,35,0,35
974670,0,5 user reviews,2,3,5
974680,0,7 user reviews,4,3,7
974720,0,7 user reviews,5,2,7
974721,4,Mostly Negative,5,8,13
974722,0,6 user reviews,4,2,6
974723,7,Positive,10,2,12
974724,0,3 user reviews,2,1,3
974725,0,4 user reviews,3,1,4
974726,5,Mixed,17,8,25
974740,0,2 user reviews,2,0,2
974850,0,1 user reviews,1,0,1
974860,0,2 user reviews,2,0,2
974870,7,Positive,16,0,16
974910,8,Very Positive,65,3,68
974920,0,2 user reviews,1,1,2
974970,0,6 user reviews,6,0,6
975000,6,Mostly Positive,20,6,26
975020,5,Mixed,11,9,20
975100,0,2 user reviews,1,1,2
975120,5,Mixed,6,4,10
975150,7,Positive,27,4,31
975200,0,2 user reviews,1,1,2
975220,0,2 user reviews,0,2,2
975230,7,Positive,14,2,16
975240,6,Mostly Positive,43,11,54
975270,7,Positive,44,2,46
975280,7,Positive,8,2,10
975290,7,Positive,11,0,11
975360,0,7 user reviews,6,1,7
975390,7,Positive,14,3,17
975400,8,Very Positive,207,50,257
975410,6,Mostly Positive,17,5,22
975430,7,Positive,9,1,10
975470,5,Mixed,29,16,45
975510,6,Mostly Positive,58,21,79
975530,0,2 user reviews,1,1,2
975550,0,3 user reviews,2,1,3
975560,7,Positive,16,2,18
975600,0,5 user reviews,4,1,5
975620,0,1 user reviews,1,0,1
975640,5,Mixed,7,7,14
975660,5,Mixed,5,6,11
975680,5,Mixed,66,44,110
975690,0,2 user reviews,2,0,2
975710,0,1 user reviews,1,0,1
975760,6,Mostly Positive,19,6,25
975770,0,5 user reviews,4,1,5
975800,0,2 user reviews,2,0,2
975910,0,6 user reviews,5,1,6
975950,7,Positive,24,6,30
976010,8,Very Positive,160,15,175
976030,7,Positive,36,6,42
976050,0,1 user reviews,1,0,1
976070,0,1 user reviews,0,1,1
976080,0,2 user reviews,2,0,2
976090,0,1 user reviews,1,0,1
976120,7,Positive,38,6,44
976160,0,3 user reviews,1,2,3
976170,0,1 user reviews,0,1,1
976180,7,Positive,39,0,39
976210,5,Mixed,24,12,36
976230,0,3 user reviews,1,2,3
976240,0,1 user reviews,0,1,1
976260,0,5 user reviews,5,0,5
976280,0,2 user reviews,2,0,2
976310,8,Very Positive,6911,1707,8618
976330,0,9 user reviews,9,0,9
976340,5,Mixed,9,6,15
976350,0,1 user reviews,1,0,1
976360,0,2 user reviews,2,0,2
976390,8,Very Positive,52,3,55
976420,7,Positive,13,1,14
976500,7,Positive,11,1,12
976570,5,Mixed,7,7,14
976662,0,1 user reviews,1,0,1
976663,0,2 user reviews,2,0,2
976664,0,1 user reviews,0,1,1
976700,7,Positive,15,1,16
976720,0,4 user reviews,3,1,4
976730,8,Very Positive,68308,6317,74625
976780,6,Mostly Positive,46,16,62
976800,4,Mostly Negative,9,16,25
976830,0,3 user reviews,3,0,3
976840,0,1 user reviews,0,1,1
976850,0,5 user reviews,5,0,5
976870,0,2 user reviews,2,0,2
976920,8,Very Positive,42,8,50
976930,0,2 user reviews,2,0,2
976960,0,9 user reviews,9,0,9
976970,0,2 user reviews,2,0,2
977000,0,4 user reviews,4,0,4
977070,0,6 user reviews,6,0,6
977080,0,2 user reviews,2,0,2
977100,7,Positive,13,1,14
977110,0,3 user reviews,2,1,3
977180,0,1 user reviews,1,0,1
977220,0,8 user reviews,5,3,8
977230,8,Very Positive,104,3,107
977250,0,1 user reviews,1,0,1
977290,0,1 user reviews,1,0,1
977300,6,Mostly Positive,11,3,14
977310,0,2 user reviews,2,0,2
977340,5,Mixed,7,9,16
977390,7,Positive,14,1,15
977420,5,Mixed,126,74,200
977430,0,1 user reviews,1,0,1
977460,8,Very Positive,101,14,115
977490,0,1 user reviews,1,0,1
977500,0,2 user reviews,2,0,2
977530,0,3 user reviews,3,0,3
977560,6,Mostly Positive,7,3,10
977570,5,Mixed,36,32,68
977590,0,3 user reviews,1,2,3
977610,8,Very Positive,151,26,177
977640,5,Mixed,12,6,18
977650,8,Very Positive,66,16,82
977670,0,2 user reviews,2,0,2
977690,7,Positive,17,3,20
977720,5,Mixed,117,66,183
977790,0,3 user reviews,1,2,3
977810,7,Positive,40,3,43
977840,0,6 user reviews,6,0,6
977900,0,4 user reviews,3,1,4
977930,0,2 user reviews,2,0,2
977950,9,Overwhelmingly Positive,915,38,953
978010,0,4 user reviews,4,0,4
978040,0,3 user reviews,2,1,3
978140,7,Positive,17,0,17
978180,5,Mixed,5,5,10
978190,6,Mostly Positive,12,5,17
978210,0,3 user reviews,2,1,3
978250,8,Very Positive,76,3,79
978340,0,4 user reviews,4,0,4
978360,7,Positive,17,4,21
978380,0,1 user reviews,1,0,1
978440,0,4 user reviews,4,0,4
978450,0,1 user reviews,0,1,1
978470,4,Mostly Negative,5,10,15
978510,0,7 user reviews,7,0,7
978520,8,Very Positive,446,81,527
978580,0,1 user reviews,0,1,1
978610,0,2 user reviews,0,2,2
978640,7,Positive,10,1,11
978650,0,1 user reviews,0,1,1
978660,0,1 user reviews,1,0,1
978680,8,Very Positive,63,15,78
978690,7,Positive,18,1,19
978710,0,1 user reviews,1,0,1
978720,5,Mixed,32,17,49
978730,0,1 user reviews,1,0,1
978740,0,2 user reviews,2,0,2
978780,9,Overwhelmingly Positive,1153,45,1198
978790,0,3 user reviews,3,0,3
978800,0,2 user reviews,2,0,2
978851,0,1 user reviews,0,1,1
978861,0,1 user reviews,1,0,1
978870,6,Mostly Positive,19,5,24
978880,0,4 user reviews,4,0,4
978960,5,Mixed,37,22,59
978990,0,5 user reviews,3,2,5
979000,0,1 user reviews,0,1,1
979010,5,Mixed,22,11,33
979090,7,Positive,26,2,28
979110,8,Very Positive,1229,179,1408
979120,8,Very Positive,1073,114,1187
979130,0,1 user reviews,1,0,1
979131,0,4 user reviews,4,0,4
979132,0,1 user reviews,0,1,1
979160,0,5 user reviews,4,1,5
979280,0,3 user reviews,3,0,3
979300,0,1 user reviews,0,1,1
979330,5,Mixed,16,10,26
979390,0,1 user reviews,0,1,1
979400,6,Mostly Positive,13,5,18
979450,0,7 user reviews,7,0,7
979464,0,1 user reviews,1,0,1
979465,0,2 user reviews,0,2,2
979520,7,Positive,9,1,10
979530,0,6 user reviews,5,1,6
979550,0,2 user reviews,1,1,2
979560,5,Mixed,44,29,73
979580,0,2 user reviews,2,0,2
979600,8,Very Positive,301,5,306
979620,0,3 user reviews,2,1,3
979640,8,Very Positive,140,17,157
979650,0,1 user reviews,1,0,1
979700,0,2 user reviews,2,0,2
979710,8,Very Positive,69,6,75
979720,0,7 user reviews,5,2,7
979740,0,7 user reviews,5,2,7
979780,0,2 user reviews,2,0,2
979800,5,Mixed,14,9,23
979810,5,Mixed,5,5,10
979880,0,1 user reviews,1,0,1
979890,0,1 user reviews,0,1,1
979900,0,2 user reviews,2,0,2
979910,0,7 user reviews,3,4,7
979930,8,Very Positive,52,8,60
979970,5,Mixed,8,4,12
980050,0,1 user reviews,1,0,1
980090,0,1 user reviews,1,0,1
980190,0,2 user reviews,2,0,2
980291,0,1 user reviews,1,0,1
980300,9,Overwhelmingly Positive,1948,62,2010
980320,5,Mixed,6,4,10
980370,0,2 user reviews,2,0,2
980390,0,3 user reviews,3,0,3
980400,0,2 user reviews,2,0,2
980410,0,1 user reviews,1,0,1
980420,0,1 user reviews,1,0,1
980440,0,2 user reviews,1,1,2
980460,0,2 user reviews,2,0,2
980480,7,Positive,19,0,19
980490,0,4 user reviews,4,0,4
980520,0,5 user reviews,5,0,5
980541,0,6 user reviews,1,5,6
980542,4,Mostly Negative,4,8,12
980543,0,2 user reviews,2,0,2
980544,5,Mixed,9,7,16
980545,0,4 user reviews,1,3,4
980546,0,4 user reviews,4,0,4
980547,0,7 user reviews,4,3,7
980548,5,Mixed,12,8,20
980549,0,2 user reviews,1,1,2
980550,0,1 user reviews,1,0,1
980560,0,2 user reviews,0,2,2
980590,7,Positive,16,1,17
980591,6,Mostly Positive,10,3,13
980592,7,Positive,17,0,17
980600,0,3 user reviews,3,0,3
980690,0,4 user reviews,3,1,4
980720,0,5 user reviews,5,0,5
980750,0,2 user reviews,2,0,2
980760,0,1 user reviews,1,0,1
980770,0,2 user reviews,1,1,2
980830,8,Very Positive,52,6,58
980850,0,1 user reviews,0,1,1
980880,0,9 user reviews,8,1,9
980940,6,Mostly Positive,152,58,210
981020,7,Positive,41,1,42
981050,0,2 user reviews,1,1,2
981130,0,2 user reviews,0,2,2
981140,0,2 user reviews,0,2,2
981160,6,Mostly Positive,9,3,12
981250,0,1 user reviews,1,0,1
981260,6,Mostly Positive,46,13,59
981270,0,2 user reviews,2,0,2
981300,8,Very Positive,49,9,58
981320,0,1 user reviews,0,1,1
981420,7,Positive,37,2,39
981430,8,Very Positive,447,25,472
981440,0,3 user reviews,3,0,3
981450,0,1 user reviews,1,0,1
981500,0,2 user reviews,2,0,2
981550,5,Mixed,13,6,19
981590,0,3 user reviews,2,1,3
981610,0,1 user reviews,1,0,1
981620,0,5 user reviews,5,0,5
981630,0,6 user reviews,6,0,6
981670,0,1 user reviews,1,0,1
981690,0,2 user reviews,0,2,2
981700,0,1 user reviews,1,0,1
981701,0,2 user reviews,2,0,2
981702,0,1 user reviews,1,0,1
981710,0,1 user reviews,1,0,1
981750,8,Very Positive,151,32,183
981770,8,Very Positive,89,8,97
981790,0,7 user reviews,1,6,7
981800,0,3 user reviews,1,2,3
981850,0,8 user reviews,6,2,8
981880,7,Positive,14,1,15
981910,5,Mixed,5,6,11
981960,6,Mostly Positive,10,4,14
982020,0,1 user reviews,1,0,1
982040,7,Positive,13,3,16
982050,0,1 user reviews,1,0,1
982060,8,Very Positive,48,12,60
982100,0,2 user reviews,0,2,2
982110,7,Positive,29,0,29
982120,0,1 user reviews,1,0,1
982150,8,Very Positive,146,19,165
982180,0,5 user reviews,3,2,5
982200,0,4 user reviews,4,0,4
982201,0,2 user reviews,2,0,2
982220,8,Very Positive,128,13,141
982240,0,4 user reviews,0,4,4
982250,0,4 user reviews,4,0,4
982270,8,Very Positive,126,7,133
982390,0,1 user reviews,1,0,1
982440,5,Mixed,33,16,49
982450,6,Mostly Positive,15,6,21
982470,0,1 user reviews,1,0,1
982480,0,3 user reviews,0,3,3
982520,5,Mixed,17,11,28
982540,7,Positive,10,0,10
982580,6,Mostly Positive,7,3,10
982590,5,Mixed,23,13,36
982670,0,3 user reviews,2,1,3
982690,0,1 user reviews,0,1,1
982700,6,Mostly Positive,36,13,49
982760,5,Mixed,7,7,14
982800,0,6 user reviews,4,2,6
982840,0,3 user reviews,3,0,3
982850,0,2 user reviews,1,1,2
982970,6,Mostly Positive,117,43,160
982990,0,2 user reviews,2,0,2
983050,7,Positive,11,0,11
983100,0,2 user reviews,2,0,2
983140,7,Positive,21,0,21
983150,0,1 user reviews,1,0,1
983160,0,5 user reviews,2,3,5
983170,0,2 user reviews,1,1,2
983240,0,3 user reviews,2,1,3
983280,0,3 user reviews,3,0,3
983290,7,Positive,18,4,22
983300,0,1 user reviews,1,0,1
983340,0,2 user reviews,1,1,2
983350,8,Very Positive,151,23,174
983440,4,Mostly Negative,6,10,16
983441,0,8 user reviews,5,3,8
983442,0,2 user reviews,1,1,2
983450,7,Positive,9,1,10
983520,0,2 user reviews,2,0,2
983590,0,2 user reviews,2,0,2
983610,0,1 user reviews,0,1,1
983640,0,6 user reviews,6,0,6
983670,5,Mixed,8,9,17
983760,0,9 user reviews,9,0,9
983780,0,2 user reviews,1,1,2
983790,0,3 user reviews,3,0,3
983820,0,8 user reviews,2,6,8
983830,0,6 user reviews,5,1,6
983840,5,Mixed,5,6,11
983880,5,Mixed,5,6,11
983890,0,5 user reviews,1,4,5
983900,0,2 user reviews,2,0,2
983980,0,9 user reviews,6,3,9
983990,0,2 user reviews,2,0,2
984020,0,5 user reviews,5,0,5
984030,0,1 user reviews,1,0,1
984070,0,9 user reviews,6,3,9
984080,0,5 user reviews,0,5,5
984110,0,4 user reviews,4,0,4
984130,0,2 user reviews,2,0,2
984150,0,1 user reviews,0,1,1
984170,0,1 user reviews,0,1,1
984180,7,Positive,20,5,25
984200,0,1 user reviews,1,0,1
984210,0,7 user reviews,5,2,7
984220,7,Positive,12,2,14
984250,0,2 user reviews,2,0,2
984270,0,1 user reviews,1,0,1
984300,0,5 user reviews,4,1,5
984340,0,1 user reviews,1,0,1
984360,0,5 user reviews,5,0,5
984450,7,Positive,19,0,19
984470,7,Positive,9,1,10
984510,0,3 user reviews,3,0,3
984520,0,4 user reviews,1,3,4
984540,0,6 user reviews,6,0,6
984560,8,Very Positive,293,41,334
984590,0,2 user reviews,2,0,2
984610,7,Positive,32,1,33
984660,5,Mixed,9,8,17
984680,8,Very Positive,188,45,233
984710,0,2 user reviews,0,2,2
984711,0,2 user reviews,0,2,2
984720,7,Positive,37,5,42
984730,0,4 user reviews,3,1,4
984740,0,2 user reviews,0,2,2
984741,0,2 user reviews,0,2,2
984780,8,Very Positive,327,46,373
984800,6,Mostly Positive,105,39,144
984820,0,3 user reviews,0,3,3
984830,0,1 user reviews,1,0,1
984880,0,1 user reviews,1,0,1
984910,0,5 user reviews,5,0,5
984930,0,3 user reviews,1,2,3
984970,0,1 user reviews,1,0,1
985040,7,Positive,29,5,34
985070,0,1 user reviews,0,1,1
985080,7,Positive,20,0,20
985110,7,Positive,10,1,11
985190,0,3 user reviews,3,0,3
985260,8,Very Positive,78,10,88
985280,0,1 user reviews,0,1,1
985330,0,6 user reviews,4,2,6
985400,5,Mixed,11,5,16
985420,0,1 user reviews,0,1,1
985430,5,Mixed,25,14,39
985460,0,3 user reviews,3,0,3
985470,0,2 user reviews,2,0,2
985500,0,4 user reviews,2,2,4
985510,7,Positive,11,2,13
985530,0,6 user reviews,4,2,6
985580,0,3 user reviews,2,1,3
985590,7,Positive,20,0,20
985620,0,4 user reviews,4,0,4
985640,0,4 user reviews,2,2,4
985660,0,1 user reviews,0,1,1
985690,0,1 user reviews,1,0,1
985710,0,9 user reviews,1,8,9
985720,4,Mostly Negative,6,12,18
985760,5,Mixed,40,19,59
985770,0,1 user reviews,0,1,1
985800,6,Mostly Positive,7,3,10
985860,0,1 user reviews,1,0,1
985890,8,Very Positive,2810,262,3072
985920,3,Negative,2,10,12
985940,0,3 user reviews,1,2,3
985950,6,Mostly Positive,89,33,122
986020,8,Very Positive,50,7,57
986070,7,Positive,10,0,10
986080,5,Mixed,6,5,11
986090,7,Positive,41,0,41
986120,0,2 user reviews,1,1,2
986140,0,1 user reviews,1,0,1
986170,0,2 user reviews,2,0,2
986230,0,1 user reviews,1,0,1
986240,0,2 user reviews,2,0,2
986250,7,Positive,30,1,31
986280,7,Positive,16,1,17
986300,0,1 user reviews,1,0,1
986340,0,7 user reviews,5,2,7
986370,0,7 user reviews,7,0,7
986400,0,1 user reviews,0,1,1
986510,7,Positive,17,0,17
986670,0,1 user reviews,1,0,1
986680,0,9 user reviews,8,1,9
986710,7,Positive,11,1,12
986790,0,2 user reviews,1,1,2
986800,8,Very Positive,147,1,148
986820,7,Positive,15,2,17
986830,7,Positive,11,1,12
986850,6,Mostly Positive,54,19,73
986870,0,1 user reviews,1,0,1
986920,0,1 user reviews,1,0,1
986990,7,Positive,15,2,17
987000,7,Positive,24,6,30
987020,8,Very Positive,343,40,383
987040,0,2 user reviews,0,2,2
987050,6,Mostly Positive,21,8,29
987060,0,1 user reviews,1,0,1
987070,7,Positive,11,0,11
987150,5,Mixed,61,37,98
987170,0,9 user reviews,6,3,9
987180,0,9 user reviews,6,3,9
987190,7,Positive,18,4,22
987200,5,Mixed,14,8,22
987210,6,Mostly Positive,8,3,11
987230,6,Mostly Positive,136,55,191
987250,0,1 user reviews,0,1,1
987270,7,Positive,12,3,15
987290,7,Positive,15,3,18
987330,5,Mixed,12,12,24
987340,0,3 user reviews,3,0,3
987350,8,Very Positive,52,8,60
987400,7,Positive,37,7,44
987410,7,Positive,14,2,16
987440,0,1 user reviews,1,0,1
987490,0,2 user reviews,0,2,2
987500,0,2 user reviews,2,0,2
987570,0,6 user reviews,5,1,6
987580,0,4 user reviews,4,0,4
987590,0,9 user reviews,4,5,9
987620,0,1 user reviews,1,0,1
987630,5,Mixed,5,5,10
987660,0,2 user reviews,1,1,2
987670,0,3 user reviews,3,0,3
987710,0,7 user reviews,7,0,7
987720,5,Mixed,87,42,129
987730,7,Positive,10,2,12
987740,0,8 user reviews,6,2,8
987770,7,Positive,30,6,36
987780,0,1 user reviews,1,0,1
987800,0,2 user reviews,1,1,2
987810,0,7 user reviews,6,1,7
987850,5,Mixed,19,12,31
987880,7,Positive,18,1,19
987950,6,Mostly Positive,20,6,26
987990,0,3 user reviews,3,0,3
988010,0,2 user reviews,2,0,2
988021,0,1 user reviews,1,0,1
988041,0,2 user reviews,2,0,2
988043,0,1 user reviews,1,0,1
988070,0,1 user reviews,0,1,1
988080,0,1 user reviews,0,1,1
988100,7,Positive,13,2,15
988110,0,3 user reviews,3,0,3
988150,0,2 user reviews,2,0,2
988160,7,Positive,10,0,10
988170,0,7 user reviews,2,5,7
988171,5,Mixed,12,6,18
988172,5,Mixed,10,9,19
988180,4,Mostly Negative,5,8,13
988190,0,7 user reviews,4,3,7
988240,5,Mixed,11,8,19
988250,0,2 user reviews,2,0,2
988310,7,Positive,20,1,21
988320,0,5 user reviews,5,0,5
988330,0,1 user reviews,0,1,1
988340,4,Mostly Negative,3,7,10
988440,5,Mixed,62,77,139
988450,5,Mixed,25,13,38
988470,7,Positive,39,6,45
988490,8,Very Positive,50,3,53
988620,0,3 user reviews,3,0,3
988621,0,2 user reviews,2,0,2
988650,7,Positive,11,1,12
988750,0,3 user reviews,3,0,3
988810,0,8 user reviews,7,1,8
988870,0,2 user reviews,2,0,2
988890,0,4 user reviews,3,1,4
988910,8,Very Positive,470,40,510
988920,0,1 user reviews,0,1,1
988940,5,Mixed,14,9,23
988980,0,6 user reviews,5,1,6
989000,0,1 user reviews,0,1,1
989010,0,3 user reviews,1,2,3
989040,0,3 user reviews,1,2,3
989050,5,Mixed,10,7,17
989060,0,5 user reviews,5,0,5
989080,7,Positive,9,1,10
989110,0,1 user reviews,0,1,1
989140,0,1 user reviews,1,0,1
989160,0,3 user reviews,2,1,3
989170,0,5 user reviews,5,0,5
989250,0,2 user reviews,0,2,2
989260,0,2 user reviews,1,1,2
989340,0,6 user reviews,5,1,6
989370,0,2 user reviews,2,0,2
989400,0,1 user reviews,1,0,1
989430,0,3 user reviews,3,0,3
989450,0,3 user reviews,2,1,3
989520,0,1 user reviews,0,1,1
989550,6,Mostly Positive,63,16,79
989560,0,7 user reviews,5,2,7
989580,5,Mixed,11,9,20
989640,0,2 user reviews,2,0,2
989650,0,2 user reviews,0,2,2
989680,0,1 user reviews,0,1,1
989690,6,Mostly Positive,327,133,460
989710,0,2 user reviews,1,1,2
989750,0,1 user reviews,1,0,1
989770,6,Mostly Positive,82,28,110
989780,0,7 user reviews,0,7,7
989810,0,2 user reviews,1,1,2
989960,7,Positive,13,0,13
989970,0,1 user reviews,1,0,1
990020,0,1 user reviews,1,0,1
990030,7,Positive,20,5,25
990050,8,Very Positive,221,55,276
990160,0,4 user reviews,1,3,4
990180,7,Positive,16,0,16
990230,0,5 user reviews,4,1,5
990240,0,3 user reviews,2,1,3
990280,0,6 user reviews,5,1,6
990360,6,Mostly Positive,26,8,34
990390,0,1 user reviews,1,0,1
990400,0,2 user reviews,2,0,2
990430,7,Positive,18,0,18
990480,0,1 user reviews,0,1,1
990500,0,1 user reviews,1,0,1
990640,7,Positive,28,7,35
990650,4,Mostly Negative,93,280,373
990730,5,Mixed,7,5,12
990731,0,3 user reviews,3,0,3
990732,0,1 user reviews,1,0,1
990733,0,7 user reviews,7,0,7
990740,0,8 user reviews,4,4,8
990750,0,6 user reviews,5,1,6
990762,0,2 user reviews,2,0,2
990840,0,6 user reviews,3,3,6
990850,5,Mixed,6,8,14
990900,7,Positive,11,0,11
990930,5,Mixed,11,10,21
990931,0,5 user reviews,4,1,5
990932,5,Mixed,7,5,12
990940,0,2 user reviews,2,0,2
990950,0,1 user reviews,0,1,1
990960,0,2 user reviews,1,1,2
991060,0,1 user reviews,1,0,1
991064,0,1 user reviews,1,0,1
991066,0,1 user reviews,0,1,1
991069,0,2 user reviews,2,0,2
991070,6,Mostly Positive,19,7,26
991080,0,2 user reviews,2,0,2
991170,8,Very Positive,457,86,543
991230,0,6 user reviews,3,3,6
991240,0,7 user reviews,6,1,7
991260,5,Mixed,285,134,419
991270,9,Overwhelmingly Positive,770,27,797
991280,0,9 user reviews,5,4,9
991430,7,Positive,11,0,11
991480,0,9 user reviews,8,1,9
991490,0,1 user reviews,1,0,1
991500,0,5 user reviews,4,1,5
991510,0,6 user reviews,6,0,6
991520,0,2 user reviews,0,2,2
991560,5,Mixed,77,56,133
991600,8,Very Positive,100,12,112
991620,0,3 user reviews,3,0,3
991660,0,1 user reviews,0,1,1
991750,0,4 user reviews,4,0,4
991770,0,2 user reviews,2,0,2
991771,0,1 user reviews,1,0,1
991773,0,8 user reviews,2,6,8
991774,0,1 user reviews,1,0,1
991780,5,Mixed,16,12,28
991810,5,Mixed,95,41,136
991860,0,4 user reviews,3,1,4
991870,7,Positive,13,0,13
991890,0,1 user reviews,1,0,1
991960,7,Positive,10,1,11
992000,0,1 user reviews,0,1,1
992040,0,6 user reviews,5,1,6
992050,6,Mostly Positive,13,4,17
992120,7,Positive,22,0,22
992160,0,1 user reviews,1,0,1
992170,7,Positive,39,4,43
992171,7,Positive,18,3,21
992172,7,Positive,40,4,44
992173,7,Positive,22,1,23
992174,8,Very Positive,54,2,56
992175,8,Very Positive,57,6,63
992176,7,Positive,40,7,47
992180,0,1 user reviews,1,0,1
992200,7,Positive,9,1,10
992210,7,Positive,9,1,10
992260,0,1 user reviews,1,0,1
992300,8,Very Positive,554,100,654
992330,7,Positive,18,4,22
992360,0,1 user reviews,0,1,1
992420,0,1 user reviews,1,0,1
992480,0,1 user reviews,0,1,1
992490,0,2 user reviews,1,1,2
992610,0,8 user reviews,8,0,8
992640,5,Mixed,491,494,985
992730,8,Very Positive,56,10,66
992740,0,2 user reviews,2,0,2
992870,0,4 user reviews,3,1,4
992880,0,1 user reviews,1,0,1
992890,0,3 user reviews,2,1,3
992910,6,Mostly Positive,286,110,396
992950,0,5 user reviews,4,1,5
992960,0,6 user reviews,4,2,6
992970,0,1 user reviews,1,0,1
992990,7,Positive,10,0,10
993020,0,5 user reviews,5,0,5
993090,8,Very Positive,81,4,85
993100,0,1 user reviews,0,1,1
993170,0,1 user reviews,1,0,1
993180,0,1 user reviews,1,0,1
993250,0,4 user reviews,2,2,4
993270,0,9 user reviews,9,0,9
993340,5,Mixed,38,20,58
993400,0,4 user reviews,1,3,4
993410,0,1 user reviews,1,0,1
993500,0,5 user reviews,4,1,5
993520,0,4 user reviews,2,2,4
993580,0,4 user reviews,4,0,4
993610,0,1 user reviews,1,0,1
993630,0,1 user reviews,1,0,1
993640,5,Mixed,11,5,16
993680,0,5 user reviews,2,3,5
993690,5,Mixed,25,18,43
993740,8,Very Positive,46,6,52
993750,0,6 user reviews,2,4,6
993780,7,Positive,23,1,24
993790,8,Very Positive,167,10,177
993810,0,2 user reviews,2,0,2
993840,0,6 user reviews,6,0,6
993850,0,2 user reviews,2,0,2
993890,0,4 user reviews,4,0,4
993921,0,1 user reviews,1,0,1
993922,0,1 user reviews,1,0,1
993924,0,1 user reviews,0,1,1
993980,0,2 user reviews,1,1,2
993990,0,3 user reviews,2,1,3
994020,7,Positive,35,2,37
994040,7,Positive,12,0,12
994140,8,Very Positive,77,4,81
994160,6,Mostly Positive,12,5,17
994180,0,4 user reviews,3,1,4
994200,7,Positive,9,2,11
994210,6,Mostly Positive,10,3,13
994220,8,Very Positive,379,41,420
994230,0,4 user reviews,2,2,4
994280,8,Very Positive,830,140,970
994300,0,1 user reviews,1,0,1
994310,0,3 user reviews,0,3,3
994320,5,Mixed,19,19,38
994340,7,Positive,20,0,20
994350,6,Mostly Positive,9,3,12
994360,0,3 user reviews,3,0,3
994500,7,Positive,26,2,28
994650,0,1 user reviews,1,0,1
994670,7,Positive,12,1,13
994730,8,Very Positive,173,17,190
994790,0,2 user reviews,2,0,2
994860,0,4 user reviews,4,0,4
994870,0,9 user reviews,6,3,9
994880,0,1 user reviews,1,0,1
994890,5,Mixed,24,12,36
994900,0,3 user reviews,3,0,3
995000,0,8 user reviews,5,3,8
995040,0,1 user reviews,1,0,1
995050,8,Very Positive,124,22,146
995140,5,Mixed,6,7,13
995160,0,6 user reviews,6,0,6
995170,0,1 user reviews,1,0,1
995210,4,Mostly Negative,5,9,14
995230,8,Very Positive,127,22,149
995240,7,Positive,9,2,11
995280,0,6 user reviews,3,3,6
995300,0,4 user reviews,3,1,4
995380,7,Positive,27,3,30
995430,0,8 user reviews,3,5,8
995450,5,Mixed,10,5,15
995460,8,Very Positive,61,1,62
995470,0,7 user reviews,6,1,7
995480,0,1 user reviews,0,1,1
995490,0,5 user reviews,5,0,5
995590,0,1 user reviews,0,1,1
995610,7,Positive,12,0,12
995640,0,2 user reviews,1,1,2
995650,0,5 user reviews,4,1,5
995651,0,4 user reviews,3,1,4
995652,0,5 user reviews,3,2,5
995653,0,5 user reviews,3,2,5
995654,0,7 user reviews,5,2,7
995660,5,Mixed,6,8,14
995670,5,Mixed,9,4,13
995700,0,1 user reviews,0,1,1
995770,7,Positive,25,1,26
995780,6,Mostly Positive,32,10,42
995790,0,6 user reviews,4,2,6
995860,7,Positive,33,5,38
995870,7,Positive,9,1,10
995890,0,1 user reviews,1,0,1
995900,0,2 user reviews,2,0,2
995910,0,3 user reviews,1,2,3
995920,0,2 user reviews,2,0,2
995950,0,2 user reviews,2,0,2
995960,5,Mixed,21,24,45
995970,5,Mixed,9,8,17
995980,8,Very Positive,172,28,200
996000,7,Positive,10,0,10
996050,5,Mixed,9,4,13
996060,7,Positive,12,0,12
996080,7,Positive,27,3,30
996150,0,1 user reviews,1,0,1
996160,0,5 user reviews,3,2,5
996180,0,4 user reviews,4,0,4
996280,0,1 user reviews,1,0,1
996300,0,1 user reviews,0,1,1
996380,5,Mixed,182,207,389
996430,0,1 user reviews,0,1,1
996450,7,Positive,14,3,17
996470,5,Mixed,1224,540,1764
996550,0,9 user reviews,9,0,9
996580,8,Very Positive,3124,190,3314
996620,0,2 user reviews,2,0,2
996630,0,1 user reviews,1,0,1
996650,0,2 user reviews,2,0,2
996720,7,Positive,12,0,12
996721,0,2 user reviews,2,0,2
996730,0,1 user reviews,0,1,1
996741,0,5 user reviews,5,0,5
996742,0,3 user reviews,3,0,3
996770,8,Very Positive,152,32,184
996830,3,Negative,0,24,24
996860,0,6 user reviews,5,1,6
996910,0,4 user reviews,3,1,4
996920,0,6 user reviews,6,0,6
996980,7,Positive,11,1,12
996990,0,7 user reviews,4,3,7
997000,0,3 user reviews,1,2,3
997020,0,1 user reviews,0,1,1
997030,0,5 user reviews,5,0,5
997041,0,2 user reviews,2,0,2
997050,5,Mixed,5,5,10
997060,0,1 user reviews,1,0,1
997070,5,Mixed,3974,1945,5919
997120,6,Mostly Positive,8,3,11
997170,0,5 user reviews,5,0,5
997240,0,5 user reviews,3,2,5
997260,0,8 user reviews,8,0,8
997280,0,3 user reviews,3,0,3
997310,0,1 user reviews,1,0,1
997330,7,Positive,26,0,26
997340,0,1 user reviews,0,1,1
997360,0,6 user reviews,6,0,6
997370,0,7 user reviews,6,1,7
997380,7,Positive,16,2,18
997430,0,4 user reviews,4,0,4
997470,0,1 user reviews,1,0,1
997480,0,4 user reviews,4,0,4
997560,0,2 user reviews,2,0,2
997670,0,1 user reviews,1,0,1
997700,7,Positive,8,2,10
997710,5,Mixed,6,5,11
997720,7,Positive,9,1,10
997730,0,2 user reviews,2,0,2
997750,0,1 user reviews,1,0,1
997870,0,3 user reviews,0,3,3
997950,0,6 user reviews,4,2,6
998010,0,9 user reviews,2,7,9
998020,0,9 user reviews,4,5,9
998220,7,Positive,12,1,13
998270,0,1 user reviews,1,0,1
998330,5,Mixed,9,5,14
998470,5,Mixed,6,4,10
998480,0,2 user reviews,1,1,2
998490,7,Positive,21,0,21
998530,0,1 user reviews,0,1,1
998550,0,6 user reviews,5,1,6
998570,6,Mostly Positive,13,5,18
998580,0,1 user reviews,1,0,1
998590,0,1 user reviews,1,0,1
998630,0,5 user reviews,5,0,5
998680,0,1 user reviews,1,0,1
998730,0,2 user reviews,2,0,2
998740,8,Very Positive,212,28,240
998790,0,6 user reviews,3,3,6
998810,7,Positive,27,1,28
998830,0,4 user reviews,3,1,4
998850,5,Mixed,11,5,16
998890,0,1 user reviews,0,1,1
998930,6,Mostly Positive,200,53,253
998940,8,Very Positive,182,22,204
998960,0,4 user reviews,4,0,4
998961,0,1 user reviews,1,0,1
998970,0,5 user reviews,2,3,5
998990,6,Mostly Positive,8,3,11
999020,8,Very Positive,300,50,350
999030,0,1 user reviews,1,0,1
999040,0,2 user reviews,1,1,2
999050,0,2 user reviews,1,1,2
999150,0,3 user reviews,1,2,3
999190,0,3 user reviews,0,3,3
999220,6,Mostly Positive,1159,406,1565
999250,0,2 user reviews,2,0,2
999260,6,Mostly Positive,34,12,46
999290,0,4 user reviews,3,1,4
999300,0,2 user reviews,1,1,2
999302,0,2 user reviews,1,1,2
999310,0,2 user reviews,2,0,2
999350,0,6 user reviews,6,0,6
999410,7,Positive,31,1,32
999430,0,2 user reviews,2,0,2
999480,0,3 user reviews,0,3,3
999490,0,3 user reviews,3,0,3
999550,7,Positive,10,1,11
999640,5,Mixed,17,13,30
999660,5,Mixed,6,4,10
999720,0,2 user reviews,2,0,2
999840,0,4 user reviews,4,0,4
999860,6,Mostly Positive,46,12,58
999990,0,1 user reviews,1,0,1
1000010,8,Very Positive,159,22,181
1000030,9,Overwhelmingly Positive,616,16,632
1000080,8,Very Positive,79,18,97
1000120,0,1 user reviews,0,1,1
1000130,0,5 user reviews,5,0,5
1000140,0,3 user reviews,1,2,3
1000150,0,1 user reviews,0,1,1
1000160,0,1 user reviews,1,0,1
1000170,0,1 user reviews,0,1,1
1000180,0,1 user reviews,0,1,1
1000200,0,2 user reviews,2,0,2
1000210,0,1 user reviews,1,0,1
1000310,0,2 user reviews,0,2,2
1000370,0,1 user reviews,0,1,1
1000400,0,9 user reviews,9,0,9
1000410,8,Very Positive,534,54,588
1000470,6,Mostly Positive,23,7,30
1000480,5,Mixed,7,4,11
1000510,5,Mixed,12,7,19
1000550,0,6 user reviews,4,2,6
1000640,7,Positive,47,2,49
1000710,0,2 user reviews,2,0,2
1000711,0,3 user reviews,3,0,3
1000712,0,1 user reviews,1,0,1
1000713,0,2 user reviews,2,0,2
1000714,0,1 user reviews,0,1,1
1000715,0,1 user reviews,1,0,1
1000717,0,3 user reviews,3,0,3
1000718,0,3 user reviews,3,0,3
1000770,0,9 user reviews,8,1,9
1000780,0,1 user reviews,1,0,1
1000781,0,1 user reviews,1,0,1
1000782,0,5 user reviews,5,0,5
1000783,0,1 user reviews,1,0,1
1000790,0,1 user reviews,0,1,1
1000830,8,Very Positive,55,2,57
1000860,0,4 user reviews,3,1,4
1000870,0,1 user reviews,0,1,1
1000990,0,9 user reviews,7,2,9
1001010,0,1 user reviews,1,0,1
1001040,5,Mixed,36,20,56
1001050,0,1 user reviews,0,1,1
1001060,5,Mixed,21,18,39
1001070,7,Positive,25,4,29
1001100,0,1 user reviews,1,0,1
1001110,0,1 user reviews,1,0,1
1001140,8,Very Positive,93,15,108
1001150,7,Positive,15,3,18
1001170,0,5 user reviews,0,5,5
1001200,0,8 user reviews,7,1,8
1001220,8,Very Positive,84,21,105
1001230,0,5 user reviews,5,0,5
1001240,5,Mixed,7,10,17
1001280,0,2 user reviews,2,0,2
1001291,0,1 user reviews,0,1,1
1001321,0,1 user reviews,1,0,1
1001370,0,4 user reviews,4,0,4
1001371,0,7 user reviews,7,0,7
1001380,0,5 user reviews,3,2,5
1001390,0,3 user reviews,0,3,3
1001430,0,5 user reviews,5,0,5
1001490,5,Mixed,7,5,12
1001500,0,7 user reviews,5,2,7
1001570,0,2 user reviews,2,0,2
1001590,0,2 user reviews,2,0,2
1001600,0,6 user reviews,5,1,6
1001620,0,3 user reviews,3,0,3
1001640,4,Mostly Negative,3,9,12
1001660,0,2 user reviews,2,0,2
1001690,0,3 user reviews,1,2,3
1001740,0,4 user reviews,4,0,4
1001760,0,1 user reviews,0,1,1
1001800,8,Very Positive,58,13,71
1001810,0,1 user reviews,0,1,1
1001880,0,8 user reviews,7,1,8
1001910,0,6 user reviews,5,1,6
1001950,0,4 user reviews,3,1,4
1001960,0,1 user reviews,0,1,1
1001970,0,1 user reviews,0,1,1
1001980,5,Mixed,25,11,36
1001990,0,3 user reviews,1,2,3
1002000,0,3 user reviews,3,0,3
1002020,5,Mixed,7,5,12
1002030,6,Mostly Positive,15,6,21
1002060,0,2 user reviews,2,0,2
1002100,0,3 user reviews,3,0,3
1002130,7,Positive,12,3,15
1002180,0,3 user reviews,1,2,3
1002200,0,2 user reviews,2,0,2
1002210,0,1 user reviews,1,0,1
1002230,0,2 user reviews,1,1,2
1002270,7,Positive,12,2,14
1002280,0,4 user reviews,2,2,4
1002300,8,Very Positive,143,17,160
1002310,0,1 user reviews,1,0,1
1002410,0,4 user reviews,3,1,4
1002420,0,3 user reviews,2,1,3
1002430,8,Very Positive,102,6,108
1002440,0,4 user reviews,2,2,4
1002490,5,Mixed,4,6,10
1002500,0,1 user reviews,1,0,1
1002510,7,Positive,12,0,12
1002520,0,4 user reviews,4,0,4
1002540,0,7 user reviews,4,3,7
1002560,8,Very Positive,94,3,97
1002580,0,1 user reviews,1,0,1
1002610,6,Mostly Positive,14,4,18
1002620,0,2 user reviews,2,0,2
1002630,7,Positive,8,2,10
1002650,0,3 user reviews,1,2,3
1002670,0,4 user reviews,3,1,4
1002750,0,3 user reviews,0,3,3
1002800,0,3 user reviews,2,1,3
1002810,0,1 user reviews,1,0,1
1002830,5,Mixed,8,4,12
1002910,0,2 user reviews,2,0,2
1002940,0,1 user reviews,1,0,1
1002960,6,Mostly Positive,13,4,17
1002970,7,Positive,13,2,15
1003000,0,2 user reviews,1,1,2
1003020,7,Positive,17,1,18
1003070,0,7 user reviews,5,2,7
1003090,8,Very Positive,105,14,119
1003150,0,1 user reviews,0,1,1
1003170,0,1 user reviews,0,1,1
1003190,0,3 user reviews,3,0,3
1003200,0,6 user reviews,4,2,6
1003230,0,2 user reviews,2,0,2
1003310,5,Mixed,16,7,23
1003320,7,Positive,15,2,17
1003360,6,Mostly Positive,72,21,93
1003370,0,8 user reviews,7,1,8
1003400,0,2 user reviews,2,0,2
1003450,0,3 user reviews,2,1,3
1003480,6,Mostly Positive,11,4,15
1003490,7,Positive,17,2,19
1003520,8,Very Positive,805,119,924
1003560,0,8 user reviews,7,1,8
1003570,0,2 user reviews,2,0,2
1003600,7,Positive,12,1,13
1003650,0,1 user reviews,0,1,1
1003670,0,3 user reviews,1,2,3
1003690,0,1 user reviews,1,0,1
1003730,7,Positive,30,1,31
1003750,0,2 user reviews,2,0,2
1003760,0,1 user reviews,1,0,1
1003780,0,7 user reviews,7,0,7
1003800,7,Positive,10,2,12
1003830,0,1 user reviews,0,1,1
1003850,0,1 user reviews,1,0,1
1003860,7,Positive,10,0,10
1003880,6,Mostly Positive,7,3,10
1003890,8,Very Positive,427,93,520
1004000,5,Mixed,9,8,17
1004030,0,4 user reviews,3,1,4
1004040,0,4 user reviews,3,1,4
1004050,0,4 user reviews,0,4,4
1004100,0,2 user reviews,1,1,2
1004150,0,3 user reviews,3,0,3
1004180,0,1 user reviews,0,1,1
1004200,0,2 user reviews,2,0,2
1004210,7,Positive,30,2,32
1004220,0,4 user reviews,4,0,4
1004230,0,1 user reviews,1,0,1
1004240,9,Overwhelmingly Positive,499,23,522
1004260,0,9 user reviews,9,0,9
1004270,6,Mostly Positive,182,73,255
1004310,0,3 user reviews,3,0,3
1004320,0,3 user reviews,1,2,3
1004330,8,Very Positive,57,3,60
1004340,0,1 user reviews,1,0,1
1004490,6,Mostly Positive,73,22,95
1004500,0,3 user reviews,3,0,3
1004510,7,Positive,18,1,19
1004550,0,2 user reviews,0,2,2
1004560,5,Mixed,26,16,42
1004590,0,1 user reviews,0,1,1
1004600,0,1 user reviews,1,0,1
1004610,8,Very Positive,83,6,89
1004650,0,6 user reviews,4,2,6
1004740,7,Positive,36,5,41
1004750,5,Mixed,23,12,35
1004770,8,Very Positive,208,1,209
1004780,0,2 user reviews,1,1,2
1004860,7,Positive,26,4,30
1004890,6,Mostly Positive,13,4,17
1004891,7,Positive,15,0,15
1004892,0,7 user reviews,6,1,7
1004893,0,4 user reviews,3,1,4
1004894,0,9 user reviews,6,3,9
1004900,0,3 user reviews,2,1,3
1004911,0,1 user reviews,1,0,1
1004912,0,1 user reviews,0,1,1
1004915,0,1 user reviews,1,0,1
1004917,0,1 user reviews,1,0,1
1004918,0,1 user reviews,1,0,1
1004919,0,7 user reviews,4,3,7
1004920,0,9 user reviews,7,2,9
1004921,0,7 user reviews,7,0,7
1004930,0,4 user reviews,4,0,4
1004940,7,Positive,9,1,10
1004950,7,Positive,10,0,10
1004960,0,4 user reviews,4,0,4
1004970,0,3 user reviews,1,2,3
1004980,0,4 user reviews,2,2,4
1004990,0,4 user reviews,2,2,4
1005000,0,3 user reviews,3,0,3
1005010,0,3 user reviews,2,1,3
1005020,0,2 user reviews,1,1,2
1005030,0,2 user reviews,1,1,2
1005050,0,7 user reviews,6,1,7
1005060,0,4 user reviews,4,0,4
1005130,6,Mostly Positive,10,4,14
1005300,9,Overwhelmingly Positive,990,44,1034
1005310,0,4 user reviews,4,0,4
1005410,8,Very Positive,55,2,57
1005420,0,3 user reviews,0,3,3
1005450,7,Positive,23,0,23
1005460,0,3 user reviews,2,1,3
1005520,0,2 user reviews,2,0,2
1005530,0,9 user reviews,2,7,9
1005541,0,1 user reviews,0,1,1
1005550,0,7 user reviews,5,2,7
1005580,4,Mostly Negative,14,25,39
1005630,0,9 user reviews,6,3,9
1005730,7,Positive,10,0,10
1005780,0,1 user reviews,0,1,1
1005790,5,Mixed,18,8,26
1005890,0,4 user reviews,4,0,4
1005900,0,6 user reviews,5,1,6
1005920,0,1 user reviews,1,0,1
1005930,8,Very Positive,47,7,54
1005950,0,2 user reviews,1,1,2
1005971,6,Mostly Positive,10,4,14
1005972,0,7 user reviews,5,2,7
1005990,0,8 user reviews,6,2,8
1006120,0,3 user reviews,3,0,3
1006140,0,7 user reviews,7,0,7
1006150,5,Mixed,8,5,13
1006160,0,5 user reviews,5,0,5
1006190,0,1 user reviews,1,0,1
1006220,8,Very Positive,50,0,50
1006250,7,Positive,19,1,20
1006270,7,Positive,12,1,13
1006280,0,1 user reviews,1,0,1
1006400,0,2 user reviews,2,0,2
1006430,0,3 user reviews,3,0,3
1006440,0,9 user reviews,7,2,9
1006450,0,4 user reviews,3,1,4
1006460,0,5 user reviews,5,0,5
1006470,0,1 user reviews,0,1,1
1006510,6,Mostly Positive,461,134,595
1006600,0,7 user reviews,5,2,7
1006700,5,Mixed,8,6,14
1006710,7,Positive,10,0,10
1006720,0,3 user reviews,3,0,3
1006760,0,3 user reviews,3,0,3
1006770,0,1 user reviews,0,1,1
1006800,0,1 user reviews,1,0,1
1006850,5,Mixed,6,4,10
1006900,0,5 user reviews,2,3,5
1006920,0,4 user reviews,3,1,4
1006930,6,Mostly Positive,21,6,27
1006971,0,1 user reviews,0,1,1
1006981,0,3 user reviews,3,0,3
1006982,0,1 user reviews,0,1,1
1007040,9,Overwhelmingly Positive,1962,86,2048
1007050,7,Positive,17,1,18
1007060,0,1 user reviews,1,0,1
1007070,0,3 user reviews,2,1,3
1007080,0,1 user reviews,0,1,1
1007140,0,5 user reviews,4,1,5
1007180,0,2 user reviews,2,0,2
1007200,0,2 user reviews,1,1,2
1007210,0,1 user reviews,1,0,1
1007230,0,1 user reviews,1,0,1
1007240,0,2 user reviews,0,2,2
1007250,0,3 user reviews,3,0,3
1007251,0,1 user reviews,1,0,1
1007280,0,4 user reviews,2,2,4
1007350,5,Mixed,21,10,31
1007390,0,4 user reviews,3,1,4
1007400,5,Mixed,29,37,66
1007430,0,4 user reviews,4,0,4
1007440,0,2 user reviews,1,1,2
1007490,0,3 user reviews,0,3,3
1007520,7,Positive,9,1,10
1007560,0,5 user reviews,2,3,5
1007580,7,Positive,11,0,11
1007630,8,Very Positive,48,2,50
1007730,0,7 user reviews,4,3,7
1007780,6,Mostly Positive,17,6,23
1007800,0,4 user reviews,4,0,4
1007810,0,7 user reviews,7,0,7
1007830,0,5 user reviews,4,1,5
1007840,6,Mostly Positive,30,8,38
1007880,0,2 user reviews,2,0,2
1007910,0,5 user reviews,4,1,5
1007930,0,1 user reviews,1,0,1
1007940,0,8 user reviews,6,2,8
1007970,0,5 user reviews,0,5,5
1007980,0,1 user reviews,1,0,1
1007990,0,3 user reviews,1,2,3
1008010,0,7 user reviews,7,0,7
1008020,8,Very Positive,248,32,280
1008060,0,2 user reviews,2,0,2
1008140,0,4 user reviews,2,2,4
1008160,0,1 user reviews,0,1,1
1008210,0,2 user reviews,2,0,2
1008250,0,1 user reviews,1,0,1
1008260,0,2 user reviews,1,1,2
1008280,0,3 user reviews,3,0,3
1008290,5,Mixed,7,5,12
1008300,0,1 user reviews,1,0,1
1008320,0,7 user reviews,4,3,7
1008370,0,1 user reviews,1,0,1
1008390,0,1 user reviews,0,1,1
1008410,0,4 user reviews,1,3,4
1008430,0,1 user reviews,1,0,1
1008450,0,1 user reviews,1,0,1
1008460,7,Positive,23,3,26
1008510,5,Mixed,32,17,49
1008520,6,Mostly Positive,18,6,24
1008610,0,2 user reviews,0,2,2
1008680,0,4 user reviews,4,0,4
1008700,0,7 user reviews,6,1,7
1008710,6,Mostly Positive,245,72,317
1008730,0,2 user reviews,2,0,2
1008740,0,7 user reviews,6,1,7
1008800,8,Very Positive,55,4,59
1008830,7,Positive,12,1,13
1008850,0,1 user reviews,0,1,1
1008870,0,9 user reviews,6,3,9
1008910,0,1 user reviews,1,0,1
1008920,6,Mostly Positive,43,14,57
1008970,0,1 user reviews,1,0,1
1009100,0,2 user reviews,1,1,2
1009140,0,1 user reviews,1,0,1
1009150,0,2 user reviews,0,2,2
1009180,0,9 user reviews,6,3,9
1009210,0,2 user reviews,2,0,2
1009230,0,1 user reviews,0,1,1
1009290,5,Mixed,757,352,1109
1009300,0,1 user reviews,1,0,1
1009330,0,3 user reviews,3,0,3
1009350,0,5 user reviews,4,1,5
1009370,0,1 user reviews,1,0,1
1009390,0,2 user reviews,2,0,2
1009400,0,1 user reviews,1,0,1
1009450,8,Very Positive,107,4,111
1009460,7,Positive,14,1,15
1009590,0,2 user reviews,2,0,2
1009700,7,Positive,15,1,16
1009750,8,Very Positive,73,1,74
1009780,0,2 user reviews,2,0,2
1009810,0,1 user reviews,1,0,1
1009820,8,Very Positive,140,34,174
1009821,8,Very Positive,241,50,291
1009900,0,1 user reviews,0,1,1
1009920,0,7 user reviews,6,1,7
1009940,0,3 user reviews,1,2,3
1009960,0,6 user reviews,6,0,6
1010000,0,1 user reviews,1,0,1
1010070,0,1 user reviews,1,0,1
1010100,8,Very Positive,59,2,61
1010110,0,2 user reviews,2,0,2
1010120,0,1 user reviews,0,1,1
1010130,7,Positive,18,4,22
1010131,7,Positive,15,3,18
1010132,0,9 user reviews,9,0,9
1010133,5,Mixed,7,4,11
1010134,7,Positive,24,4,28
1010135,5,Mixed,18,17,35
1010136,7,Positive,37,8,45
1010137,5,Mixed,14,7,21
1010138,6,Mostly Positive,9,3,12
1010139,7,Positive,39,6,45
1010150,0,2 user reviews,2,0,2
1010170,5,Mixed,29,14,43
1010190,0,1 user reviews,1,0,1
1010210,0,5 user reviews,5,0,5
1010220,7,Positive,26,2,28
1010230,7,Positive,18,1,19
1010240,8,Very Positive,69,2,71
1010260,0,8 user reviews,3,5,8
1010270,5,Mixed,80,45,125
1010290,0,2 user reviews,2,0,2
1010330,0,1 user reviews,1,0,1
1010350,0,1 user reviews,1,0,1
1010380,0,3 user reviews,1,2,3
1010410,0,5 user reviews,3,2,5
1010420,0,1 user reviews,1,0,1
1010450,5,Mixed,13,9,22
1010460,0,5 user reviews,0,5,5
1010490,0,5 user reviews,3,2,5
1010520,0,1 user reviews,0,1,1
1010540,0,5 user reviews,4,1,5
1010590,0,2 user reviews,0,2,2
1010600,6,Mostly Positive,34,9,43
1010650,0,6 user reviews,5,1,6
1010660,6,Mostly Positive,12,5,17
1010670,8,Very Positive,108,9,117
1010740,0,1 user reviews,0,1,1
1010750,8,Very Positive,1865,113,1978
1010780,7,Positive,21,0,21
1010820,7,Positive,46,0,46
1010821,7,Positive,19,0,19
1010830,7,Positive,18,1,19
1010840,0,5 user reviews,4,1,5
1010860,5,Mixed,39,30,69
1010870,0,2 user reviews,2,0,2
1010920,0,1 user reviews,1,0,1
1010930,0,3 user reviews,2,1,3
1010950,0,2 user reviews,2,0,2
1010970,7,Positive,29,3,32
1011030,5,Mixed,14,7,21
1011070,6,Mostly Positive,24,7,31
1011090,7,Positive,21,5,26
1011120,0,2 user reviews,2,0,2
1011130,8,Very Positive,44,8,52
1011140,0,2 user reviews,0,2,2
1011171,0,1 user reviews,1,0,1
1011172,0,1 user reviews,1,0,1
1011173,0,1 user reviews,0,1,1
1011174,0,3 user reviews,0,3,3
1011190,8,Very Positive,156,32,188
1011240,0,3 user reviews,3,0,3
1011260,0,2 user reviews,2,0,2
1011270,5,Mixed,19,11,30
1011280,0,8 user reviews,8,0,8
1011290,8,Very Positive,50,6,56
1011300,0,3 user reviews,3,0,3
1011370,0,1 user reviews,0,1,1
1011390,8,Very Positive,291,56,347
1011400,0,6 user reviews,5,1,6
1011420,5,Mixed,13,8,21
1011460,0,1 user reviews,1,0,1
1011470,0,8 user reviews,7,1,8
1011524,0,1 user reviews,1,0,1
1011550,5,Mixed,7,4,11
1011610,8,Very Positive,169,21,190
1011620,0,4 user reviews,4,0,4
1011630,6,Mostly Positive,11,4,15
1011700,7,Positive,27,2,29
1011740,0,1 user reviews,0,1,1
1011760,0,1 user reviews,0,1,1
1011830,7,Positive,39,5,44
1011870,0,1 user reviews,1,0,1
1011890,7,Positive,12,1,13
1011900,7,Positive,16,2,18
1011940,8,Very Positive,111,10,121
1011950,0,2 user reviews,2,0,2
1011990,7,Positive,32,0,32
1012010,0,1 user reviews,1,0,1
1012030,8,Very Positive,72,6,78
1012070,0,2 user reviews,1,1,2
1012080,0,3 user reviews,3,0,3
1012081,5,Mixed,4,6,10
1012100,0,8 user reviews,3,5,8
1012101,0,3 user reviews,1,2,3
1012102,7,Positive,22,1,23
1012160,0,2 user reviews,1,1,2
1012210,0,4 user reviews,1,3,4
1012220,0,7 user reviews,6,1,7
1012270,0,1 user reviews,1,0,1
1012280,0,2 user reviews,2,0,2
1012360,0,1 user reviews,1,0,1
1012370,0,3 user reviews,1,2,3
1012380,0,1 user reviews,0,1,1
1012400,0,1 user reviews,0,1,1
1012401,0,1 user reviews,1,0,1
1012402,0,4 user reviews,3,1,4
1012403,0,2 user reviews,2,0,2
1012404,0,1 user reviews,0,1,1
1012405,0,5 user reviews,5,0,5
1012410,7,Positive,26,5,31
1012430,0,1 user reviews,1,0,1
1012450,0,5 user reviews,5,0,5
1012460,5,Mixed,8,7,15
1012490,0,1 user reviews,1,0,1
1012530,0,3 user reviews,3,0,3
1012560,8,Very Positive,889,69,958
1012580,0,9 user reviews,6,3,9
1012610,8,Very Positive,233,57,290
1012630,8,Very Positive,113,3,116
1012670,0,1 user reviews,1,0,1
1012710,0,1 user reviews,0,1,1
1012720,0,3 user reviews,2,1,3
1012790,6,Mostly Positive,241,71,312
1012800,0,1 user reviews,1,0,1
1012810,0,1 user reviews,1,0,1
1012830,6,Mostly Positive,8,3,11
1012840,6,Mostly Positive,466,127,593
1012850,0,9 user reviews,9,0,9
1012880,8,Very Positive,791,70,861
1012900,5,Mixed,21,15,36
1012960,0,7 user reviews,6,1,7
1012970,6,Mostly Positive,19,5,24
1012980,7,Positive,16,4,20
1012990,7,Positive,9,1,10
1013000,0,1 user reviews,0,1,1
1013040,6,Mostly Positive,21,8,29
1013070,0,7 user reviews,4,3,7
1013090,0,2 user reviews,2,0,2
1013100,0,4 user reviews,4,0,4
1013120,0,3 user reviews,2,1,3
1013130,5,Mixed,7,6,13
1013180,7,Positive,42,3,45
1013190,7,Positive,12,0,12
1013230,0,1 user reviews,1,0,1
1013280,7,Positive,19,0,19
1013290,0,1 user reviews,1,0,1
1013300,5,Mixed,31,16,47
1013310,5,Mixed,33,18,51
1013350,0,3 user reviews,1,2,3
1013410,0,8 user reviews,1,7,8
1013450,0,4 user reviews,3,1,4
1013540,8,Very Positive,54,12,66
1013580,0,6 user reviews,5,1,6
1013600,0,6 user reviews,6,0,6
1013630,0,1 user reviews,1,0,1
1013650,7,Positive,42,2,44
1013670,0,2 user reviews,2,0,2
1013700,5,Mixed,7,5,12
1013710,5,Mixed,8,4,12
1013750,6,Mostly Positive,11,3,14
1013820,0,5 user reviews,4,1,5
1013870,7,Positive,42,4,46
1013890,0,2 user reviews,1,1,2
1013950,0,3 user reviews,3,0,3
1013960,7,Positive,10,2,12
1014010,5,Mixed,6,5,11
1014030,0,1 user reviews,0,1,1
1014040,5,Mixed,11,7,18
1014050,0,3 user reviews,1,2,3
1014100,6,Mostly Positive,11,4,15
1014110,5,Mixed,8,4,12
1014130,6,Mostly Positive,45,16,61
1014140,8,Very Positive,73,3,76
1014270,0,5 user reviews,5,0,5
1014280,7,Positive,31,2,33
1014290,0,2 user reviews,2,0,2
1014300,0,7 user reviews,6,1,7
1014310,0,1 user reviews,1,0,1
1014360,0,2 user reviews,2,0,2
1014420,7,Positive,9,1,10
1014450,0,1 user reviews,1,0,1
1014460,6,Mostly Positive,13,4,17
1014560,6,Mostly Positive,7,3,10
1014570,7,Positive,14,2,16
1014580,0,7 user reviews,7,0,7
1014590,0,9 user reviews,3,6,9
1014620,0,4 user reviews,3,1,4
1014660,0,1 user reviews,1,0,1
1014710,0,7 user reviews,5,2,7
1014730,6,Mostly Positive,61,26,87
1014750,0,3 user reviews,3,0,3
1014790,0,1 user reviews,1,0,1
1014810,5,Mixed,22,17,39
1014820,0,3 user reviews,2,1,3
1014840,0,1 user reviews,1,0,1
1014850,0,3 user reviews,3,0,3
1014890,0,5 user reviews,2,3,5
1014900,5,Mixed,6,5,11
1014990,0,6 user reviews,5,1,6
1015020,0,9 user reviews,7,2,9
1015030,7,Positive,43,5,48
1015050,7,Positive,12,1,13
1015080,7,Positive,16,4,20
1015090,5,Mixed,30,35,65
1015100,0,3 user reviews,2,1,3
1015110,0,3 user reviews,3,0,3
1015130,5,Mixed,36,17,53
1015140,6,Mostly Positive,163,44,207
1015160,8,Very Positive,250,12,262
1015180,0,1 user reviews,0,1,1
1015240,0,4 user reviews,2,2,4
1015250,0,1 user reviews,1,0,1
1015350,4,Mostly Negative,4,8,12
1015430,6,Mostly Positive,17,6,23
1015470,0,2 user reviews,0,2,2
1015480,6,Mostly Positive,24,9,33
1015500,4,Mostly Negative,330,584,914
1015530,0,3 user reviews,2,1,3
1015540,0,2 user reviews,0,2,2
1015550,0,1 user reviews,1,0,1
1015610,5,Mixed,60,33,93
1015660,7,Positive,17,3,20
1015710,4,Mostly Negative,5,10,15
1015720,7,Positive,44,5,49
1015730,7,Positive,32,7,39
1015750,0,8 user reviews,6,2,8
1015770,7,Positive,31,7,38
1015790,5,Mixed,16,9,25
1015800,5,Mixed,10,6,16
1015830,5,Mixed,13,18,31
1015880,6,Mostly Positive,20,7,27
1015900,0,6 user reviews,6,0,6
1015930,4,Mostly Negative,79,121,200
1015940,7,Positive,40,0,40
1015980,5,Mixed,7,4,11
1016010,0,4 user reviews,2,2,4
1016070,2,Very Negative,12,65,77
1016080,5,Mixed,13,14,27
1016100,0,1 user reviews,1,0,1
1016120,8,Very Positive,931,228,1159
1016130,0,3 user reviews,3,0,3
1016150,0,3 user reviews,0,3,3
1016250,5,Mixed,9,6,15
1016300,0,4 user reviews,4,0,4
1016330,0,2 user reviews,2,0,2
1016420,0,7 user reviews,5,2,7
1016430,0,8 user reviews,8,0,8
1016520,0,5 user reviews,5,0,5
1016600,8,Very Positive,95,11,106
1016610,0,4 user reviews,2,2,4
1016630,7,Positive,15,0,15
1016650,0,1 user reviews,1,0,1
1016660,0,5 user reviews,4,1,5
1016690,0,2 user reviews,1,1,2
1016710,3,Negative,2,11,13
1016720,5,Mixed,16,13,29
1016730,5,Mixed,138,65,203
1016740,0,2 user reviews,0,2,2
1016760,6,Mostly Positive,13,5,18
1016770,8,Very Positive,82,10,92
1016790,6,Mostly Positive,81,31,112
1016800,6,Mostly Positive,580,177,757
1016810,5,Mixed,14,12,26
1016840,5,Mixed,41,26,67
1016850,0,1 user reviews,1,0,1
1016860,8,Very Positive,61,14,75
1016920,8,Very Positive,1036,59,1095
1016930,5,Mixed,39,24,63
1016940,7,Positive,10,2,12
1016960,8,Very Positive,223,45,268
1016980,0,6 user reviews,4,2,6
1017030,8,Very Positive,55,7,62
1017060,5,Mixed,41,25,66
1017130,0,6 user reviews,5,1,6
1017180,8,Very Positive,895,128,1023
1017240,0,1 user reviews,1,0,1
1017270,0,1 user reviews,1,0,1
1017350,0,5 user reviews,3,2,5
1017410,0,1 user reviews,1,0,1
1017440,0,1 user reviews,1,0,1
1017510,7,Positive,16,1,17
1017520,7,Positive,34,7,41
1017560,0,8 user reviews,7,1,8
1017580,5,Mixed,7,4,11
1017600,0,1 user reviews,0,1,1
1017610,0,2 user reviews,2,0,2
1017620,0,2 user reviews,1,1,2
1017630,0,4 user reviews,4,0,4
1017670,0,9 user reviews,8,1,9
1017750,0,1 user reviews,0,1,1
1017780,6,Mostly Positive,23,9,32
1017810,0,2 user reviews,2,0,2
1017880,0,5 user reviews,3,2,5
1017900,6,Mostly Positive,1548,393,1941
1017910,0,4 user reviews,3,1,4
1017940,6,Mostly Positive,12,4,16
1018000,5,Mixed,21,15,36
1018010,8,Very Positive,221,50,271
1018020,6,Mostly Positive,80,22,102
1018040,5,Mixed,9,4,13
1018080,0,3 user reviews,2,1,3
1018090,0,4 user reviews,1,3,4
1018130,7,Positive,24,2,26
1018160,8,Very Positive,135,32,167
1018240,0,5 user reviews,5,0,5
1018270,5,Mixed,11,11,22
1018320,0,1 user reviews,1,0,1
1018420,0,7 user reviews,6,1,7
1018480,0,1 user reviews,1,0,1
1018530,8,Very Positive,58,8,66
1018560,0,2 user reviews,2,0,2
1018590,0,3 user reviews,2,1,3
1018610,0,7 user reviews,4,3,7
1018670,0,1 user reviews,1,0,1
1018680,7,Positive,38,9,47
1018720,0,3 user reviews,2,1,3
1018760,0,4 user reviews,4,0,4
1018761,0,6 user reviews,6,0,6
1018770,0,1 user reviews,0,1,1
1018800,8,Very Positive,279,18,297
1018810,0,1 user reviews,1,0,1
1018820,0,4 user reviews,2,2,4
1018830,8,Very Positive,113,8,121
1018850,9,Overwhelmingly Positive,649,4,653
1018860,0,2 user reviews,2,0,2
1018870,5,Mixed,12,8,20
1018880,7,Positive,25,1,26
1018900,0,2 user reviews,2,0,2
1018960,0,2 user reviews,0,2,2
1018990,7,Positive,15,0,15
1019020,0,2 user reviews,2,0,2
1019040,0,5 user reviews,3,2,5
1019060,0,2 user reviews,1,1,2
1019070,0,4 user reviews,4,0,4
1019080,0,1 user reviews,0,1,1
1019133,0,3 user reviews,2,1,3
1019170,0,1 user reviews,0,1,1
1019230,7,Positive,14,1,15
1019270,0,2 user reviews,2,0,2
1019310,8,Very Positive,222,47,269
1019360,0,1 user reviews,0,1,1
1019400,0,3 user reviews,3,0,3
1019420,8,Very Positive,59,12,71
1019450,5,Mixed,24,17,41
1019510,0,4 user reviews,1,3,4
1019511,0,4 user reviews,3,1,4
1019512,0,2 user reviews,0,2,2
1019513,0,2 user reviews,1,1,2
1019540,7,Positive,9,1,10
1019550,6,Mostly Positive,229,89,318
1019590,7,Positive,43,1,44
1019630,0,8 user reviews,5,3,8
1019640,0,1 user reviews,1,0,1
1019710,0,1 user reviews,0,1,1
1019730,0,2 user reviews,2,0,2
1019790,0,2 user reviews,1,1,2
1019820,0,2 user reviews,2,0,2
1019920,7,Positive,14,0,14
1019930,7,Positive,30,3,33
1019940,5,Mixed,79,36,115
1019960,0,1 user reviews,1,0,1
1019964,0,1 user reviews,1,0,1
1019965,0,1 user reviews,1,0,1
1019966,0,2 user reviews,0,2,2
1019984,0,1 user reviews,1,0,1
1019985,0,1 user reviews,1,0,1
1019989,0,1 user reviews,1,0,1
1019993,0,1 user reviews,1,0,1
1019994,0,1 user reviews,1,0,1
1020020,0,1 user reviews,1,0,1
1020030,6,Mostly Positive,30,11,41
1020040,0,1 user reviews,1,0,1
1020050,5,Mixed,11,5,16
1020090,0,7 user reviews,7,0,7
1020100,7,Positive,11,1,12
1020120,0,2 user reviews,2,0,2
1020210,6,Mostly Positive,11,4,15
1020250,0,2 user reviews,1,1,2
1020270,7,Positive,28,4,32
1020290,0,4 user reviews,3,1,4
1020330,0,2 user reviews,2,0,2
1020340,8,Very Positive,256,45,301
1020390,0,4 user reviews,3,1,4
1020440,0,2 user reviews,1,1,2
1020450,0,6 user reviews,6,0,6
1020470,8,Very Positive,207,47,254
1020480,0,2 user reviews,1,1,2
1020490,0,2 user reviews,2,0,2
1020540,5,Mixed,10,10,20
1020560,0,3 user reviews,2,1,3
1020590,7,Positive,34,0,34
1020600,0,9 user reviews,5,4,9
1020630,0,1 user reviews,1,0,1
1020631,0,1 user reviews,1,0,1
1020650,0,1 user reviews,1,0,1
1020660,4,Mostly Negative,3,10,13
1020730,8,Very Positive,132,13,145
1020800,5,Mixed,24,12,36
1020820,6,Mostly Positive,84,31,115
1020840,0,1 user reviews,1,0,1
1020940,7,Positive,34,0,34
1020980,0,1 user reviews,0,1,1
1021060,0,1 user reviews,1,0,1
1021070,6,Mostly Positive,74,31,105
1021120,0,6 user reviews,2,4,6
1021130,0,3 user reviews,3,0,3
1021190,0,7 user reviews,5,2,7
1021280,7,Positive,25,0,25
1021370,0,3 user reviews,3,0,3
1021640,0,3 user reviews,3,0,3
1021670,0,2 user reviews,0,2,2
1021680,0,6 user reviews,5,1,6
1021690,0,3 user reviews,1,2,3
1021740,0,1 user reviews,0,1,1
1021770,8,Very Positive,64,2,66
1021780,3,Negative,1,23,24
1021790,5,Mixed,487,256,743
1021800,0,2 user reviews,1,1,2
1021820,0,2 user reviews,2,0,2
1021860,0,4 user reviews,4,0,4
1021880,0,1 user reviews,1,0,1
1021900,0,1 user reviews,1,0,1
1022010,6,Mostly Positive,12,4,16
1022040,0,3 user reviews,1,2,3
1022120,0,1 user reviews,1,0,1
1022130,0,7 user reviews,6,1,7
1022160,0,1 user reviews,1,0,1
1022170,0,1 user reviews,0,1,1
1022230,5,Mixed,57,26,83
1022270,0,2 user reviews,2,0,2
1022280,0,2 user reviews,1,1,2
1022310,6,Mostly Positive,346,112,458
1022380,0,1 user reviews,0,1,1
1022392,0,1 user reviews,1,0,1
1022418,0,1 user reviews,1,0,1
1022424,0,1 user reviews,1,0,1
1022438,0,1 user reviews,1,0,1
1022443,0,1 user reviews,1,0,1
1022448,0,2 user reviews,2,0,2
1022449,0,1 user reviews,1,0,1
1022460,0,2 user reviews,2,0,2
1022468,0,1 user reviews,1,0,1
1022478,0,1 user reviews,1,0,1
1022480,7,Positive,24,5,29
1022497,0,1 user reviews,1,0,1
1022510,0,1 user reviews,1,0,1
1022530,0,2 user reviews,1,1,2
1022550,0,3 user reviews,3,0,3
1022570,0,5 user reviews,4,1,5
1022610,0,7 user reviews,7,0,7
1022640,0,1 user reviews,1,0,1
1022650,0,4 user reviews,3,1,4
1022700,0,5 user reviews,3,2,5
1022710,5,Mixed,47,23,70
1022770,0,6 user reviews,4,2,6
1022780,6,Mostly Positive,40,12,52
1022830,5,Mixed,8,9,17
1022850,8,Very Positive,94,4,98
1022870,7,Positive,14,0,14
1022910,0,5 user reviews,4,1,5
1022980,5,Mixed,135,70,205
1022990,7,Positive,11,1,12
1023010,0,1 user reviews,1,0,1
1023030,0,1 user reviews,1,0,1
1023060,0,2 user reviews,1,1,2
1023110,0,1 user reviews,1,0,1
1023130,0,1 user reviews,1,0,1
1023150,0,2 user reviews,2,0,2
1023160,0,1 user reviews,1,0,1
1023260,0,5 user reviews,4,1,5
1023310,0,1 user reviews,1,0,1
1023390,0,6 user reviews,3,3,6
1023410,0,2 user reviews,2,0,2
1023510,0,7 user reviews,3,4,7
1023550,7,Positive,27,0,27
1023560,0,2 user reviews,2,0,2
1023640,0,6 user reviews,4,2,6
1023650,0,1 user reviews,1,0,1
1023680,0,5 user reviews,2,3,5
1023690,7,Positive,17,1,18
1023700,7,Positive,18,3,21
1023710,0,4 user reviews,4,0,4
1023720,0,3 user reviews,3,0,3
1023740,8,Very Positive,79,16,95
1023750,0,4 user reviews,3,1,4
1023780,0,2 user reviews,2,0,2
1023802,7,Positive,11,1,12
1023860,0,3 user reviews,3,0,3
1023870,5,Mixed,12,14,26
1023930,6,Mostly Positive,9,3,12
1023960,0,1 user reviews,0,1,1
1023970,6,Mostly Positive,23,6,29
1023980,5,Mixed,12,18,30
1024010,8,Very Positive,106,18,124
1024080,0,6 user reviews,4,2,6
1024100,0,4 user reviews,4,0,4
1024110,6,Mostly Positive,31,12,43
1024150,0,2 user reviews,0,2,2
1024210,0,5 user reviews,4,1,5
1024220,0,2 user reviews,0,2,2
1024250,0,1 user reviews,0,1,1
1024380,6,Mostly Positive,558,158,716
1024400,0,9 user reviews,7,2,9
1024430,4,Mostly Negative,5,8,13
1024460,7,Positive,31,4,35
1024480,5,Mixed,60,45,105
1024490,0,2 user reviews,2,0,2
1024530,0,1 user reviews,1,0,1
1024540,0,3 user reviews,2,1,3
1024551,0,2 user reviews,2,0,2
1024570,0,3 user reviews,3,0,3
1024590,0,4 user reviews,3,1,4
1024600,0,5 user reviews,1,4,5
1024630,6,Mostly Positive,14,5,19
1024640,6,Mostly Positive,10,3,13
1024650,5,Mixed,100,73,173
1024660,7,Positive,34,6,40
1024670,6,Mostly Positive,11,3,14
1024690,0,1 user reviews,0,1,1
1024700,0,3 user reviews,1,2,3
1024701,6,Mostly Positive,7,3,10
1024702,7,Positive,15,2,17
1024703,0,9 user reviews,6,3,9
1024704,0,7 user reviews,1,6,7
1024730,0,2 user reviews,2,0,2
1024770,7,Positive,29,6,35
1024780,0,1 user reviews,0,1,1
1024800,0,3 user reviews,3,0,3
1024810,0,3 user reviews,3,0,3
1024860,0,2 user reviews,2,0,2
1024950,0,3 user reviews,2,1,3
1025000,0,4 user reviews,3,1,4
1025020,0,1 user reviews,1,0,1
1025070,0,3 user reviews,3,0,3
1025130,0,9 user reviews,9,0,9
1025140,8,Very Positive,82,7,89
1025160,0,2 user reviews,2,0,2
1025240,0,2 user reviews,2,0,2
1025250,7,Positive,18,3,21
1025270,0,1 user reviews,0,1,1
1025280,0,1 user reviews,1,0,1
1025290,0,1 user reviews,1,0,1
1025340,5,Mixed,17,8,25
1025360,0,1 user reviews,1,0,1
1025410,6,Mostly Positive,47,12,59
1025420,0,1 user reviews,1,0,1
1025430,0,1 user reviews,0,1,1
1025440,8,Very Positive,260,48,308
1025450,0,1 user reviews,0,1,1
1025460,0,7 user reviews,7,0,7
1025480,0,4 user reviews,4,0,4
1025510,0,2 user reviews,1,1,2
1025520,0,1 user reviews,1,0,1
1025530,0,4 user reviews,2,2,4
1025540,0,3 user reviews,2,1,3
1025550,0,2 user reviews,1,1,2
1025590,0,9 user reviews,8,1,9
1025600,8,Very Positive,595,116,711
1025650,0,1 user reviews,0,1,1
1025740,4,Mostly Negative,4,7,11
1025870,0,4 user reviews,0,4,4
1025890,0,1 user reviews,1,0,1
1025990,0,1 user reviews,1,0,1
1026010,0,3 user reviews,3,0,3
1026020,0,2 user reviews,2,0,2
1026060,0,1 user reviews,0,1,1
1026070,0,6 user reviews,5,1,6
1026080,0,4 user reviews,2,2,4
1026090,0,1 user reviews,1,0,1
1026130,7,Positive,27,2,29
1026160,8,Very Positive,47,8,55
1026171,0,2 user reviews,2,0,2
1026200,5,Mixed,16,9,25
1026210,0,1 user reviews,0,1,1
1026370,0,8 user reviews,8,0,8
1026380,7,Positive,10,2,12
1026390,0,6 user reviews,5,1,6
1026400,8,Very Positive,64,1,65
1026420,6,Mostly Positive,136,40,176
1026430,0,3 user reviews,3,0,3
1026560,0,2 user reviews,2,0,2
1026610,0,7 user reviews,7,0,7
1026670,0,3 user reviews,3,0,3
1026680,5,Mixed,580,343,923
1026740,0,3 user reviews,2,1,3
1026750,0,1 user reviews,1,0,1
1026770,0,4 user reviews,1,3,4
1026800,0,1 user reviews,1,0,1
1026820,0,4 user reviews,4,0,4
1026880,0,4 user reviews,4,0,4
1026910,0,1 user reviews,1,0,1
1026940,0,3 user reviews,3,0,3
1026960,0,8 user reviews,4,4,8
1026970,5,Mixed,11,5,16
1027130,5,Mixed,8,4,12
1027140,0,5 user reviews,3,2,5
1027190,7,Positive,14,1,15
1027230,0,4 user reviews,4,0,4
1027250,7,Positive,28,5,33
1027520,0,4 user reviews,2,2,4
1027530,0,1 user reviews,0,1,1
1027600,5,Mixed,7,4,11
1027610,0,1 user reviews,1,0,1
1027620,7,Positive,42,1,43
1027690,0,1 user reviews,0,1,1
1027720,0,4 user reviews,4,0,4
1027790,0,1 user reviews,1,0,1
1027800,0,3 user reviews,2,1,3
1027830,0,1 user reviews,1,0,1
1027880,0,4 user reviews,4,0,4
1027900,0,5 user reviews,5,0,5
1027930,0,1 user reviews,1,0,1
1027960,0,2 user reviews,1,1,2
1027970,6,Mostly Positive,9,3,12
1027990,0,2 user reviews,2,0,2
1028010,0,1 user reviews,1,0,1
1028030,0,1 user reviews,1,0,1
1028110,0,2 user reviews,0,2,2
1028120,0,2 user reviews,2,0,2
1028130,5,Mixed,12,7,19
1028160,0,2 user reviews,0,2,2
1028210,8,Very Positive,55,5,60
1028240,0,1 user reviews,0,1,1
1028250,0,2 user reviews,2,0,2
1028270,8,Very Positive,50,6,56
1028290,0,2 user reviews,2,0,2
1028300,7,Positive,11,0,11
1028340,0,6 user reviews,5,1,6
1028360,0,1 user reviews,0,1,1
1028410,0,1 user reviews,0,1,1
1028420,7,Positive,19,0,19
1028430,5,Mixed,81,75,156
1028440,5,Mixed,21,10,31
1028460,0,2 user reviews,2,0,2
1028480,0,2 user reviews,2,0,2
1028490,0,5 user reviews,4,1,5
1028500,0,7 user reviews,7,0,7
1028520,0,8 user reviews,6,2,8
1028530,7,Positive,27,0,27
1028550,0,2 user reviews,2,0,2
1028570,8,Very Positive,109,13,122
1028610,0,1 user reviews,0,1,1
1028630,8,Very Positive,804,89,893
1028660,0,1 user reviews,1,0,1
1028702,7,Positive,11,0,11
1028703,0,9 user reviews,9,0,9
1028704,0,5 user reviews,5,0,5
1028710,0,1 user reviews,1,0,1
1028711,0,2 user reviews,2,0,2
1028712,0,1 user reviews,1,0,1
1028720,0,1 user reviews,1,0,1
1028730,6,Mostly Positive,11,4,15
1028740,5,Mixed,6,7,13
1028760,0,2 user reviews,1,1,2
1028770,0,4 user reviews,1,3,4
1028780,0,1 user reviews,0,1,1
1028800,5,Mixed,9,5,14
1028820,0,2 user reviews,1,1,2
1028840,0,4 user reviews,2,2,4
1028850,0,4 user reviews,4,0,4
1028890,0,9 user reviews,7,2,9
1028891,0,3 user reviews,3,0,3
1028892,0,6 user reviews,1,5,6
1028893,0,1 user reviews,0,1,1
1028894,0,5 user reviews,3,2,5
1028895,0,9 user reviews,6,3,9
1028900,0,1 user reviews,1,0,1
1028920,7,Positive,9,1,10
1028990,0,1 user reviews,0,1,1
1029000,7,Positive,13,1,14
1029020,0,1 user reviews,1,0,1
1029040,7,Positive,8,2,10
1029050,0,3 user reviews,2,1,3
1029070,0,6 user reviews,4,2,6
1029080,0,5 user reviews,5,0,5
1029090,0,6 user reviews,3,3,6
1029100,6,Mostly Positive,13,5,18
1029130,7,Positive,15,0,15
1029150,0,6 user reviews,5,1,6
1029160,0,6 user reviews,5,1,6
1029170,7,Positive,21,1,22
1029220,0,4 user reviews,4,0,4
1029240,5,Mixed,53,23,76
1029300,0,1 user reviews,1,0,1
1029311,0,1 user reviews,1,0,1
1029320,7,Positive,25,0,25
1029321,0,1 user reviews,1,0,1
1029322,0,1 user reviews,1,0,1
1029323,0,2 user reviews,2,0,2
1029330,0,6 user reviews,6,0,6
1029331,7,Positive,17,1,18
1029340,0,6 user reviews,6,0,6
1029350,0,1 user reviews,1,0,1
1029360,0,3 user reviews,3,0,3
1029371,0,2 user reviews,2,0,2
1029372,0,2 user reviews,2,0,2
1029380,7,Positive,16,0,16
1029390,0,1 user reviews,1,0,1
1029391,0,2 user reviews,1,1,2
1029392,0,1 user reviews,1,0,1
1029400,0,1 user reviews,1,0,1
1029412,0,4 user reviews,4,0,4
1029431,0,2 user reviews,2,0,2
1029450,0,4 user reviews,4,0,4
1029530,0,2 user reviews,1,1,2
1029550,6,Mostly Positive,113,35,148
1029560,0,1 user reviews,1,0,1
1029570,7,Positive,28,4,32
1029630,5,Mixed,203,145,348
1029660,0,4 user reviews,1,3,4
1029720,0,5 user reviews,4,1,5
1029730,5,Mixed,9,7,16
1029760,7,Positive,28,2,30
1029790,0,2 user reviews,2,0,2
1029810,0,2 user reviews,2,0,2
1029860,7,Positive,12,1,13
1029870,7,Positive,9,2,11
1029890,6,Mostly Positive,332,132,464
1029900,6,Mostly Positive,14,4,18
1029920,0,3 user reviews,2,1,3
1029980,8,Very Positive,66,8,74
1029990,6,Mostly Positive,23,9,32
1030050,0,1 user reviews,0,1,1
1030090,0,1 user reviews,0,1,1
1030170,0,2 user reviews,2,0,2
1030180,0,3 user reviews,1,2,3
1030190,0,4 user reviews,3,1,4
1030210,5,Mixed,1548,1298,2846
1030223,0,3 user reviews,2,1,3
1030230,0,2 user reviews,1,1,2
1030270,7,Positive,10,0,10
1030330,0,1 user reviews,0,1,1
1030360,0,6 user reviews,5,1,6
1030380,0,5 user reviews,1,4,5
1030410,5,Mixed,8,6,14
1030430,0,8 user reviews,8,0,8
1030470,7,Positive,15,1,16
1030490,0,3 user reviews,3,0,3
1030500,6,Mostly Positive,19,6,25
1030530,0,2 user reviews,2,0,2
1030563,0,1 user reviews,1,0,1
1030580,8,Very Positive,47,11,58
1030590,0,1 user reviews,1,0,1
1030760,0,1 user reviews,0,1,1
1030830,5,Mixed,893,486,1379
1030840,8,Very Positive,4250,606,4856
1030950,4,Mostly Negative,4,7,11
1030960,0,7 user reviews,7,0,7
1030970,0,1 user reviews,1,0,1
1030980,0,1 user reviews,1,0,1
1031020,7,Positive,25,4,29
1031130,0,2 user reviews,1,1,2
1031170,6,Mostly Positive,29,10,39
1031200,0,2 user reviews,0,2,2
1031210,0,3 user reviews,3,0,3
1031220,0,2 user reviews,1,1,2
1031230,0,1 user reviews,0,1,1
1031260,0,3 user reviews,2,1,3
1031300,0,1 user reviews,1,0,1
1031310,0,3 user reviews,1,2,3
1031320,0,1 user reviews,1,0,1
1031330,0,1 user reviews,1,0,1
1031420,0,3 user reviews,3,0,3
1031421,0,2 user reviews,2,0,2
1031440,7,Positive,44,4,48
1031470,0,1 user reviews,0,1,1
1031480,8,Very Positive,122,1,123
1031500,8,Very Positive,163,3,166
1031510,8,Very Positive,51,1,52
1031540,0,9 user reviews,5,4,9
1031550,0,5 user reviews,5,0,5
1031570,0,5 user reviews,3,2,5
1031580,0,2 user reviews,2,0,2
1031590,0,1 user reviews,0,1,1
1031630,0,1 user reviews,1,0,1
1031640,0,4 user reviews,3,1,4
1031650,0,4 user reviews,3,1,4
1031660,0,2 user reviews,0,2,2
1031770,0,1 user reviews,1,0,1
1031790,7,Positive,28,4,32
1031800,0,1 user reviews,0,1,1
1031810,0,4 user reviews,2,2,4
1031830,0,2 user reviews,2,0,2
1031840,0,4 user reviews,3,1,4
1031910,0,1 user reviews,1,0,1
1031920,5,Mixed,11,5,16
1032040,0,1 user reviews,1,0,1
1032050,0,9 user reviews,9,0,9
1032070,0,4 user reviews,4,0,4
1032170,7,Positive,24,3,27
1032230,0,2 user reviews,2,0,2
1032240,0,3 user reviews,2,1,3
1032260,0,1 user reviews,0,1,1
1032270,0,1 user reviews,0,1,1
1032290,0,2 user reviews,2,0,2
1032330,0,3 user reviews,3,0,3
1032340,0,9 user reviews,7,2,9
1032370,5,Mixed,29,13,42
1032390,0,8 user reviews,8,0,8
1032410,0,4 user reviews,3,1,4
1032430,5,Mixed,328,190,518
1032440,0,1 user reviews,1,0,1
1032450,0,4 user reviews,4,0,4
1032560,0,2 user reviews,2,0,2
1032570,0,3 user reviews,1,2,3
1032580,0,3 user reviews,3,0,3
1032590,7,Positive,23,1,24
1032670,7,Positive,42,7,49
1032730,8,Very Positive,69,7,76
1032760,0,7 user reviews,4,3,7
1032790,8,Very Positive,43,8,51
1032830,7,Positive,23,1,24
1033060,4,Mostly Negative,305,602,907
1033070,0,3 user reviews,3,0,3
1033090,0,1 user reviews,1,0,1
1033110,0,2 user reviews,0,2,2
1033120,5,Mixed,7,10,17
1033170,8,Very Positive,53,13,66
1033210,0,9 user reviews,8,1,9
1033220,6,Mostly Positive,18,6,24
1033230,0,1 user reviews,1,0,1
1033240,0,5 user reviews,3,2,5
1033250,0,1 user reviews,0,1,1
1033330,0,3 user reviews,1,2,3
1033340,0,4 user reviews,4,0,4
1033360,0,1 user reviews,1,0,1
1033410,7,Positive,34,3,37
1033420,8,Very Positive,50,1,51
1033450,0,7 user reviews,4,3,7
1033460,0,4 user reviews,3,1,4
1033470,0,1 user reviews,1,0,1
1033471,0,1 user reviews,1,0,1
1033472,0,2 user reviews,2,0,2
1033473,0,1 user reviews,1,0,1
1033474,0,2 user reviews,2,0,2
1033475,0,2 user reviews,1,1,2
1033476,0,2 user reviews,2,0,2
1033477,0,3 user reviews,2,1,3
1033478,0,3 user reviews,2,1,3
1033479,0,2 user reviews,1,1,2
1033482,0,1 user reviews,0,1,1
1033483,0,1 user reviews,1,0,1
1033484,0,1 user reviews,1,0,1
1033485,0,1 user reviews,0,1,1
1033486,0,1 user reviews,1,0,1
1033487,0,1 user reviews,1,0,1
1033488,0,1 user reviews,1,0,1
1033489,0,1 user reviews,0,1,1
1033490,7,Positive,25,2,27
1033503,0,1 user reviews,1,0,1
1033510,0,4 user reviews,2,2,4
1033530,7,Positive,16,4,20
1033580,0,5 user reviews,5,0,5
1033640,4,Mostly Negative,4,11,15
1033710,0,2 user reviews,1,1,2
1033720,0,5 user reviews,0,5,5
1033780,7,Positive,16,1,17
1033790,0,3 user reviews,3,0,3
1033860,0,3 user reviews,0,3,3
1033880,8,Very Positive,82,12,94
1033890,5,Mixed,180,130,310
1033910,0,7 user reviews,3,4,7
1033920,0,1 user reviews,1,0,1
1034030,0,3 user reviews,3,0,3
1034060,5,Mixed,6,4,10
1034120,0,4 user reviews,2,2,4
1034130,0,2 user reviews,1,1,2
1034160,5,Mixed,6,4,10
1034230,0,3 user reviews,2,1,3
1034240,0,5 user reviews,4,1,5
1034250,0,4 user reviews,2,2,4
1034260,0,2 user reviews,1,1,2
1034270,0,2 user reviews,2,0,2
1034280,0,5 user reviews,4,1,5
1034291,0,3 user reviews,3,0,3
1034370,0,3 user reviews,2,1,3
1034380,0,2 user reviews,1,1,2
1034390,0,1 user reviews,1,0,1
1034400,0,5 user reviews,4,1,5
1034410,0,5 user reviews,3,2,5
1034450,0,3 user reviews,3,0,3
1034471,0,4 user reviews,3,1,4
1034480,0,3 user reviews,3,0,3
1034510,0,3 user reviews,3,0,3
1034511,0,3 user reviews,3,0,3
1034540,0,9 user reviews,7,2,9
1034550,0,2 user reviews,2,0,2
1034560,0,6 user reviews,5,1,6
1034700,6,Mostly Positive,139,36,175
1034750,7,Positive,22,5,27
1034810,5,Mixed,10,5,15
1034820,0,1 user reviews,0,1,1
1034850,6,Mostly Positive,44,16,60
1034860,8,Very Positive,209,13,222
1034870,0,6 user reviews,5,1,6
1034890,7,Positive,21,2,23
1034900,8,Very Positive,225,11,236
1034910,8,Very Positive,72,11,83
1034920,0,9 user reviews,7,2,9
1034940,8,Very Positive,98,3,101
1034950,0,8 user reviews,8,0,8
1034970,6,Mostly Positive,7,3,10
1035010,7,Positive,15,3,18
1035020,0,9 user reviews,8,1,9
1035030,7,Positive,10,0,10
1035050,7,Positive,21,4,25
1035110,7,Positive,10,2,12
1035150,0,1 user reviews,0,1,1
1035190,0,4 user reviews,2,2,4
1035230,0,8 user reviews,8,0,8
1035260,0,1 user reviews,1,0,1
1035270,0,3 user reviews,1,2,3
1035310,0,9 user reviews,5,4,9
1035470,0,2 user reviews,2,0,2
1035490,0,1 user reviews,1,0,1
1035500,0,1 user reviews,0,1,1
1035510,7,Positive,32,2,34
1035530,0,6 user reviews,5,1,6
1035560,8,Very Positive,65,4,69
1035610,8,Very Positive,52,8,60
1035690,0,1 user reviews,1,0,1
1035700,0,4 user reviews,4,0,4
1035770,0,9 user reviews,8,1,9
1035790,0,1 user reviews,1,0,1
1035830,0,1 user reviews,0,1,1
1035850,7,Positive,22,0,22
1035860,0,1 user reviews,0,1,1
1035920,0,1 user reviews,1,0,1
1035930,7,Positive,14,1,15
1035950,7,Positive,31,2,33
1036000,0,1 user reviews,1,0,1
1036020,0,1 user reviews,1,0,1
1036120,0,2 user reviews,2,0,2
1036220,0,1 user reviews,1,0,1
1036260,7,Positive,13,3,16
1036320,0,1 user reviews,0,1,1
1036370,7,Positive,16,0,16
1036400,0,1 user reviews,0,1,1
1036420,0,6 user reviews,4,2,6
1036440,6,Mostly Positive,84,33,117
1036470,0,8 user reviews,6,2,8
1036480,7,Positive,9,2,11
1036490,7,Positive,19,0,19
1036550,0,2 user reviews,1,1,2
1036580,8,Very Positive,75,5,80
1036600,5,Mixed,6,4,10
1036660,7,Positive,16,3,19
1036700,7,Positive,41,2,43
1036750,7,Positive,21,4,25
1036760,7,Positive,32,7,39
1036770,0,1 user reviews,1,0,1
1036771,0,1 user reviews,1,0,1
1036780,0,2 user reviews,1,1,2
1036797,0,1 user reviews,1,0,1
1036798,0,1 user reviews,1,0,1
1036799,0,2 user reviews,2,0,2
1036800,0,3 user reviews,1,2,3
1036820,0,7 user reviews,4,3,7
1036840,0,4 user reviews,2,2,4
1036870,0,3 user reviews,2,1,3
1036900,0,2 user reviews,2,0,2
1036910,5,Mixed,9,5,14
1036920,0,3 user reviews,1,2,3
1036950,0,8 user reviews,8,0,8
1036970,7,Positive,8,2,10
1036980,6,Mostly Positive,20,8,28
1036990,0,6 user reviews,5,1,6
1037010,0,4 user reviews,3,1,4
1037020,8,Very Positive,452,32,484
1037050,0,5 user reviews,4,1,5
1037090,0,2 user reviews,2,0,2
1037100,7,Positive,8,2,10
1037140,0,2 user reviews,1,1,2
1037190,8,Very Positive,50,0,50
1037200,7,Positive,11,2,13
1037260,0,1 user reviews,0,1,1
1037330,0,2 user reviews,0,2,2
1037340,0,1 user reviews,0,1,1
1037350,0,4 user reviews,1,3,4
1037420,0,2 user reviews,2,0,2
1037430,0,1 user reviews,1,0,1
1037480,7,Positive,42,2,44
1037560,6,Mostly Positive,62,19,81
1037570,6,Mostly Positive,27,11,38
1037590,8,Very Positive,194,29,223
1037690,0,9 user reviews,9,0,9
1037750,6,Mostly Positive,27,7,34
1037760,6,Mostly Positive,15,5,20
1037820,5,Mixed,7,4,11
1037830,0,1 user reviews,1,0,1
1037840,0,3 user reviews,1,2,3
1037850,0,1 user reviews,1,0,1
1037890,7,Positive,9,2,11
1037930,0,1 user reviews,0,1,1
1037940,7,Positive,24,6,30
1037960,5,Mixed,21,19,40
1037970,0,3 user reviews,2,1,3
1037990,8,Very Positive,46,8,54
1038000,7,Positive,17,1,18
1038100,0,8 user reviews,7,1,8
1038120,0,1 user reviews,1,0,1
1038240,5,Mixed,7,8,15
1038260,0,1 user reviews,1,0,1
1038280,8,Very Positive,47,4,51
1038300,7,Positive,19,1,20
1038370,8,Very Positive,307,17,324
1038380,0,4 user reviews,4,0,4
1038400,0,2 user reviews,2,0,2
1038430,0,1 user reviews,1,0,1
1038450,5,Mixed,306,242,548
1038500,7,Positive,13,2,15
1038510,0,1 user reviews,1,0,1
1038620,5,Mixed,11,10,21
1038630,0,8 user reviews,7,1,8
1038640,0,2 user reviews,1,1,2
1038650,0,4 user reviews,2,2,4
1038670,0,1 user reviews,0,1,1
1038710,7,Positive,10,1,11
1038740,8,Very Positive,209,10,219
1038810,6,Mostly Positive,22,8,30
1038820,0,1 user reviews,1,0,1
1038830,0,2 user reviews,1,1,2
1038840,0,1 user reviews,1,0,1
1038950,0,1 user reviews,1,0,1
1039030,0,1 user reviews,1,0,1
1039040,0,5 user reviews,4,1,5
1039060,0,1 user reviews,0,1,1
1039080,7,Positive,10,2,12
1039200,7,Positive,20,1,21
1039210,0,1 user reviews,1,0,1
1039290,0,7 user reviews,7,0,7
1039310,0,5 user reviews,3,2,5
1039320,0,2 user reviews,1,1,2
1039330,0,1 user reviews,1,0,1
1039350,7,Positive,21,4,25
1039370,5,Mixed,21,17,38
1039380,0,7 user reviews,6,1,7
1039430,0,1 user reviews,1,0,1
1039470,0,1 user reviews,1,0,1
1039480,6,Mostly Positive,53,15,68
1039570,0,5 user reviews,3,2,5
1039580,0,1 user reviews,1,0,1
1039830,0,5 user reviews,1,4,5
1039860,0,1 user reviews,1,0,1
1039880,8,Very Positive,535,117,652
1039890,5,Mixed,164,101,265
1039910,0,3 user reviews,3,0,3
1039940,8,Very Positive,60,1,61
1039960,0,9 user reviews,9,0,9
1039970,7,Positive,11,2,13
1040000,0,1 user reviews,1,0,1
1040030,0,1 user reviews,1,0,1
1040070,8,Very Positive,426,55,481
1040080,6,Mostly Positive,15,4,19
1040150,0,1 user reviews,1,0,1
1040230,6,Mostly Positive,73,19,92
1040310,0,5 user reviews,3,2,5
1040370,0,2 user reviews,2,0,2
1040390,7,Positive,25,2,27
1040420,8,Very Positive,232,9,241
1040460,6,Mostly Positive,10,4,14
1040501,0,2 user reviews,0,2,2
1040550,8,Very Positive,157,3,160
1040590,7,Positive,11,2,13
1040620,0,2 user reviews,2,0,2
1040630,8,Very Positive,71,9,80
1040690,0,3 user reviews,1,2,3
1040700,0,1 user reviews,1,0,1
1040720,0,1 user reviews,0,1,1
1040730,7,Positive,18,2,20
1040740,0,3 user reviews,2,1,3
1040750,0,1 user reviews,1,0,1
1040860,0,2 user reviews,0,2,2
1040880,0,1 user reviews,0,1,1
1040930,7,Positive,22,4,26
1040940,5,Mixed,4,6,10
1041000,7,Positive,15,0,15
1041010,0,6 user reviews,6,0,6
1041130,0,7 user reviews,5,2,7
1041140,0,4 user reviews,0,4,4
1041270,0,7 user reviews,4,3,7
1041390,0,3 user reviews,2,1,3
1041400,8,Very Positive,85,18,103
1041450,0,3 user reviews,3,0,3
1041460,8,Very Positive,50,2,52
1041500,0,4 user reviews,4,0,4
1041650,0,1 user reviews,1,0,1
1041670,0,9 user reviews,6,3,9
1041680,5,Mixed,24,13,37
1041690,6,Mostly Positive,14,4,18
1041710,0,2 user reviews,2,0,2
1041720,6,Mostly Positive,1219,426,1645
1041780,0,8 user reviews,5,3,8
1041840,5,Mixed,50,25,75
1041920,8,Very Positive,112,5,117
1041940,7,Positive,35,5,40
1042020,4,Mostly Negative,7,12,19
1042030,0,5 user reviews,5,0,5
1042040,0,1 user reviews,0,1,1
1042050,0,1 user reviews,0,1,1
1042080,0,5 user reviews,4,1,5
1042090,0,5 user reviews,4,1,5
1042130,0,3 user reviews,2,1,3
1042150,0,1 user reviews,1,0,1
1042160,6,Mostly Positive,17,7,24
1042170,0,5 user reviews,4,1,5
1042220,5,Mixed,363,325,688
1042270,8,Very Positive,60,6,66
1042290,0,2 user reviews,0,2,2
1042310,0,4 user reviews,2,2,4
1042330,7,Positive,10,0,10
1042360,6,Mostly Positive,23,9,32
1042390,7,Positive,24,0,24
1042550,8,Very Positive,1061,60,1121
1042580,0,1 user reviews,1,0,1
1042670,5,Mixed,18,10,28
1042730,0,6 user reviews,5,1,6
1042731,0,9 user reviews,6,3,9
1042780,6,Mostly Positive,337,129,466
1042800,8,Very Positive,452,108,560
1042820,0,6 user reviews,3,3,6
1042850,0,6 user reviews,6,0,6
1042851,0,3 user reviews,3,0,3
1042880,0,1 user reviews,0,1,1
1042950,0,1 user reviews,0,1,1
1042980,6,Mostly Positive,12,4,16
1042990,5,Mixed,7,4,11
1043000,6,Mostly Positive,9,3,12
1043020,0,2 user reviews,0,2,2
1043030,0,3 user reviews,3,0,3
1043040,0,4 user reviews,1,3,4
1043060,0,1 user reviews,1,0,1
1043120,0,4 user reviews,4,0,4
1043140,0,1 user reviews,1,0,1
1043150,7,Positive,24,2,26
1043160,0,2 user reviews,2,0,2
1043200,0,4 user reviews,4,0,4
1043230,7,Positive,35,0,35
1043240,7,Positive,40,0,40
1043250,0,6 user reviews,6,0,6
1043340,8,Very Positive,431,13,444
1043350,5,Mixed,9,9,18
1043360,0,4 user reviews,1,3,4
1043390,8,Very Positive,294,31,325
1043420,0,7 user reviews,5,2,7
1043430,7,Positive,35,5,40
1043500,8,Very Positive,99,6,105
1043510,0,1 user reviews,1,0,1
1043550,0,1 user reviews,1,0,1
1043560,0,3 user reviews,3,0,3
1043580,0,2 user reviews,2,0,2
1043610,0,6 user reviews,3,3,6
1043690,7,Positive,11,0,11
1043710,0,2 user reviews,2,0,2
1043860,0,1 user reviews,1,0,1
1043870,0,7 user reviews,7,0,7
1043880,0,7 user reviews,4,3,7
1043890,0,5 user reviews,4,1,5
1044020,0,9 user reviews,8,1,9
1044040,5,Mixed,20,17,37
1044130,0,2 user reviews,2,0,2
1044140,0,2 user reviews,2,0,2
1044141,0,1 user reviews,1,0,1
1044170,3,Negative,2,14,16
1044190,0,2 user reviews,2,0,2
1044210,0,1 user reviews,1,0,1
1044220,0,7 user reviews,6,1,7
1044260,0,2 user reviews,2,0,2
1044310,0,9 user reviews,8,1,9
1044340,6,Mostly Positive,39,15,54
1044350,0,4 user reviews,3,1,4
1044440,7,Positive,23,5,28
1044450,7,Positive,29,2,31
1044460,0,2 user reviews,0,2,2
1044490,8,Very Positive,60,5,65
1044500,7,Positive,23,4,27
1044520,0,6 user reviews,5,1,6
1044620,8,Very Positive,307,6,313
1044630,4,Mostly Negative,2,8,10
1044640,0,2 user reviews,1,1,2
1044730,7,Positive,10,0,10
1044760,6,Mostly Positive,11,4,15
1044770,0,6 user reviews,6,0,6
1044790,0,2 user reviews,2,0,2
1044800,0,3 user reviews,3,0,3
1044830,0,1 user reviews,0,1,1
1044840,0,3 user reviews,3,0,3
1044870,0,5 user reviews,5,0,5
1044920,0,2 user reviews,1,1,2
1044930,0,1 user reviews,1,0,1
1044950,5,Mixed,5,6,11
1045010,0,7 user reviews,7,0,7
1045060,0,1 user reviews,1,0,1
1045070,0,1 user reviews,1,0,1
1045080,6,Mostly Positive,58,21,79
1045100,3,Negative,2,19,21
1045110,5,Mixed,8,4,12
1045120,7,Positive,13,0,13
1045170,6,Mostly Positive,24,8,32
1045180,6,Mostly Positive,52,17,69
1045190,5,Mixed,7,6,13
1045220,0,1 user reviews,0,1,1
1045290,0,3 user reviews,2,1,3
1045291,0,1 user reviews,0,1,1
1045300,0,3 user reviews,2,1,3
1045340,7,Positive,31,6,37
1045350,7,Positive,29,7,36
1045390,0,5 user reviews,5,0,5
1045400,0,1 user reviews,1,0,1
1045430,7,Positive,34,5,39
1045490,0,1 user reviews,1,0,1
1045510,0,7 user reviews,5,2,7
1045520,9,Overwhelmingly Positive,1633,41,1674
1045580,7,Positive,24,0,24
1045620,8,Very Positive,66,7,73
1045650,8,Very Positive,42,8,50
1045680,5,Mixed,14,10,24
1045720,8,Very Positive,117,4,121
1045740,0,4 user reviews,1,3,4
1045810,0,2 user reviews,2,0,2
1045840,7,Positive,30,7,37
1045900,0,2 user reviews,2,0,2
1045920,0,7 user reviews,4,3,7
1045930,0,3 user reviews,3,0,3
1045980,6,Mostly Positive,139,47,186
1046030,9,Overwhelmingly Positive,6309,272,6581
1046050,5,Mixed,12,8,20
1046060,0,3 user reviews,3,0,3
1046070,0,3 user reviews,2,1,3
1046130,7,Positive,10,0,10
1046140,0,1 user reviews,0,1,1
1046180,6,Mostly Positive,70,24,94
1046190,0,2 user reviews,2,0,2
1046210,0,7 user reviews,7,0,7
1046230,6,Mostly Positive,28,10,38
1046240,3,Negative,1,9,10
1046300,8,Very Positive,78,15,93
1046330,0,1 user reviews,1,0,1
1046350,0,1 user reviews,0,1,1
1046530,0,4 user reviews,3,1,4
1046560,0,2 user reviews,0,2,2
1046570,0,6 user reviews,4,2,6
1046600,0,3 user reviews,2,1,3
1046610,0,1 user reviews,1,0,1
1046630,0,5 user reviews,5,0,5
1046660,6,Mostly Positive,98,37,135
1046670,0,3 user reviews,2,1,3
1046740,0,4 user reviews,2,2,4
1046750,0,4 user reviews,3,1,4
1046770,7,Positive,16,3,19
1046800,0,1 user reviews,1,0,1
1046801,0,1 user reviews,1,0,1
1046820,7,Positive,23,5,28
1046880,0,2 user reviews,2,0,2
1046910,0,1 user reviews,1,0,1
1046980,0,5 user reviews,3,2,5
1047010,8,Very Positive,79,7,86
1047020,0,1 user reviews,0,1,1
1047110,0,6 user reviews,6,0,6
1047120,0,8 user reviews,8,0,8
1047140,0,4 user reviews,0,4,4
1047150,0,5 user reviews,5,0,5
1047160,0,2 user reviews,0,2,2
1047180,5,Mixed,46,33,79
1047220,8,Very Positive,250,5,255
1047230,0,1 user reviews,1,0,1
1047240,5,Mixed,5,5,10
1047380,6,Mostly Positive,26,11,37
1047440,8,Very Positive,324,16,340
1047580,7,Positive,14,0,14
1047670,5,Mixed,9,4,13
1047780,0,2 user reviews,1,1,2
1047800,0,3 user reviews,3,0,3
1047810,0,3 user reviews,2,1,3
1047830,5,Mixed,19,11,30
1047850,0,5 user reviews,5,0,5
1047860,0,5 user reviews,3,2,5
1047870,7,Positive,25,2,27
1047930,0,4 user reviews,4,0,4
1047940,0,1 user reviews,1,0,1
1047960,6,Mostly Positive,19,5,24
1048000,7,Positive,14,3,17
1048020,0,4 user reviews,2,2,4
1048050,0,6 user reviews,2,4,6
1048080,0,3 user reviews,2,1,3
1048090,0,5 user reviews,4,1,5
1048100,6,Mostly Positive,225,71,296
1048110,0,1 user reviews,1,0,1
1048260,0,1 user reviews,0,1,1
1048270,5,Mixed,7,4,11
1048280,0,9 user reviews,4,5,9
1048300,0,7 user reviews,7,0,7
1048380,0,1 user reviews,1,0,1
1048381,0,1 user reviews,1,0,1
1048420,0,2 user reviews,2,0,2
1048460,0,5 user reviews,3,2,5
1048540,8,Very Positive,289,22,311
1048560,7,Positive,13,1,14
1048600,6,Mostly Positive,93,24,117
1048640,4,Mostly Negative,4,10,14
1048690,0,1 user reviews,1,0,1
1048710,5,Mixed,6,4,10
1048740,8,Very Positive,54,5,59
1048870,5,Mixed,9,10,19
1048871,5,Mixed,6,7,13
1048872,5,Mixed,9,6,15
1048873,0,9 user reviews,3,6,9
1048874,4,Mostly Negative,12,20,32
1048875,0,9 user reviews,2,7,9
1048876,5,Mixed,9,5,14
1048877,0,5 user reviews,1,4,5
1048878,4,Mostly Negative,3,9,12
1048879,5,Mixed,5,5,10
1048880,0,5 user reviews,2,3,5
1048900,0,7 user reviews,5,2,7
1048920,0,2 user reviews,1,1,2
1048950,6,Mostly Positive,92,26,118
1048960,0,4 user reviews,3,1,4
1049020,8,Very Positive,147,20,167
1049030,0,1 user reviews,1,0,1
1049070,7,Positive,11,2,13
1049090,0,5 user reviews,4,1,5
1049100,7,Positive,25,2,27
1049120,0,1 user reviews,1,0,1
1049130,5,Mixed,13,8,21
1049140,0,3 user reviews,2,1,3
1049220,7,Positive,34,8,42
1049240,5,Mixed,85,50,135
1049270,0,3 user reviews,2,1,3
1049280,8,Very Positive,278,16,294
1049290,5,Mixed,37,16,53
1049310,0,2 user reviews,2,0,2
1049320,8,Very Positive,504,106,610
1049370,0,3 user reviews,2,1,3
1049430,0,3 user reviews,3,0,3
1049440,6,Mostly Positive,20,7,27
1049490,0,4 user reviews,3,1,4
1049510,0,5 user reviews,4,1,5
1049530,0,9 user reviews,8,1,9
1049560,0,4 user reviews,4,0,4
1049570,6,Mostly Positive,7,3,10
1049590,0,5 user reviews,4,1,5
1049650,0,6 user reviews,4,2,6
1049670,7,Positive,10,0,10
1049680,0,1 user reviews,0,1,1
1049690,0,4 user reviews,4,0,4
1049720,0,1 user reviews,1,0,1
1049730,0,2 user reviews,1,1,2
1049790,8,Very Positive,271,43,314
1049810,7,Positive,25,4,29
1049820,7,Positive,11,1,12
1049840,0,1 user reviews,1,0,1
1049890,9,Overwhelmingly Positive,1122,19,1141
1049900,7,Positive,15,1,16
1049910,0,2 user reviews,1,1,2
1049930,0,1 user reviews,0,1,1
1049940,5,Mixed,9,6,15
1050000,7,Positive,20,1,21
1050010,0,5 user reviews,5,0,5
1050040,0,4 user reviews,1,3,4
1050050,0,2 user reviews,0,2,2
1050080,0,1 user reviews,0,1,1
1050090,0,2 user reviews,1,1,2
1050120,0,1 user reviews,0,1,1
1050122,5,Mixed,5,5,10
1050150,5,Mixed,5,5,10
1050160,0,2 user reviews,2,0,2
1050170,0,1 user reviews,0,1,1
1050180,0,2 user reviews,1,1,2
1050210,0,4 user reviews,2,2,4
1050230,0,6 user reviews,6,0,6
1050240,0,7 user reviews,4,3,7
1050330,0,7 user reviews,5,2,7
1050340,0,7 user reviews,2,5,7
1050350,0,3 user reviews,1,2,3
1050360,0,1 user reviews,1,0,1
1050430,0,1 user reviews,1,0,1
1050440,6,Mostly Positive,15,4,19
1050450,0,5 user reviews,5,0,5
1050460,7,Positive,19,0,19
1050480,0,1 user reviews,0,1,1
1050500,0,5 user reviews,5,0,5
1050510,7,Positive,22,4,26
1050520,0,5 user reviews,5,0,5
1050540,0,4 user reviews,1,3,4
1050560,0,1 user reviews,1,0,1
1050580,0,7 user reviews,4,3,7
1050710,0,9 user reviews,8,1,9
1050712,0,5 user reviews,5,0,5
1050714,0,3 user reviews,3,0,3
1050716,0,2 user reviews,1,1,2
1050720,6,Mostly Positive,12,4,16
1050730,0,5 user reviews,5,0,5
1050780,0,3 user reviews,1,2,3
1050810,0,6 user reviews,1,5,6
1050880,7,Positive,11,1,12
1051160,0,1 user reviews,1,0,1
1051170,0,4 user reviews,3,1,4
1051190,0,1 user reviews,1,0,1
1051200,8,Very Positive,1537,143,1680
1051220,0,1 user reviews,1,0,1
1051250,4,Mostly Negative,12,21,33
1051260,0,2 user reviews,1,1,2
1051270,0,1 user reviews,0,1,1
1051290,0,6 user reviews,3,3,6
1051300,0,3 user reviews,2,1,3
1051310,7,Positive,31,4,35
1051320,0,1 user reviews,0,1,1
1051380,0,5 user reviews,5,0,5
1051410,7,Positive,29,3,32
1051420,0,3 user reviews,2,1,3
1051431,0,2 user reviews,1,1,2
1051470,0,3 user reviews,3,0,3
1051500,7,Positive,12,1,13
1051530,0,2 user reviews,2,0,2
1051570,5,Mixed,18,9,27
1051590,0,8 user reviews,5,3,8
1051620,7,Positive,32,8,40
1051621,3,Negative,1,13,14
1051630,0,2 user reviews,0,2,2
1051670,5,Mixed,16,14,30
1051690,8,Very Positive,346,12,358
1051700,7,Positive,18,1,19
1051770,0,1 user reviews,1,0,1
1051771,0,1 user reviews,1,0,1
1051781,0,4 user reviews,3,1,4
1051790,0,1 user reviews,1,0,1
1051791,0,1 user reviews,1,0,1
1051810,8,Very Positive,82,8,90
1051830,0,5 user reviews,2,3,5
1051840,7,Positive,14,0,14
1051850,5,Mixed,12,7,19
1051890,0,7 user reviews,5,2,7
1051920,0,5 user reviews,5,0,5
1051960,7,Positive,24,2,26
1051990,0,2 user reviews,2,0,2
1052010,0,2 user reviews,0,2,2
1052030,0,5 user reviews,5,0,5
1052080,0,3 user reviews,3,0,3
1052090,0,5 user reviews,4,1,5
1052100,0,2 user reviews,2,0,2
1052210,6,Mostly Positive,7,3,10
1052220,7,Positive,11,1,12
1052310,0,3 user reviews,0,3,3
1052330,0,1 user reviews,0,1,1
1052360,0,1 user reviews,0,1,1
1052370,0,6 user reviews,4,2,6
1052380,0,2 user reviews,2,0,2
1052420,0,3 user reviews,1,2,3
1052440,7,Positive,14,3,17
1052470,0,1 user reviews,0,1,1
1052480,0,2 user reviews,2,0,2
1052530,0,9 user reviews,9,0,9
1052550,0,6 user reviews,3,3,6
1052560,0,1 user reviews,0,1,1
1052580,0,3 user reviews,3,0,3
1052600,0,4 user reviews,1,3,4
1052630,0,1 user reviews,1,0,1
1052640,7,Positive,10,0,10
1052670,0,3 user reviews,3,0,3
1052690,5,Mixed,46,24,70
1052700,0,1 user reviews,1,0,1
1052730,0,1 user reviews,1,0,1
1052760,0,5 user reviews,5,0,5
1052870,0,3 user reviews,3,0,3
1052900,0,2 user reviews,1,1,2
1052960,0,2 user reviews,2,0,2
1052990,8,Very Positive,231,5,236
1053040,0,1 user reviews,1,0,1
1053060,0,1 user reviews,1,0,1
1053090,0,2 user reviews,2,0,2
1053160,0,2 user reviews,1,1,2
1053190,7,Positive,12,0,12
1053250,7,Positive,20,1,21
1053260,7,Positive,13,2,15
1053270,0,2 user reviews,2,0,2
1053330,0,2 user reviews,1,1,2
1053550,0,3 user reviews,3,0,3
1053560,0,7 user reviews,7,0,7
1053590,0,5 user reviews,0,5,5
1053620,0,6 user reviews,6,0,6
1053650,7,Positive,14,2,16
1053660,5,Mixed,7,6,13
1053680,8,Very Positive,616,61,677
1053730,0,9 user reviews,5,4,9
1053750,0,4 user reviews,3,1,4
1053780,0,8 user reviews,7,1,8
1053800,0,3 user reviews,3,0,3
1053820,0,1 user reviews,0,1,1
1053830,7,Positive,24,2,26
1053850,0,7 user reviews,3,4,7
1053870,0,1 user reviews,0,1,1
1053920,0,3 user reviews,3,0,3
1053940,0,4 user reviews,2,2,4
1053970,0,2 user reviews,1,1,2
1054030,0,5 user reviews,2,3,5
1054050,0,4 user reviews,2,2,4
1054071,7,Positive,13,3,16
1054090,0,6 user reviews,4,2,6
1054110,6,Mostly Positive,35,12,47
1054120,4,Mostly Negative,4,7,11
1054150,0,1 user reviews,1,0,1
1054180,0,2 user reviews,2,0,2
1054240,0,2 user reviews,2,0,2
1054250,0,1 user reviews,0,1,1
1054270,7,Positive,19,0,19
1054290,0,9 user reviews,3,6,9
1054310,0,5 user reviews,2,3,5
1054370,0,1 user reviews,1,0,1
1054390,7,Positive,37,7,44
1054470,0,8 user reviews,6,2,8
1054480,5,Mixed,58,41,99
1054490,8,Very Positive,462,35,497
1054510,8,Very Positive,447,64,511
1054520,0,1 user reviews,0,1,1
1054550,6,Mostly Positive,89,24,113
1054570,0,1 user reviews,0,1,1
1054610,0,1 user reviews,1,0,1
1054620,0,2 user reviews,2,0,2
1054640,0,1 user reviews,1,0,1
1054650,0,4 user reviews,2,2,4
1054660,7,Positive,36,1,37
1054670,0,1 user reviews,1,0,1
1054690,6,Mostly Positive,20,7,27
1054700,7,Positive,31,7,38
1054710,6,Mostly Positive,19,5,24
1054720,0,2 user reviews,1,1,2
1054730,0,7 user reviews,5,2,7
1054770,0,2 user reviews,1,1,2
1054790,0,5 user reviews,5,0,5
1054800,6,Mostly Positive,12,4,16
1054850,0,1 user reviews,0,1,1
1054873,0,4 user reviews,4,0,4
1054900,0,1 user reviews,0,1,1
1054930,0,4 user reviews,1,3,4
1054980,0,4 user reviews,3,1,4
1054990,0,6 user reviews,4,2,6
1055000,0,2 user reviews,0,2,2
1055010,5,Mixed,59,36,95
1055030,0,1 user reviews,1,0,1
1055090,5,Mixed,143,70,213
1055140,0,1 user reviews,1,0,1
1055150,0,3 user reviews,3,0,3
1055180,0,3 user reviews,2,1,3
1055210,0,3 user reviews,3,0,3
1055220,0,3 user reviews,3,0,3
1055280,0,1 user reviews,1,0,1
1055290,7,Positive,20,2,22
1055310,5,Mixed,6,6,12
1055331,0,3 user reviews,3,0,3
1055332,0,5 user reviews,1,4,5
1055333,6,Mostly Positive,20,8,28
1055334,0,1 user reviews,1,0,1
1055335,0,2 user reviews,1,1,2
1055336,0,2 user reviews,2,0,2
1055338,7,Positive,12,0,12
1055339,0,3 user reviews,2,1,3
1055410,0,1 user reviews,1,0,1
1055430,8,Very Positive,302,29,331
1055490,6,Mostly Positive,37,14,51
1055540,9,Overwhelmingly Positive,2772,22,2794
1055580,0,6 user reviews,6,0,6
1055590,0,5 user reviews,3,2,5
1055610,8,Very Positive,90,9,99
1055620,7,Positive,18,3,21
1055670,0,6 user reviews,4,2,6
1055680,0,2 user reviews,2,0,2
1055690,0,8 user reviews,8,0,8
1055780,0,2 user reviews,2,0,2
1055810,8,Very Positive,181,2,183
1055880,0,9 user reviews,9,0,9
1055890,0,8 user reviews,8,0,8
1055910,0,2 user reviews,2,0,2
1055930,0,1 user reviews,0,1,1
1055950,0,1 user reviews,1,0,1
1055990,8,Very Positive,159,21,180
1056010,0,1 user reviews,1,0,1
1056040,0,3 user reviews,3,0,3
1056050,4,Mostly Negative,3,7,10
1056070,0,1 user reviews,1,0,1
1056080,0,4 user reviews,0,4,4
1056170,6,Mostly Positive,17,5,22
1056180,8,Very Positive,54,9,63
1056230,0,5 user reviews,4,1,5
1056280,7,Positive,17,1,18
1056350,7,Positive,21,0,21
1056360,0,1 user reviews,1,0,1
1056390,8,Very Positive,54,7,61
1056400,0,2 user reviews,2,0,2
1056420,0,9 user reviews,3,6,9
1056470,0,9 user reviews,4,5,9
1056480,0,6 user reviews,4,2,6
1056490,7,Positive,29,2,31
1056510,6,Mostly Positive,8,3,11
1056520,0,3 user reviews,2,1,3
1056570,8,Very Positive,108,5,113
1056590,0,8 user reviews,6,2,8
1056610,7,Positive,20,2,22
1056622,0,1 user reviews,1,0,1
1056623,0,1 user reviews,0,1,1
1056640,0,1 user reviews,1,0,1
1056650,0,2 user reviews,1,1,2
1056660,0,4 user reviews,1,3,4
1056690,7,Positive,21,1,22
1056700,7,Positive,18,1,19
1056720,7,Positive,27,0,27
1056730,0,1 user reviews,1,0,1
1056750,7,Positive,21,5,26
1056760,8,Very Positive,232,37,269
1056761,8,Very Positive,55,12,67
1056780,7,Positive,14,1,15
1056870,0,3 user reviews,2,1,3
1056880,0,2 user reviews,1,1,2
1056890,0,4 user reviews,1,3,4
1056900,0,1 user reviews,1,0,1
1056940,0,3 user reviews,1,2,3
1056960,5,Mixed,1329,1418,2747
1056970,4,Mostly Negative,30,54,84
1057060,0,2 user reviews,2,0,2
1057070,0,2 user reviews,2,0,2
1057090,9,Overwhelmingly Positive,9528,347,9875
1057120,0,1 user reviews,1,0,1
1057160,0,3 user reviews,3,0,3
1057180,5,Mixed,83,52,135
1057240,5,Mixed,36,17,53
1057250,0,1 user reviews,1,0,1
1057270,7,Positive,12,2,14
1057271,7,Positive,9,1,10
1057272,0,4 user reviews,4,0,4
1057273,0,5 user reviews,5,0,5
1057274,0,1 user reviews,1,0,1
1057275,0,1 user reviews,1,0,1
1057276,0,3 user reviews,2,1,3
1057278,0,4 user reviews,3,1,4
1057279,0,3 user reviews,2,1,3
1057280,0,1 user reviews,1,0,1
1057281,0,3 user reviews,2,1,3
1057282,0,1 user reviews,1,0,1
1057283,0,3 user reviews,3,0,3
1057310,0,4 user reviews,2,2,4
1057390,0,3 user reviews,3,0,3
1057430,0,3 user reviews,3,0,3
1057490,6,Mostly Positive,15,4,19
1057500,0,4 user reviews,3,1,4
1057540,8,Very Positive,76,12,88
1057560,0,1 user reviews,1,0,1
1057640,7,Positive,34,8,42
1057680,0,3 user reviews,2,1,3
1057730,0,2 user reviews,0,2,2
1057750,5,Mixed,374,168,542
1057770,5,Mixed,5,6,11
1057780,7,Positive,26,2,28
1057810,5,Mixed,7,7,14
1057820,0,3 user reviews,1,2,3
1057980,7,Positive,12,0,12
1058020,9,Overwhelmingly Positive,1357,44,1401
1058060,6,Mostly Positive,17,6,23
1058110,5,Mixed,8,6,14
1058120,0,1 user reviews,1,0,1
1058121,0,1 user reviews,1,0,1
1058130,6,Mostly Positive,127,33,160
1058140,7,Positive,27,2,29
1058150,0,4 user reviews,1,3,4
1058180,8,Very Positive,93,2,95
1058190,5,Mixed,16,13,29
1058200,7,Positive,12,0,12
1058210,0,7 user reviews,4,3,7
1058220,0,4 user reviews,4,0,4
1058270,0,1 user reviews,1,0,1
1058300,0,9 user reviews,4,5,9
1058320,6,Mostly Positive,26,11,37
1058330,0,3 user reviews,2,1,3
1058350,7,Positive,11,1,12
1058360,4,Mostly Negative,3,7,10
1058380,6,Mostly Positive,37,12,49
1058390,0,2 user reviews,1,1,2
1058430,8,Very Positive,858,156,1014
1058450,8,Very Positive,379,54,433
1058463,0,1 user reviews,1,0,1
1058470,0,9 user reviews,9,0,9
1058490,0,7 user reviews,1,6,7
1058500,0,4 user reviews,2,2,4
1058510,0,1 user reviews,1,0,1
1058530,7,Positive,36,7,43
1058560,7,Positive,32,2,34
1058590,0,2 user reviews,2,0,2
1058630,0,2 user reviews,1,1,2
1058650,6,Mostly Positive,541,138,679
1058660,0,5 user reviews,1,4,5
1058680,0,3 user reviews,2,1,3
1058690,7,Positive,45,4,49
1058710,0,2 user reviews,2,0,2
1058740,7,Positive,22,3,25
1058750,0,2 user reviews,1,1,2
1058770,0,7 user reviews,7,0,7
1058800,7,Positive,23,5,28
1058830,9,Overwhelmingly Positive,870,21,891
1058840,0,4 user reviews,4,0,4
1058930,0,3 user reviews,2,1,3
1058940,0,1 user reviews,0,1,1
1058980,0,9 user reviews,6,3,9
1059040,7,Positive,9,2,11
1059080,0,2 user reviews,1,1,2
1059090,0,2 user reviews,2,0,2
1059150,6,Mostly Positive,9,3,12
1059160,0,7 user reviews,6,1,7
1059170,0,1 user reviews,1,0,1
1059190,0,8 user reviews,2,6,8
1059230,6,Mostly Positive,17,5,22
1059240,0,6 user reviews,3,3,6
1059280,5,Mixed,14,11,25
1059290,0,7 user reviews,5,2,7
1059291,0,4 user reviews,3,1,4
1059300,0,2 user reviews,2,0,2
1059310,0,3 user reviews,2,1,3
1059360,0,1 user reviews,1,0,1
1059370,0,3 user reviews,3,0,3
1059420,0,4 user reviews,4,0,4
1059430,6,Mostly Positive,41,11,52
1059440,0,3 user reviews,2,1,3
1059460,7,Positive,13,3,16
1059470,0,1 user reviews,1,0,1
1059500,0,2 user reviews,1,1,2
1059620,0,2 user reviews,0,2,2
1059640,0,2 user reviews,2,0,2
1059710,0,1 user reviews,1,0,1
1059760,0,1 user reviews,1,0,1
1059820,5,Mixed,24,18,42
1059830,0,2 user reviews,0,2,2
1059840,0,4 user reviews,3,1,4
1059880,8,Very Positive,55,10,65
1059890,0,9 user reviews,9,0,9
1060000,0,3 user reviews,2,1,3
1060060,0,4 user reviews,2,2,4
1060110,0,1 user reviews,0,1,1
1060170,0,5 user reviews,4,1,5
1060180,6,Mostly Positive,15,4,19
1060210,6,Mostly Positive,75,20,95
1060220,8,Very Positive,106,24,130
1060240,0,7 user reviews,7,0,7
1060300,5,Mixed,33,29,62
1060310,6,Mostly Positive,44,16,60
1060460,0,6 user reviews,5,1,6
1060470,0,3 user reviews,1,2,3
1060550,0,1 user reviews,1,0,1
1060570,0,8 user reviews,6,2,8
1060590,0,2 user reviews,2,0,2
1060600,8,Very Positive,397,3,400
1060620,0,7 user reviews,6,1,7
1060670,6,Mostly Positive,69,24,93
1060690,0,3 user reviews,1,2,3
1060770,0,3 user reviews,3,0,3
1060780,0,1 user reviews,1,0,1
1060810,0,2 user reviews,1,1,2
1060820,0,4 user reviews,3,1,4
1060840,0,1 user reviews,1,0,1
1060870,0,1 user reviews,1,0,1
1060910,0,1 user reviews,1,0,1
1060980,0,2 user reviews,2,0,2
1061010,0,4 user reviews,2,2,4
1061090,8,Very Positive,1282,108,1390
1061100,6,Mostly Positive,186,74,260
1061120,0,1 user reviews,1,0,1
1061160,0,5 user reviews,4,1,5
1061200,0,1 user reviews,1,0,1
1061220,0,1 user reviews,1,0,1
1061240,0,6 user reviews,2,4,6
1061260,0,1 user reviews,0,1,1
1061270,7,Positive,9,1,10
1061300,6,Mostly Positive,8,3,11
1061310,5,Mixed,11,5,16
1061350,5,Mixed,15,8,23
1061420,0,1 user reviews,1,0,1
1061470,7,Positive,11,1,12
1061490,5,Mixed,40,26,66
1061540,0,5 user reviews,5,0,5
1061610,7,Positive,42,0,42
1061620,0,3 user reviews,2,1,3
1061640,5,Mixed,10,12,22
1061650,0,4 user reviews,1,3,4
1061690,0,2 user reviews,2,0,2
1061700,0,4 user reviews,3,1,4
1061730,5,Mixed,71,62,133
1061740,0,4 user reviews,3,1,4
1061757,0,1 user reviews,0,1,1
1061820,5,Mixed,9,10,19
1061850,0,2 user reviews,2,0,2
1061900,0,5 user reviews,3,2,5
1061920,7,Positive,19,2,21
1061930,2,Very Negative,11,65,76
1062020,0,4 user reviews,2,2,4
1062040,8,Very Positive,67,15,82
1062060,7,Positive,13,2,15
1062080,0,3 user reviews,3,0,3
1062120,0,1 user reviews,1,0,1
1062160,9,Overwhelmingly Positive,1116,32,1148
1062200,0,1 user reviews,0,1,1
1062220,7,Positive,9,2,11
1062300,0,1 user reviews,1,0,1
1062340,8,Very Positive,53,13,66
1062420,0,5 user reviews,5,0,5
1062470,0,1 user reviews,0,1,1
1062480,0,3 user reviews,2,1,3
1062540,0,3 user reviews,2,1,3
1062590,5,Mixed,41,38,79
1062660,0,2 user reviews,1,1,2
1062670,0,1 user reviews,1,0,1
1062680,0,1 user reviews,1,0,1
1062830,8,Very Positive,140,5,145
1062960,6,Mostly Positive,164,70,234
1063040,6,Mostly Positive,10,4,14
1063050,5,Mixed,7,4,11
1063060,0,2 user reviews,2,0,2
1063070,0,2 user reviews,2,0,2
1063080,0,6 user reviews,6,0,6
1063110,0,5 user reviews,5,0,5
1063120,7,Positive,10,0,10
1063130,7,Positive,26,6,32
1063220,0,1 user reviews,1,0,1
1063230,0,6 user reviews,1,5,6
1063240,5,Mixed,9,4,13
1063270,0,1 user reviews,1,0,1
1063280,0,2 user reviews,0,2,2
1063300,0,2 user reviews,2,0,2
1063310,8,Very Positive,46,11,57
1063350,0,3 user reviews,3,0,3
1063360,0,1 user reviews,1,0,1
1063380,5,Mixed,6,4,10
1063430,0,2 user reviews,1,1,2
1063440,4,Mostly Negative,5,14,19
1063450,4,Mostly Negative,10,21,31
1063470,0,4 user reviews,2,2,4
1063490,8,Very Positive,161,23,184
1063500,0,1 user reviews,0,1,1
1063520,0,3 user reviews,2,1,3
1063560,5,Mixed,7,6,13
1063580,8,Very Positive,72,10,82
1063710,0,2 user reviews,2,0,2
1063790,8,Very Positive,69,13,82
1063800,0,2 user reviews,1,1,2
1063830,7,Positive,20,3,23
1063850,0,8 user reviews,6,2,8
1063860,0,9 user reviews,7,2,9
1063870,0,2 user reviews,2,0,2
1063890,6,Mostly Positive,19,8,27
1063930,5,Mixed,9,12,21
1063960,0,4 user reviews,4,0,4
1064010,7,Positive,19,3,22
1064050,0,2 user reviews,2,0,2
1064060,5,Mixed,16,13,29
1064080,0,9 user reviews,8,1,9
1064090,7,Positive,8,2,10
1064130,7,Positive,21,1,22
1064160,5,Mixed,19,12,31
1064191,0,1 user reviews,0,1,1
1064200,7,Positive,18,1,19
1064220,6,Mostly Positive,2356,757,3113
1064221,5,Mixed,580,275,855
1064270,6,Mostly Positive,506,184,690
1064271,8,Very Positive,1068,134,1202
1064272,8,Very Positive,274,41,315
1064310,5,Mixed,20,10,30
1064320,0,8 user reviews,8,0,8
1064440,0,1 user reviews,1,0,1
1064450,0,1 user reviews,1,0,1
1064460,8,Very Positive,161,13,174
1064480,0,1 user reviews,1,0,1
1064540,0,6 user reviews,5,1,6
1064580,0,9 user reviews,9,0,9
1064590,0,9 user reviews,9,0,9
1064610,8,Very Positive,59,1,60
1064620,0,1 user reviews,1,0,1
1064650,0,2 user reviews,1,1,2
1064660,6,Mostly Positive,59,17,76
1064690,7,Positive,20,0,20
1064710,0,1 user reviews,1,0,1
1064720,0,3 user reviews,3,0,3
1064730,8,Very Positive,160,30,190
1064800,0,8 user reviews,6,2,8
1064810,0,1 user reviews,1,0,1
1064820,5,Mixed,9,4,13
1064840,6,Mostly Positive,19,6,25
1064860,0,7 user reviews,3,4,7
1064900,0,8 user reviews,8,0,8
1064910,0,5 user reviews,5,0,5
1064970,0,7 user reviews,6,1,7
1064990,0,4 user reviews,1,3,4
1065020,8,Very Positive,102,5,107
1065100,8,Very Positive,234,8,242
1065140,0,3 user reviews,3,0,3
1065160,0,3 user reviews,1,2,3
1065180,7,Positive,41,3,44
1065200,0,1 user reviews,1,0,1
1065210,5,Mixed,5,7,12
1065220,0,3 user reviews,3,0,3
1065221,0,1 user reviews,0,1,1
1065230,0,2 user reviews,2,0,2
1065250,0,1 user reviews,1,0,1
1065260,8,Very Positive,73,7,80
1065380,5,Mixed,23,12,35
1065410,0,5 user reviews,5,0,5
1065460,7,Positive,13,0,13
1065490,6,Mostly Positive,12,4,16
1065491,5,Mixed,9,4,13
1065570,5,Mixed,11,8,19
1065580,5,Mixed,19,9,28
1065710,7,Positive,41,3,44
1065730,0,4 user reviews,4,0,4
1065770,0,1 user reviews,0,1,1
1065810,0,1 user reviews,1,0,1
1065830,0,4 user reviews,2,2,4
1065850,7,Positive,17,0,17
1065870,0,1 user reviews,1,0,1
1065880,8,Very Positive,68,0,68
1065890,0,4 user reviews,3,1,4
1065920,0,1 user reviews,1,0,1
1065940,5,Mixed,9,7,16
1065950,0,9 user reviews,6,3,9
1065960,0,3 user reviews,2,1,3
1065970,8,Very Positive,170,30,200
1066010,0,2 user reviews,2,0,2
1066030,0,5 user reviews,5,0,5
1066040,7,Positive,13,0,13
1066090,0,2 user reviews,2,0,2
1066110,0,8 user reviews,5,3,8
1066130,0,9 user reviews,4,5,9
1066140,6,Mostly Positive,30,10,40
1066150,0,7 user reviews,4,3,7
1066160,0,6 user reviews,3,3,6
1066180,8,Very Positive,63,11,74
1066190,5,Mixed,22,16,38
1066210,0,4 user reviews,2,2,4
1066220,0,6 user reviews,3,3,6
1066240,7,Positive,12,3,15
1066260,8,Very Positive,574,43,617
1066280,0,1 user reviews,1,0,1
1066290,0,1 user reviews,1,0,1
1066300,7,Positive,16,0,16
1066320,0,1 user reviews,1,0,1
1066430,0,6 user reviews,6,0,6
1066440,0,1 user reviews,0,1,1
1066600,5,Mixed,7,8,15
1066630,7,Positive,12,1,13
1066670,0,5 user reviews,4,1,5
1066700,0,1 user reviews,1,0,1
1066730,0,1 user reviews,0,1,1
1066780,8,Very Positive,2513,462,2975
1066810,0,7 user reviews,7,0,7
1066830,0,1 user reviews,1,0,1
1066840,0,1 user reviews,0,1,1
1066860,0,2 user reviews,1,1,2
1066890,8,Very Positive,692,119,811
1066920,0,1 user reviews,0,1,1
1066940,7,Positive,14,1,15
1066950,0,6 user reviews,6,0,6
1067010,0,2 user reviews,2,0,2
1067020,8,Very Positive,64,4,68
1067040,0,1 user reviews,0,1,1
1067050,0,1 user reviews,1,0,1
1067060,0,2 user reviews,1,1,2
1067080,0,6 user reviews,6,0,6
1067100,0,1 user reviews,1,0,1
1067150,0,4 user reviews,4,0,4
1067250,0,1 user reviews,0,1,1
1067340,0,1 user reviews,1,0,1
1067350,7,Positive,26,1,27
1067370,0,1 user reviews,1,0,1
1067390,0,4 user reviews,4,0,4
1067400,0,8 user reviews,7,1,8
1067430,7,Positive,11,1,12
1067440,0,1 user reviews,1,0,1
1067450,0,2 user reviews,1,1,2
1067460,0,2 user reviews,0,2,2
1067476,0,1 user reviews,1,0,1
1067520,0,2 user reviews,1,1,2
1067540,8,Very Positive,127,5,132
1067560,0,5 user reviews,1,4,5
1067580,6,Mostly Positive,10,3,13
1067590,6,Mostly Positive,17,5,22
1067630,0,5 user reviews,4,1,5
1067650,0,4 user reviews,2,2,4
1067690,8,Very Positive,175,7,182
1067720,7,Positive,32,2,34
1067730,0,1 user reviews,0,1,1
1067750,7,Positive,19,0,19
1067770,0,8 user reviews,8,0,8
1067810,0,4 user reviews,3,1,4
1067830,0,1 user reviews,1,0,1
1067850,9,Overwhelmingly Positive,905,29,934
1067860,8,Very Positive,97,16,113
1068100,0,1 user reviews,0,1,1
1068110,0,1 user reviews,1,0,1
1068130,0,1 user reviews,0,1,1
1068150,5,Mixed,33,34,67
1068210,0,5 user reviews,3,2,5
1068230,0,2 user reviews,0,2,2
1068260,6,Mostly Positive,12,4,16
1068290,8,Very Positive,121,0,121
1068340,0,2 user reviews,1,1,2
1068400,0,8 user reviews,8,0,8
1068480,0,8 user reviews,7,1,8
1068490,0,2 user reviews,1,1,2
1068530,5,Mixed,21,23,44
1068540,0,1 user reviews,1,0,1
1068600,0,7 user reviews,5,2,7
1068640,6,Mostly Positive,106,42,148
1068680,0,5 user reviews,5,0,5
1068700,0,3 user reviews,2,1,3
1068710,0,1 user reviews,1,0,1
1068770,0,2 user reviews,1,1,2
1068800,0,5 user reviews,4,1,5
1068810,0,1 user reviews,1,0,1
1068820,8,Very Positive,502,42,544
1068910,0,2 user reviews,2,0,2
1068990,0,2 user reviews,2,0,2
1069030,8,Very Positive,112,8,120
1069050,5,Mixed,9,6,15
1069140,0,8 user reviews,7,1,8
1069210,7,Positive,22,5,27
1069230,0,7 user reviews,7,0,7
1069250,0,3 user reviews,1,2,3
1069270,7,Positive,9,1,10
1069390,7,Positive,39,7,46
1069430,0,1 user reviews,0,1,1
1069450,0,1 user reviews,1,0,1
1069460,0,5 user reviews,4,1,5
1069470,0,9 user reviews,7,2,9
1069480,7,Positive,10,1,11
1069490,0,3 user reviews,3,0,3
1069500,0,1 user reviews,0,1,1
1069540,0,4 user reviews,2,2,4
1069580,5,Mixed,42,26,68
1069581,0,1 user reviews,1,0,1
1069600,0,3 user reviews,2,1,3
1069610,0,7 user reviews,6,1,7
1069640,6,Mostly Positive,619,198,817
1069650,6,Mostly Positive,255,89,344
1069730,0,5 user reviews,4,1,5
1069740,8,Very Positive,318,29,347
1069750,0,7 user reviews,7,0,7
1069760,8,Very Positive,213,12,225
1069820,0,9 user reviews,6,3,9
1069840,0,1 user reviews,1,0,1
1069850,7,Positive,17,2,19
1069900,5,Mixed,6,8,14
1069910,5,Mixed,8,5,13
1069920,0,1 user reviews,1,0,1
1069970,0,3 user reviews,3,0,3
1069990,0,4 user reviews,4,0,4
1070030,0,1 user reviews,1,0,1
1070052,0,1 user reviews,1,0,1
1070053,0,1 user reviews,1,0,1
1070110,0,4 user reviews,4,0,4
1070121,0,1 user reviews,1,0,1
1070150,8,Very Positive,63,3,66
1070160,0,1 user reviews,1,0,1
1070190,6,Mostly Positive,14,6,20
1070220,0,8 user reviews,6,2,8
1070230,0,4 user reviews,3,1,4
1070240,0,6 user reviews,1,5,6
1070250,0,9 user reviews,9,0,9
1070280,0,5 user reviews,2,3,5
1070300,0,3 user reviews,2,1,3
1070320,0,8 user reviews,6,2,8
1070330,8,Very Positive,528,44,572
1070350,0,2 user reviews,2,0,2
1070410,7,Positive,11,2,13
1070440,0,4 user reviews,4,0,4
1070450,0,1 user reviews,0,1,1
1070460,0,1 user reviews,1,0,1
1070510,7,Positive,15,0,15
1070550,8,Very Positive,60,0,60
1070580,8,Very Positive,869,76,945
1070600,0,1 user reviews,1,0,1
1070601,0,1 user reviews,1,0,1
1070602,0,2 user reviews,2,0,2
1070603,0,1 user reviews,1,0,1
1070690,6,Mostly Positive,21,8,29
1070710,9,Overwhelmingly Positive,3298,45,3343
1070770,0,2 user reviews,1,1,2
1070780,7,Positive,33,2,35
1070820,6,Mostly Positive,60,20,80
1070860,8,Very Positive,87,13,100
1070890,0,4 user reviews,3,1,4
1070940,6,Mostly Positive,58,18,76
1070960,0,1 user reviews,0,1,1
1070980,0,1 user reviews,1,0,1
1070990,0,3 user reviews,3,0,3
1071030,0,1 user reviews,0,1,1
1071060,0,5 user reviews,4,1,5
1071100,8,Very Positive,90,7,97
1071130,8,Very Positive,163,2,165
1071170,0,3 user reviews,2,1,3
1071190,7,Positive,12,0,12
1071200,5,Mixed,77,39,116
1071210,0,1 user reviews,1,0,1
1071260,0,5 user reviews,5,0,5
1071280,7,Positive,19,0,19
1071290,8,Very Positive,131,29,160
1071330,7,Positive,40,4,44
1071350,0,4 user reviews,3,1,4
1071373,0,2 user reviews,2,0,2
1071377,0,1 user reviews,1,0,1
1071379,0,1 user reviews,1,0,1
1071391,0,1 user reviews,1,0,1
1071392,0,1 user reviews,0,1,1
1071460,0,3 user reviews,3,0,3
1071490,0,8 user reviews,6,2,8
1071500,0,2 user reviews,1,1,2
1071510,7,Positive,28,3,31
1071580,0,1 user reviews,1,0,1
1071660,7,Positive,10,0,10
1071670,0,5 user reviews,1,4,5
1071680,8,Very Positive,51,10,61
1071760,0,1 user reviews,1,0,1
1071770,0,6 user reviews,4,2,6
1071810,0,7 user reviews,4,3,7
1071860,0,2 user reviews,2,0,2
1071870,8,Very Positive,349,30,379
1071920,0,3 user reviews,3,0,3
1071940,5,Mixed,24,15,39
1071970,0,1 user reviews,1,0,1
1072020,7,Positive,11,1,12
1072030,0,1 user reviews,1,0,1
1072040,6,Mostly Positive,545,145,690
1072050,0,1 user reviews,0,1,1
1072100,6,Mostly Positive,44,12,56
1072120,8,Very Positive,58,6,64
1072150,8,Very Positive,491,30,521
1072180,0,2 user reviews,2,0,2
1072270,6,Mostly Positive,8,3,11
1072280,0,2 user reviews,2,0,2
1072310,0,7 user reviews,5,2,7
1072350,0,5 user reviews,5,0,5
1072420,8,Very Positive,621,56,677
1072450,0,6 user reviews,4,2,6
1072480,5,Mixed,93,66,159
1072500,5,Mixed,91,42,133
1072561,7,Positive,12,0,12
1072562,8,Very Positive,152,17,169
1072590,7,Positive,13,2,15
1072610,7,Positive,11,1,12
1072620,5,Mixed,6,7,13
1072640,8,Very Positive,55,1,56
1072660,0,6 user reviews,0,6,6
1072680,0,4 user reviews,4,0,4
1072681,0,2 user reviews,2,0,2
1072710,8,Very Positive,108,5,113
1072720,0,1 user reviews,1,0,1
1072760,0,2 user reviews,2,0,2
1072800,0,6 user reviews,6,0,6
1072850,0,1 user reviews,0,1,1
1072860,7,Positive,13,1,14
1072870,0,7 user reviews,7,0,7
1072920,0,5 user reviews,2,3,5
1072950,6,Mostly Positive,10,3,13
1073040,0,1 user reviews,0,1,1
1073050,0,2 user reviews,1,1,2
1073080,0,2 user reviews,1,1,2
1073100,0,4 user reviews,4,0,4
1073130,0,1 user reviews,0,1,1
1073140,0,2 user reviews,1,1,2
1073210,5,Mixed,6,7,13
1073220,7,Positive,39,3,42
1073230,0,3 user reviews,2,1,3
1073280,0,8 user reviews,6,2,8
1073310,7,Positive,18,1,19
1073320,8,Very Positive,176,3,179
1073370,0,3 user reviews,2,1,3
1073410,0,9 user reviews,6,3,9
1073440,9,Overwhelmingly Positive,1290,66,1356
1073490,7,Positive,14,3,17
1073610,0,4 user reviews,4,0,4
1073630,0,2 user reviews,2,0,2
1073660,0,1 user reviews,1,0,1
1073710,0,1 user reviews,1,0,1
1073720,0,4 user reviews,3,1,4
1073770,7,Positive,14,2,16
1073810,7,Positive,26,0,26
1073820,8,Very Positive,79,9,88
1073840,7,Positive,34,3,37
1073870,7,Positive,19,1,20
1073900,7,Positive,29,1,30
1073960,0,1 user reviews,0,1,1
1074070,0,8 user reviews,5,3,8
1074080,8,Very Positive,98,16,114
1074150,0,2 user reviews,1,1,2
1074170,7,Positive,10,1,11
1074180,5,Mixed,30,13,43
1074202,0,1 user reviews,1,0,1
1074210,0,1 user reviews,1,0,1
1074211,0,2 user reviews,2,0,2
1074220,0,9 user reviews,8,1,9
1074260,0,6 user reviews,6,0,6
1074265,0,1 user reviews,0,1,1
1074270,0,8 user reviews,6,2,8
1074276,0,1 user reviews,0,1,1
1074300,0,8 user reviews,8,0,8
1074310,0,8 user reviews,8,0,8
1074320,6,Mostly Positive,455,149,604
1074330,0,3 user reviews,3,0,3
1074340,0,2 user reviews,2,0,2
1074370,0,5 user reviews,2,3,5
1074420,5,Mixed,38,20,58
1074500,0,1 user reviews,1,0,1
1074510,5,Mixed,10,6,16
1074520,7,Positive,18,1,19
1074530,0,2 user reviews,0,2,2
1074550,6,Mostly Positive,8,3,11
1074610,5,Mixed,22,10,32
1074620,8,Very Positive,57,12,69
1074630,6,Mostly Positive,48,18,66
1074640,0,6 user reviews,6,0,6
1074650,7,Positive,15,1,16
1074660,0,3 user reviews,1,2,3
1074700,0,5 user reviews,5,0,5
1074770,6,Mostly Positive,16,5,21
1074840,0,6 user reviews,2,4,6
1074870,0,1 user reviews,0,1,1
1074880,0,2 user reviews,2,0,2
1074900,0,3 user reviews,2,1,3
1074910,0,1 user reviews,1,0,1
1074920,0,1 user reviews,1,0,1
1074930,0,1 user reviews,1,0,1
1074980,0,7 user reviews,6,1,7
1075040,7,Positive,13,1,14
1075041,7,Positive,11,0,11
1075050,0,1 user reviews,1,0,1
1075080,6,Mostly Positive,30,12,42
1075101,0,1 user reviews,0,1,1
1075102,0,1 user reviews,0,1,1
1075103,0,1 user reviews,1,0,1
1075104,0,1 user reviews,0,1,1
1075190,6,Mostly Positive,286,82,368
1075370,0,4 user reviews,3,1,4
1075390,6,Mostly Positive,12,5,17
1075400,5,Mixed,69,39,108
1075480,0,1 user reviews,1,0,1
1075550,6,Mostly Positive,14,5,19
1075740,6,Mostly Positive,139,39,178
1075750,0,6 user reviews,5,1,6
1075770,0,1 user reviews,1,0,1
1075790,0,4 user reviews,1,3,4
1075850,0,1 user reviews,1,0,1
1075860,0,1 user reviews,1,0,1
1075980,8,Very Positive,75,6,81
1075990,0,1 user reviews,1,0,1
1075993,7,Positive,10,0,10
1076011,0,2 user reviews,1,1,2
1076012,0,2 user reviews,1,1,2
1076014,0,4 user reviews,3,1,4
1076015,7,Positive,10,0,10
1076040,0,1 user reviews,1,0,1
1076080,8,Very Positive,74,3,77
1076100,0,1 user reviews,0,1,1
1076110,0,1 user reviews,1,0,1
1076140,0,3 user reviews,2,1,3
1076150,6,Mostly Positive,19,6,25
1076160,8,Very Positive,230,52,282
1076210,8,Very Positive,47,11,58
1076230,7,Positive,37,9,46
1076290,0,7 user reviews,3,4,7
1076410,0,4 user reviews,0,4,4
1076450,0,1 user reviews,1,0,1
1076480,0,8 user reviews,8,0,8
1076530,0,2 user reviews,2,0,2
1076550,8,Very Positive,157,11,168
1076630,0,9 user reviews,6,3,9
1076640,5,Mixed,35,26,61
1076770,0,3 user reviews,3,0,3
1076780,0,2 user reviews,1,1,2
1076830,0,1 user reviews,1,0,1
1076850,6,Mostly Positive,34,9,43
1076880,8,Very Positive,127,6,133
1076920,5,Mixed,76,54,130
1076950,0,1 user reviews,0,1,1
1077090,0,4 user reviews,3,1,4
1077110,0,1 user reviews,1,0,1
1077170,0,1 user reviews,1,0,1
1077200,0,4 user reviews,3,1,4
1077210,0,5 user reviews,3,2,5
1077250,0,1 user reviews,1,0,1
1077290,8,Very Positive,143,12,155
1077320,0,3 user reviews,1,2,3
1077340,7,Positive,9,2,11
1077410,6,Mostly Positive,21,6,27
1077420,0,8 user reviews,8,0,8
1077430,8,Very Positive,85,15,100
1077450,7,Positive,39,0,39
1077470,0,4 user reviews,3,1,4
1077490,0,5 user reviews,4,1,5
1077520,8,Very Positive,71,14,85
1077530,8,Very Positive,70,14,84
1077550,4,Mostly Negative,5,9,14
1077570,0,1 user reviews,0,1,1
1077580,5,Mixed,25,19,44
1077600,7,Positive,23,1,24
1077610,0,2 user reviews,2,0,2
1077630,5,Mixed,12,8,20
1077690,6,Mostly Positive,46,15,61
1077760,0,1 user reviews,1,0,1
1077890,6,Mostly Positive,12,4,16
1077970,7,Positive,29,6,35
1077980,0,1 user reviews,1,0,1
1077990,0,6 user reviews,2,4,6
1078000,7,Positive,14,3,17
1078020,0,1 user reviews,1,0,1
1078040,0,2 user reviews,2,0,2
1078060,0,2 user reviews,1,1,2
1078150,0,1 user reviews,1,0,1
1078200,8,Very Positive,132,3,135
1078280,7,Positive,43,3,46
1078330,6,Mostly Positive,25,8,33
1078380,0,9 user reviews,6,3,9
1078450,0,1 user reviews,1,0,1
1078490,0,8 user reviews,5,3,8
1078510,8,Very Positive,97,9,106
1078520,0,8 user reviews,5,3,8
1078550,7,Positive,15,0,15
1078560,5,Mixed,10,10,20
1078640,5,Mixed,8,6,14
1078670,0,2 user reviews,1,1,2
1078750,0,4 user reviews,3,1,4
1078780,0,2 user reviews,1,1,2
1078810,0,3 user reviews,2,1,3
1078820,0,1 user reviews,1,0,1
1078840,0,7 user reviews,6,1,7
1078870,0,6 user reviews,5,1,6
1078920,8,Very Positive,89,4,93
1078930,0,2 user reviews,2,0,2
1079000,8,Very Positive,103,8,111
1079100,0,3 user reviews,1,2,3
1079110,0,4 user reviews,4,0,4
1079130,6,Mostly Positive,23,6,29
1079160,8,Very Positive,122,3,125
1079180,8,Very Positive,81,1,82
1079200,6,Mostly Positive,11,4,15
1079210,8,Very Positive,128,18,146
1079310,0,9 user reviews,8,1,9
1079320,7,Positive,18,3,21
1079330,0,1 user reviews,0,1,1
1079360,0,2 user reviews,2,0,2
1079420,0,1 user reviews,0,1,1
1079440,0,2 user reviews,1,1,2
1079450,8,Very Positive,53,0,53
1079460,0,4 user reviews,3,1,4
1079470,0,1 user reviews,1,0,1
1079520,0,5 user reviews,3,2,5
1079560,0,5 user reviews,5,0,5
1079600,0,2 user reviews,1,1,2
1079610,0,3 user reviews,3,0,3
1079620,8,Very Positive,220,44,264
1079630,6,Mostly Positive,11,3,14
1079710,0,3 user reviews,3,0,3
1079720,0,1 user reviews,1,0,1
1079730,0,2 user reviews,2,0,2
1079790,5,Mixed,9,9,18
1079800,8,Very Positive,1130,104,1234
1079910,0,1 user reviews,1,0,1
1079940,0,3 user reviews,1,2,3
1079970,0,3 user reviews,3,0,3
1079990,0,1 user reviews,1,0,1
1080001,0,1 user reviews,1,0,1
1080010,7,Positive,11,0,11
1080110,8,Very Positive,2994,225,3219
1080130,0,9 user reviews,6,3,9
1080240,0,1 user reviews,1,0,1
1080250,7,Positive,15,2,17
1080280,0,1 user reviews,1,0,1
1080320,0,2 user reviews,2,0,2
1080330,7,Positive,14,0,14
1080360,0,1 user reviews,0,1,1
1080370,0,2 user reviews,1,1,2
1080410,7,Positive,14,2,16
1080440,0,6 user reviews,0,6,6
1080470,0,1 user reviews,0,1,1
1080550,7,Positive,25,1,26
1080630,0,2 user reviews,1,1,2
1080750,8,Very Positive,174,4,178
1080770,7,Positive,23,3,26
1080780,0,9 user reviews,7,2,9
1080790,7,Positive,15,0,15
1080900,0,2 user reviews,2,0,2
1080950,0,1 user reviews,1,0,1
1081000,0,8 user reviews,5,3,8
1081020,0,1 user reviews,1,0,1
1081040,6,Mostly Positive,16,5,21
1081070,0,2 user reviews,2,0,2
1081090,0,5 user reviews,4,1,5
1081100,7,Positive,12,0,12
1081110,0,1 user reviews,0,1,1
1081120,7,Positive,18,1,19
1081140,0,2 user reviews,0,2,2
1081170,0,1 user reviews,1,0,1
1081190,0,1 user reviews,1,0,1
1081200,0,1 user reviews,1,0,1
1081240,0,1 user reviews,0,1,1
1081250,0,6 user reviews,4,2,6
1081260,0,2 user reviews,2,0,2
1081320,0,1 user reviews,1,0,1
1081370,0,1 user reviews,1,0,1
1081410,0,3 user reviews,2,1,3
1081430,0,1 user reviews,1,0,1
1081510,8,Very Positive,189,37,226
1081550,0,6 user reviews,6,0,6
1081560,6,Mostly Positive,60,23,83
1081600,0,1 user reviews,0,1,1
1081610,6,Mostly Positive,86,28,114
1081630,0,2 user reviews,2,0,2
1081650,8,Very Positive,55,6,61
1081670,0,1 user reviews,0,1,1
1081710,0,6 user reviews,4,2,6
1081720,0,1 user reviews,0,1,1
1081760,0,8 user reviews,4,4,8
1081780,7,Positive,8,2,10
1081840,0,7 user reviews,7,0,7
1081850,0,8 user reviews,8,0,8
1081870,7,Positive,13,0,13
1081890,7,Positive,11,1,12
1081900,0,3 user reviews,1,2,3
1081910,0,1 user reviews,0,1,1
1081920,0,1 user reviews,1,0,1
1081990,0,2 user reviews,2,0,2
1082000,7,Positive,11,0,11
1082110,7,Positive,10,1,11
1082161,0,1 user reviews,1,0,1
1082180,6,Mostly Positive,96,37,133
1082220,0,4 user reviews,4,0,4
1082250,7,Positive,20,1,21
1082350,6,Mostly Positive,22,7,29
1082351,0,3 user reviews,3,0,3
1082352,5,Mixed,11,5,16
1082353,8,Very Positive,160,28,188
1082370,0,3 user reviews,2,1,3
1082440,7,Positive,15,0,15
1082460,0,5 user reviews,5,0,5
1082470,0,7 user reviews,7,0,7
1082480,0,1 user reviews,1,0,1
1082490,0,1 user reviews,0,1,1
1082500,0,2 user reviews,2,0,2
1082550,0,1 user reviews,1,0,1
1082571,0,1 user reviews,0,1,1
1082572,0,1 user reviews,0,1,1
1082573,0,1 user reviews,0,1,1
1082574,0,2 user reviews,0,2,2
1082575,0,1 user reviews,0,1,1
1082576,0,2 user reviews,0,2,2
1082577,0,1 user reviews,0,1,1
1082578,0,1 user reviews,0,1,1
1082579,0,3 user reviews,2,1,3
1082580,0,4 user reviews,3,1,4
1082581,0,3 user reviews,2,1,3
1082582,0,2 user reviews,1,1,2
1082610,0,1 user reviews,1,0,1
1082650,0,1 user reviews,1,0,1
1082680,4,Mostly Negative,155,292,447
1082710,9,Overwhelmingly Positive,1228,18,1246
1082720,6,Mostly Positive,10,4,14
1082770,0,8 user reviews,4,4,8
1082860,0,2 user reviews,2,0,2
1082920,8,Very Positive,74,0,74
1082930,7,Positive,12,3,15
1082940,0,5 user reviews,3,2,5
1083090,0,3 user reviews,3,0,3
1083100,0,3 user reviews,1,2,3
1083190,8,Very Positive,55,3,58
1083210,5,Mixed,35,17,52
1083240,0,6 user reviews,6,0,6
1083260,0,2 user reviews,0,2,2
1083270,0,1 user reviews,1,0,1
1083280,0,1 user reviews,1,0,1
1083281,0,1 user reviews,1,0,1
1083282,7,Positive,16,2,18
1083283,0,4 user reviews,3,1,4
1083290,0,7 user reviews,2,5,7
1083310,6,Mostly Positive,37,10,47
1083350,0,1 user reviews,1,0,1
1083410,0,1 user reviews,0,1,1
1083420,7,Positive,17,4,21
1083430,0,1 user reviews,0,1,1
1083450,0,2 user reviews,2,0,2
1083460,0,3 user reviews,3,0,3
1083490,0,4 user reviews,2,2,4
1083590,0,2 user reviews,1,1,2
1083650,5,Mixed,38,17,55
1083670,0,9 user reviews,8,1,9
1083700,0,2 user reviews,2,0,2
1083750,0,1 user reviews,1,0,1
1083760,7,Positive,44,3,47
1083800,0,1 user reviews,1,0,1
1083810,7,Positive,21,2,23
1083820,7,Positive,17,4,21
1083850,5,Mixed,8,11,19
1083880,8,Very Positive,558,57,615
1083890,6,Mostly Positive,14,4,18
1083900,0,2 user reviews,2,0,2
1083910,0,6 user reviews,6,0,6
1083970,0,2 user reviews,0,2,2
1083990,0,3 user reviews,2,1,3
1084010,0,1 user reviews,0,1,1
1084020,8,Very Positive,175,26,201
1084060,0,4 user reviews,2,2,4
1084070,0,4 user reviews,4,0,4
1084071,0,1 user reviews,1,0,1
1084072,0,2 user reviews,1,1,2
1084073,0,4 user reviews,3,1,4
1084080,7,Positive,28,7,35
1084090,0,1 user reviews,1,0,1
1084100,4,Mostly Negative,7,14,21
1084110,5,Mixed,11,8,19
1084210,0,7 user reviews,7,0,7
1084220,7,Positive,15,0,15
1084350,7,Positive,11,2,13
1084400,6,Mostly Positive,311,87,398
1084420,0,1 user reviews,1,0,1
1084430,0,6 user reviews,5,1,6
1084460,0,1 user reviews,1,0,1
1084470,0,3 user reviews,1,2,3
1084480,7,Positive,16,3,19
1084530,0,1 user reviews,1,0,1
1084680,6,Mostly Positive,87,34,121
1084710,0,6 user reviews,5,1,6
1084770,0,2 user reviews,2,0,2
1084790,7,Positive,28,6,34
1084810,0,1 user reviews,1,0,1
1084820,7,Positive,25,2,27
1084840,0,5 user reviews,5,0,5
1084860,0,1 user reviews,1,0,1
1084870,5,Mixed,13,8,21
1084880,0,1 user reviews,1,0,1
1084910,0,1 user reviews,1,0,1
1084920,0,4 user reviews,4,0,4
1084930,0,9 user reviews,8,1,9
1084970,0,6 user reviews,5,1,6
1084990,6,Mostly Positive,41,13,54
1085010,0,4 user reviews,4,0,4
1085110,0,7 user reviews,2,5,7
1085150,0,1 user reviews,0,1,1
1085160,8,Very Positive,76,13,89
1085180,8,Very Positive,100,8,108
1085190,5,Mixed,9,4,13
1085240,0,4 user reviews,3,1,4
1085260,0,9 user reviews,9,0,9
1085270,5,Mixed,12,7,19
1085310,4,Mostly Negative,4,10,14
1085340,0,3 user reviews,2,1,3
1085390,0,2 user reviews,1,1,2
1085510,8,Very Positive,663,83,746
1085520,0,8 user reviews,5,3,8
1085560,7,Positive,26,2,28
1085610,0,8 user reviews,5,3,8
1085630,7,Positive,18,4,22
1085640,6,Mostly Positive,12,4,16
1085660,8,Very Positive,40563,4012,44575
1085730,0,1 user reviews,0,1,1
1085750,5,Mixed,86,41,127
1085820,0,2 user reviews,1,1,2
1085900,0,1 user reviews,1,0,1
1085930,0,3 user reviews,3,0,3
1085940,0,2 user reviews,0,2,2
1085950,0,1 user reviews,1,0,1
1085990,0,3 user reviews,3,0,3
1086010,8,Very Positive,221,40,261
1086030,7,Positive,13,3,16
1086060,0,1 user reviews,1,0,1
1086070,0,2 user reviews,2,0,2
1086140,0,1 user reviews,1,0,1
1086160,7,Positive,18,1,19
1086180,0,3 user reviews,2,1,3
1086250,0,1 user reviews,0,1,1
1086270,0,1 user reviews,1,0,1
1086310,0,9 user reviews,2,7,9
1086320,0,2 user reviews,0,2,2
1086410,8,Very Positive,56,3,59
1086450,7,Positive,13,0,13
1086460,0,1 user reviews,1,0,1
1086480,5,Mixed,68,60,128
1086481,6,Mostly Positive,53,21,74
1086490,0,3 user reviews,1,2,3
1086600,0,1 user reviews,0,1,1
1086640,5,Mixed,153,92,245
1086670,0,1 user reviews,1,0,1
1086680,0,1 user reviews,0,1,1
1086690,0,1 user reviews,0,1,1
1086730,0,1 user reviews,1,0,1
1086750,7,Positive,16,2,18
1086760,7,Positive,12,3,15
1086810,0,5 user reviews,4,1,5
1086820,0,3 user reviews,1,2,3
1086840,7,Positive,13,1,14
1086850,8,Very Positive,138,22,160
1086860,7,Positive,15,0,15
1086870,7,Positive,23,5,28
1086900,0,2 user reviews,2,0,2
1086920,0,3 user reviews,3,0,3
1086940,8,Very Positive,13388,1707,15095
1086970,0,8 user reviews,7,1,8
1086990,0,6 user reviews,0,6,6
1087040,0,1 user reviews,0,1,1
1087070,0,1 user reviews,0,1,1
1087100,0,3 user reviews,1,2,3
1087110,6,Mostly Positive,19,5,24
1087120,7,Positive,9,2,11
1087121,7,Positive,10,0,10
1087122,0,9 user reviews,7,2,9
1087123,7,Positive,10,0,10
1087130,7,Positive,13,2,15
1087131,0,6 user reviews,6,0,6
1087270,6,Mostly Positive,154,51,205
1087280,8,Very Positive,836,76,912
1087290,0,1 user reviews,1,0,1
1087310,0,2 user reviews,2,0,2
1087330,0,9 user reviews,4,5,9
1087350,7,Positive,24,5,29
1087420,0,6 user reviews,4,2,6
1087421,0,4 user reviews,4,0,4
1087422,0,1 user reviews,1,0,1
1087423,0,3 user reviews,3,0,3
1087424,5,Mixed,9,6,15
1087425,0,2 user reviews,1,1,2
1087426,0,2 user reviews,2,0,2
1087427,0,4 user reviews,4,0,4
1087428,0,9 user reviews,7,2,9
1087429,0,3 user reviews,3,0,3
1087440,7,Positive,16,2,18
1087450,0,2 user reviews,2,0,2
1087460,8,Very Positive,207,28,235
1087500,6,Mostly Positive,29,9,38
1087590,0,5 user reviews,5,0,5
1087600,5,Mixed,9,4,13
1087680,0,1 user reviews,1,0,1
1087700,7,Positive,17,3,20
1087720,7,Positive,21,3,24
1087740,7,Positive,28,1,29
1087770,0,1 user reviews,0,1,1
1087780,6,Mostly Positive,11,3,14
1087800,0,7 user reviews,5,2,7
1087810,7,Positive,29,3,32
1087830,0,3 user reviews,3,0,3
1087910,0,2 user reviews,1,1,2
1087940,0,3 user reviews,3,0,3
1087950,0,2 user reviews,1,1,2
1087970,6,Mostly Positive,13,4,17
1088000,6,Mostly Positive,56,20,76
1088010,0,2 user reviews,0,2,2
1088040,0,5 user reviews,4,1,5
1088060,0,2 user reviews,2,0,2
1088070,0,2 user reviews,0,2,2
1088090,5,Mixed,292,226,518
1088120,0,2 user reviews,1,1,2
1088130,0,8 user reviews,1,7,8
1088150,0,3 user reviews,2,1,3
1088290,8,Very Positive,77,3,80
1088310,0,2 user reviews,1,1,2
1088330,0,3 user reviews,3,0,3
1088340,0,3 user reviews,3,0,3
1088350,0,2 user reviews,2,0,2
1088400,0,7 user reviews,7,0,7
1088420,7,Positive,10,0,10
1088440,0,4 user reviews,3,1,4
1088481,0,1 user reviews,0,1,1
1088482,0,1 user reviews,1,0,1
1088491,0,1 user reviews,1,0,1
1088494,0,1 user reviews,1,0,1
1088495,0,1 user reviews,1,0,1
1088540,0,3 user reviews,2,1,3
1088590,5,Mixed,12,7,19
1088600,7,Positive,30,7,37
1088630,0,1 user reviews,1,0,1
1088640,5,Mixed,30,24,54
1088720,0,1 user reviews,1,0,1
1088740,0,4 user reviews,1,3,4
1088790,8,Very Positive,654,149,803
1088880,5,Mixed,6,4,10
1088910,0,1 user reviews,1,0,1
1088930,7,Positive,10,1,11
1088950,8,Very Positive,42,10,52
1088960,0,1 user reviews,1,0,1
1089000,0,3 user reviews,3,0,3
1089030,0,6 user reviews,6,0,6
1089050,0,6 user reviews,5,1,6
1089090,8,Very Positive,651,54,705
1089110,0,9 user reviews,8,1,9
1089140,0,1 user reviews,1,0,1
1089160,0,2 user reviews,2,0,2
1089161,0,1 user reviews,1,0,1
1089165,0,1 user reviews,1,0,1
1089166,0,1 user reviews,1,0,1
1089172,0,2 user reviews,2,0,2
1089190,0,1 user reviews,1,0,1
1089195,0,1 user reviews,0,1,1
1089196,0,1 user reviews,0,1,1
1089214,0,3 user reviews,1,2,3
1089238,0,5 user reviews,5,0,5
1089241,0,2 user reviews,2,0,2
1089270,8,Very Positive,312,63,375
1089310,6,Mostly Positive,15,5,20
1089320,0,1 user reviews,1,0,1
1089330,0,6 user reviews,1,5,6
1089350,5,Mixed,5536,3437,8973
1089520,0,1 user reviews,1,0,1
1089590,0,2 user reviews,1,1,2
1089600,7,Positive,15,3,18
1089620,7,Positive,10,1,11
1089630,0,5 user reviews,5,0,5
1089660,6,Mostly Positive,14,4,18
1089670,0,4 user reviews,4,0,4
1089671,0,6 user reviews,4,2,6
1089672,0,4 user reviews,2,2,4
1089760,0,4 user reviews,2,2,4
1089770,0,7 user reviews,7,0,7
1089790,6,Mostly Positive,54,21,75
1089800,0,1 user reviews,0,1,1
1089810,0,1 user reviews,1,0,1
1089820,5,Mixed,9,4,13
1089830,6,Mostly Positive,217,56,273
1089840,8,Very Positive,56,10,66
1089880,0,2 user reviews,1,1,2
1089980,9,Overwhelmingly Positive,9510,78,9588
1090030,7,Positive,16,2,18
1090060,0,5 user reviews,5,0,5
1090110,0,3 user reviews,3,0,3
1090150,8,Very Positive,461,69,530
1090162,0,3 user reviews,0,3,3
1090163,0,8 user reviews,1,7,8
1090164,0,9 user reviews,7,2,9
1090200,5,Mixed,709,628,1337
1090202,6,Mostly Positive,99,34,133
1090210,6,Mostly Positive,12,4,16
1090380,0,1 user reviews,1,0,1
1090390,7,Positive,9,2,11
1090440,7,Positive,32,5,37
1090470,6,Mostly Positive,8,3,11
1090520,0,1 user reviews,0,1,1
1090540,0,1 user reviews,0,1,1
1090580,0,1 user reviews,1,0,1
1090630,8,Very Positive,1146,170,1316
1090650,0,1 user reviews,1,0,1
1090660,0,1 user reviews,1,0,1
1090670,7,Positive,17,3,20
1090690,0,1 user reviews,1,0,1
1090730,5,Mixed,8,5,13
1090790,7,Positive,27,1,28
1090850,6,Mostly Positive,134,40,174
1090860,0,7 user reviews,7,0,7
1090910,0,1 user reviews,0,1,1
1090920,0,2 user reviews,2,0,2
1090930,6,Mostly Positive,18,5,23
1090940,0,3 user reviews,3,0,3
1090960,0,3 user reviews,3,0,3
1091040,0,1 user reviews,1,0,1
1091050,0,3 user reviews,0,3,3
1091090,0,6 user reviews,5,1,6
1091110,0,7 user reviews,5,2,7
1091150,0,7 user reviews,6,1,7
1091160,0,2 user reviews,2,0,2
1091170,0,9 user reviews,5,4,9
1091180,0,1 user reviews,1,0,1
1091190,0,1 user reviews,0,1,1
1091200,6,Mostly Positive,13,5,18
1091210,5,Mixed,10,5,15
1091220,0,1 user reviews,0,1,1
1091240,0,6 user reviews,5,1,6
1091250,8,Very Positive,52,4,56
1091270,0,7 user reviews,5,2,7
1091400,7,Positive,26,5,31
1091460,0,7 user reviews,5,2,7
1091470,7,Positive,11,2,13
1091560,0,8 user reviews,5,3,8
1091570,0,3 user reviews,2,1,3
1091580,0,4 user reviews,3,1,4
1091590,0,6 user reviews,3,3,6
1091650,5,Mixed,8,12,20
1091680,6,Mostly Positive,12,4,16
1091720,0,1 user reviews,1,0,1
1091910,0,1 user reviews,1,0,1
1091940,6,Mostly Positive,19,8,27
1091950,7,Positive,19,2,21
1091980,6,Mostly Positive,156,59,215
1092000,7,Positive,27,4,31
1092140,5,Mixed,13,8,21
1092180,0,1 user reviews,0,1,1
1092190,0,2 user reviews,0,2,2
1092210,5,Mixed,11,9,20
1092260,0,4 user reviews,3,1,4
1092291,0,3 user reviews,3,0,3
1092300,0,2 user reviews,0,2,2
1092330,7,Positive,8,2,10
1092430,6,Mostly Positive,134,34,168
1092510,0,3 user reviews,3,0,3
1092590,0,9 user reviews,9,0,9
1092630,7,Positive,31,1,32
1092640,0,1 user reviews,0,1,1
1092650,0,2 user reviews,1,1,2
1092660,6,Mostly Positive,1140,367,1507
1092690,0,1 user reviews,1,0,1
1092693,0,1 user reviews,1,0,1
1092695,0,2 user reviews,2,0,2
1092770,0,7 user reviews,6,1,7
1092780,7,Positive,17,2,19
1092800,7,Positive,14,0,14
1092830,0,1 user reviews,1,0,1
1092840,7,Positive,26,1,27
1092850,0,1 user reviews,1,0,1
1092880,7,Positive,27,2,29
1092980,6,Mostly Positive,13,4,17
1093040,0,1 user reviews,1,0,1
1093120,0,2 user reviews,2,0,2
1093130,0,5 user reviews,5,0,5
1093150,0,8 user reviews,7,1,8
1093260,0,2 user reviews,2,0,2
1093270,0,2 user reviews,0,2,2
1093280,0,1 user reviews,1,0,1
1093300,0,6 user reviews,5,1,6
1093310,0,4 user reviews,1,3,4
1093320,5,Mixed,17,10,27
1093330,8,Very Positive,213,18,231
1093360,7,Positive,16,1,17
1093370,0,8 user reviews,7,1,8
1093400,7,Positive,28,0,28
1093430,0,1 user reviews,1,0,1
1093520,7,Positive,26,1,27
1093670,0,9 user reviews,8,1,9
1093700,8,Very Positive,108,18,126
1093730,6,Mostly Positive,83,27,110
1093760,6,Mostly Positive,11,4,15
1093790,7,Positive,14,3,17
1093800,0,7 user reviews,7,0,7
1093880,5,Mixed,6,5,11
1093910,8,Very Positive,113,2,115
1093920,7,Positive,13,0,13
1093950,0,3 user reviews,3,0,3
1093990,0,1 user reviews,0,1,1
1094000,5,Mixed,50,37,87
1094030,0,1 user reviews,0,1,1
1094050,6,Mostly Positive,12,4,16
1094060,5,Mixed,37,25,62
1094070,0,6 user reviews,5,1,6
1094100,0,2 user reviews,1,1,2
1094110,0,7 user reviews,5,2,7
1094130,0,2 user reviews,2,0,2
1094190,0,1 user reviews,0,1,1
1094200,0,1 user reviews,1,0,1
1094250,7,Positive,31,3,34
1094281,0,1 user reviews,1,0,1
1094320,0,4 user reviews,2,2,4
1094340,0,6 user reviews,5,1,6
1094390,8,Very Positive,63,7,70
1094420,8,Very Positive,66,3,69
1094440,0,4 user reviews,3,1,4
1094490,0,1 user reviews,1,0,1
1094520,8,Very Positive,360,48,408
1094530,0,4 user reviews,4,0,4
1094640,0,8 user reviews,5,3,8
1094660,4,Mostly Negative,3,9,12
1094690,0,2 user reviews,2,0,2
1094740,0,1 user reviews,1,0,1
1094760,5,Mixed,12,10,22
1094780,8,Very Positive,185,25,210
1094820,7,Positive,16,0,16
1094840,0,1 user reviews,1,0,1
1094870,7,Positive,27,3,30
1094880,5,Mixed,10,6,16
1094930,0,5 user reviews,5,0,5
1094960,7,Positive,16,0,16
1095030,7,Positive,20,2,22
1095031,5,Mixed,10,5,15
1095070,0,3 user reviews,0,3,3
1095120,7,Positive,32,1,33
1095140,0,2 user reviews,2,0,2
1095230,0,1 user reviews,1,0,1
1095250,0,1 user reviews,1,0,1
1095280,0,2 user reviews,0,2,2
1095320,0,5 user reviews,5,0,5
1095360,0,1 user reviews,1,0,1
1095370,0,4 user reviews,4,0,4
1095380,0,3 user reviews,2,1,3
1095500,0,5 user reviews,4,1,5
1095540,0,2 user reviews,1,1,2
1095550,0,1 user reviews,1,0,1
1095650,0,3 user reviews,0,3,3
1095700,0,7 user reviews,4,3,7
1095710,6,Mostly Positive,7,3,10
1095750,0,6 user reviews,5,1,6
1095770,0,1 user reviews,1,0,1
1095780,0,3 user reviews,3,0,3
1095790,0,1 user reviews,1,0,1
1095820,0,2 user reviews,2,0,2
1095840,0,5 user reviews,5,0,5
1095850,0,1 user reviews,1,0,1
1095860,0,1 user reviews,1,0,1
1096000,0,6 user reviews,5,1,6
1096010,5,Mixed,14,10,24
1096020,0,2 user reviews,2,0,2
1096060,7,Positive,23,0,23
1096120,0,1 user reviews,0,1,1
1096130,0,1 user reviews,0,1,1
1096180,7,Positive,12,0,12
1096210,7,Positive,15,3,18
1096230,0,5 user reviews,4,1,5
1096240,0,3 user reviews,2,1,3
1096300,0,5 user reviews,2,3,5
1096340,0,1 user reviews,1,0,1
1096410,5,Mixed,434,197,631
1096420,0,2 user reviews,2,0,2
1096430,0,2 user reviews,0,2,2
1096510,0,7 user reviews,4,3,7
1096520,8,Very Positive,212,45,257
1096530,8,Very Positive,754,46,800
1096540,4,Mostly Negative,3,7,10
1096550,8,Very Positive,79,14,93
1096560,5,Mixed,16,7,23
1096570,8,Very Positive,342,66,408
1096580,5,Mixed,10,13,23
1096600,0,2 user reviews,2,0,2
1096610,6,Mostly Positive,32,10,42
1096630,0,6 user reviews,3,3,6
1096690,0,8 user reviews,7,1,8
1096720,8,Very Positive,121,28,149
1096730,5,Mixed,24,15,39
1096750,0,5 user reviews,4,1,5
1096830,0,1 user reviews,0,1,1
1096890,0,1 user reviews,1,0,1
1096900,5,Mixed,88,43,131
1096910,0,4 user reviews,1,3,4
1096930,8,Very Positive,58,6,64
1096940,0,2 user reviews,2,0,2
1096950,0,4 user reviews,2,2,4
1096960,0,1 user reviews,1,0,1
1096970,0,4 user reviews,1,3,4
1096980,0,6 user reviews,5,1,6
1097090,0,4 user reviews,1,3,4
1097110,7,Positive,34,3,37
1097120,0,4 user reviews,3,1,4
1097150,8,Very Positive,79879,13994,93873
1097160,0,2 user reviews,2,0,2
1097170,7,Positive,23,2,25
1097180,5,Mixed,6,4,10
1097210,6,Mostly Positive,11,3,14
1097240,6,Mostly Positive,23,9,32
1097270,0,3 user reviews,3,0,3
1097310,0,4 user reviews,1,3,4
1097330,0,5 user reviews,5,0,5
1097370,7,Positive,20,4,24
1097420,5,Mixed,15,8,23
1097520,6,Mostly Positive,9,3,12
1097530,8,Very Positive,175,19,194
1097550,0,2 user reviews,2,0,2
1097570,0,2 user reviews,2,0,2
1097580,8,Very Positive,270,52,322
1097590,0,1 user reviews,0,1,1
1097600,0,3 user reviews,0,3,3
1097620,8,Very Positive,109,24,133
1097670,7,Positive,8,2,10
1097690,0,4 user reviews,0,4,4
1097710,0,8 user reviews,7,1,8
1097750,7,Positive,23,0,23
1097760,0,4 user reviews,4,0,4
1097770,0,8 user reviews,8,0,8
1097780,7,Positive,20,0,20
1097790,6,Mostly Positive,38,10,48
1097800,8,Very Positive,162,29,191
1097810,7,Positive,14,1,15
1097840,5,Mixed,2437,1157,3594
1097870,0,4 user reviews,4,0,4
1097880,8,Very Positive,213,48,261
1097896,0,2 user reviews,0,2,2
1097900,0,2 user reviews,2,0,2
1097960,5,Mixed,49,23,72
1098080,8,Very Positive,53,8,61
1098090,0,7 user reviews,6,1,7
1098100,6,Mostly Positive,44,17,61
1098120,5,Mixed,52,24,76
1098140,0,2 user reviews,1,1,2
1098161,0,2 user reviews,2,0,2
1098162,0,3 user reviews,3,0,3
1098163,0,7 user reviews,2,5,7
1098165,0,2 user reviews,2,0,2
1098166,0,5 user reviews,1,4,5
1098167,0,6 user reviews,6,0,6
1098170,8,Very Positive,88,11,99
1098200,5,Mixed,6,7,13
1098210,6,Mostly Positive,73,31,104
1098220,0,2 user reviews,2,0,2
1098250,0,3 user reviews,3,0,3
1098291,7,Positive,11,1,12
1098292,8,Very Positive,849,174,1023
1098300,6,Mostly Positive,39,11,50
1098340,8,Very Positive,173,9,182
1098360,0,1 user reviews,1,0,1
1098370,8,Very Positive,50,2,52
1098420,7,Positive,24,1,25
1098430,0,2 user reviews,0,2,2
1098440,0,1 user reviews,1,0,1
1098490,0,4 user reviews,3,1,4
1098510,5,Mixed,9,4,13
1098520,5,Mixed,7,9,16
1098530,0,2 user reviews,0,2,2
1098540,0,4 user reviews,2,2,4
1098560,0,1 user reviews,1,0,1
1098640,0,3 user reviews,1,2,3
1098650,0,1 user reviews,0,1,1
1098670,0,3 user reviews,1,2,3
1098680,0,2 user reviews,2,0,2
1098700,0,6 user reviews,6,0,6
1098720,0,7 user reviews,6,1,7
1098730,0,3 user reviews,2,1,3
1098760,0,5 user reviews,2,3,5
1098790,5,Mixed,8,9,17
1098820,0,1 user reviews,1,0,1
1098870,0,4 user reviews,1,3,4
1098940,5,Mixed,81,39,120
1098980,0,1 user reviews,0,1,1
1099010,0,4 user reviews,3,1,4
1099070,0,1 user reviews,0,1,1
1099090,0,4 user reviews,3,1,4
1099120,0,1 user reviews,1,0,1
1099122,0,2 user reviews,0,2,2
1099140,0,2 user reviews,1,1,2
1099170,7,Positive,15,1,16
1099202,0,1 user reviews,1,0,1
1099210,0,1 user reviews,1,0,1
1099211,0,1 user reviews,1,0,1
1099213,0,1 user reviews,1,0,1
1099345,0,1 user reviews,1,0,1
1099391,0,2 user reviews,2,0,2
1099440,7,Positive,20,5,25
1099450,0,9 user reviews,5,4,9
1099460,0,7 user reviews,5,2,7
1099500,7,Positive,46,2,48
1099530,7,Positive,10,2,12
1099560,0,9 user reviews,7,2,9
1099561,7,Positive,11,2,13
1099562,0,6 user reviews,2,4,6
1099563,7,Positive,8,2,10
1099580,0,2 user reviews,0,2,2
1099581,0,8 user reviews,4,4,8
1099582,0,7 user reviews,3,4,7
1099583,0,3 user reviews,1,2,3
1099584,5,Mixed,8,5,13
1099585,0,6 user reviews,2,4,6
1099590,0,3 user reviews,3,0,3
1099592,7,Positive,10,0,10
1099594,0,6 user reviews,6,0,6
1099620,0,1 user reviews,1,0,1
1099630,0,7 user reviews,4,3,7
1099660,0,3 user reviews,3,0,3
1099830,4,Mostly Negative,4,10,14
1099840,0,7 user reviews,5,2,7
1099920,6,Mostly Positive,23,7,30
1099960,7,Positive,17,4,21
1100050,0,1 user reviews,1,0,1
1100070,0,2 user reviews,1,1,2
1100110,8,Very Positive,111,17,128
1100130,0,1 user reviews,1,0,1
1100140,7,Positive,35,0,35
1100150,7,Positive,33,0,33
1100160,7,Positive,10,1,11
1100170,0,7 user reviews,7,0,7
1100180,7,Positive,10,0,10
1100200,7,Positive,10,0,10
1100210,0,1 user reviews,1,0,1
1100250,4,Mostly Negative,11,19,30
1100260,8,Very Positive,145,19,164
1100300,0,5 user reviews,5,0,5
1100350,0,5 user reviews,5,0,5
1100410,5,Mixed,105,110,215
1100420,8,Very Positive,82,10,92
1100430,7,Positive,26,1,27
1100550,0,3 user reviews,2,1,3
1100560,0,2 user reviews,2,0,2
1100600,8,Very Positive,5553,608,6161
1100620,8,Very Positive,223,40,263
1100750,5,Mixed,64,78,142
1100781,0,2 user reviews,0,2,2
1100784,0,1 user reviews,0,1,1
1100793,0,2 user reviews,0,2,2
1100800,7,Positive,30,0,30
1100830,0,8 user reviews,4,4,8
1100900,0,4 user reviews,3,1,4
1100920,0,4 user reviews,2,2,4
1100930,6,Mostly Positive,12,5,17
1100960,7,Positive,9,1,10
1100970,6,Mostly Positive,19,5,24
1100990,8,Very Positive,491,34,525
1101000,0,3 user reviews,1,2,3
1101080,0,4 user reviews,3,1,4
1101100,0,2 user reviews,1,1,2
1101130,6,Mostly Positive,18,5,23
1101140,8,Very Positive,151,12,163
1101180,0,9 user reviews,9,0,9
1101190,6,Mostly Positive,851,319,1170
1101200,0,1 user reviews,1,0,1
1101220,0,2 user reviews,2,0,2
1101260,8,Very Positive,82,13,95
1101270,7,Positive,14,3,17
1101300,7,Positive,26,0,26
1101310,0,1 user reviews,1,0,1
1101350,7,Positive,32,1,33
1101351,7,Positive,39,0,39
1101360,5,Mixed,38,20,58
1101420,7,Positive,8,2,10
1101450,8,Very Positive,216,19,235
1101570,0,2 user reviews,0,2,2
1101660,0,4 user reviews,3,1,4
1101710,0,3 user reviews,2,1,3
1101711,0,4 user reviews,4,0,4
1101720,7,Positive,15,2,17
1101750,0,4 user reviews,1,3,4
1101760,5,Mixed,15,7,22
1101770,0,3 user reviews,3,0,3
1101780,0,6 user reviews,2,4,6
1101800,0,7 user reviews,7,0,7
1101840,0,1 user reviews,1,0,1
1101850,0,1 user reviews,1,0,1
1101930,7,Positive,13,3,16
1101940,0,4 user reviews,2,2,4
1101960,0,1 user reviews,1,0,1
1101970,5,Mixed,9,6,15
1102000,0,1 user reviews,1,0,1
1102040,0,6 user reviews,5,1,6
1102060,0,3 user reviews,2,1,3
1102080,0,7 user reviews,7,0,7
1102100,6,Mostly Positive,50,17,67
1102130,8,Very Positive,583,58,641
1102150,0,2 user reviews,1,1,2
1102190,9,Overwhelmingly Positive,5710,136,5846
1102200,0,3 user reviews,2,1,3
1102230,0,1 user reviews,1,0,1
1102250,0,7 user reviews,4,3,7
1102260,0,7 user reviews,5,2,7
1102310,5,Mixed,142,146,288
1102320,0,1 user reviews,1,0,1
1102340,7,Positive,16,0,16
1102360,0,4 user reviews,2,2,4
1102370,7,Positive,10,1,11
1102380,7,Positive,14,2,16
1102390,0,3 user reviews,3,0,3
1102420,0,1 user reviews,1,0,1
1102430,0,1 user reviews,1,0,1
1102480,0,1 user reviews,1,0,1
1102500,6,Mostly Positive,10,4,14
1102510,0,1 user reviews,1,0,1
1102580,7,Positive,13,3,16
1102590,0,1 user reviews,1,0,1
1102610,0,1 user reviews,1,0,1
1102630,0,1 user reviews,1,0,1
1102640,0,1 user reviews,1,0,1
1102650,0,8 user reviews,8,0,8
1102670,0,1 user reviews,1,0,1
1102671,0,2 user reviews,2,0,2
1102680,0,6 user reviews,4,2,6
1102700,0,8 user reviews,7,1,8
1102720,0,9 user reviews,7,2,9
1102740,0,1 user reviews,1,0,1
1102750,0,7 user reviews,5,2,7
1102780,5,Mixed,18,12,30
1102880,5,Mixed,10,6,16
1102930,7,Positive,31,7,38
1102980,0,5 user reviews,4,1,5
1103050,0,1 user reviews,0,1,1
1103100,8,Very Positive,76,18,94
1103120,0,3 user reviews,2,1,3
1103130,7,Positive,13,0,13
1103140,0,9 user reviews,6,3,9
1103210,0,5 user reviews,3,2,5
1103240,0,1 user reviews,1,0,1
1103250,0,3 user reviews,2,1,3
1103290,0,1 user reviews,1,0,1
1103300,0,1 user reviews,0,1,1
1103310,0,8 user reviews,8,0,8
1103320,0,2 user reviews,1,1,2
1103340,0,1 user reviews,1,0,1
1103370,0,1 user reviews,1,0,1
1103390,0,1 user reviews,1,0,1
1103410,0,1 user reviews,1,0,1
1103420,0,1 user reviews,1,0,1
1103430,0,1 user reviews,1,0,1
1103490,6,Mostly Positive,51,17,68
1103520,0,1 user reviews,1,0,1
1103540,0,1 user reviews,1,0,1
1103550,0,1 user reviews,1,0,1
1103630,0,4 user reviews,0,4,4
1103640,0,2 user reviews,2,0,2
1103650,0,1 user reviews,0,1,1
1103670,0,2 user reviews,2,0,2
1103710,0,1 user reviews,1,0,1
1103711,0,1 user reviews,1,0,1
1103730,0,8 user reviews,6,2,8
1103740,7,Positive,13,0,13
1103741,0,3 user reviews,2,1,3
1103770,7,Positive,28,1,29
1103790,0,1 user reviews,1,0,1
1103800,7,Positive,14,2,16
1103810,0,4 user reviews,2,2,4
1103840,7,Positive,13,2,15
1103860,8,Very Positive,79,18,97
1103870,0,1 user reviews,1,0,1
1103880,8,Very Positive,100,13,113
1103890,0,5 user reviews,4,1,5
1103920,0,2 user reviews,0,2,2
1103930,7,Positive,17,0,17
1103950,5,Mixed,235,165,400
1104030,0,1 user reviews,0,1,1
1104050,0,5 user reviews,1,4,5
1104100,0,1 user reviews,1,0,1
1104220,8,Very Positive,56,10,66
1104230,0,2 user reviews,1,1,2
1104250,0,1 user reviews,0,1,1
1104260,7,Positive,20,3,23
1104330,8,Very Positive,190,13,203
1104340,0,5 user reviews,4,1,5
1104380,9,Overwhelmingly Positive,613,23,636
1104410,0,7 user reviews,3,4,7
1104460,0,2 user reviews,1,1,2
1104470,0,1 user reviews,1,0,1
1104480,0,2 user reviews,0,2,2
1104490,0,3 user reviews,2,1,3
1104620,0,7 user reviews,6,1,7
1104660,8,Very Positive,610,49,659
1104680,7,Positive,14,3,17
1104830,0,3 user reviews,3,0,3
1104860,0,1 user reviews,0,1,1
1104880,8,Very Positive,134,26,160
1104960,0,1 user reviews,1,0,1
1105010,0,2 user reviews,1,1,2
1105040,7,Positive,23,4,27
1105110,7,Positive,39,4,43
1105140,0,1 user reviews,1,0,1
1105190,0,1 user reviews,1,0,1
1105300,0,5 user reviews,5,0,5
1105322,0,2 user reviews,0,2,2
1105350,0,1 user reviews,1,0,1
1105360,5,Mixed,14,12,26
1105370,5,Mixed,14,10,24
1105380,0,2 user reviews,2,0,2
1105410,7,Positive,10,1,11
1105430,0,9 user reviews,8,1,9
1105450,0,4 user reviews,3,1,4
1105490,0,1 user reviews,1,0,1
1105542,0,8 user reviews,7,1,8
1105600,0,1 user reviews,1,0,1
1105620,7,Positive,40,7,47
1105630,7,Positive,10,0,10
1105660,6,Mostly Positive,16,6,22
1105730,0,9 user reviews,7,2,9
1105740,7,Positive,14,1,15
1105770,0,4 user reviews,3,1,4
1105810,5,Mixed,86,45,131
1105870,0,1 user reviews,1,0,1
1105880,0,3 user reviews,3,0,3
1105890,7,Positive,28,3,31
1105950,7,Positive,16,4,20
1105951,5,Mixed,9,4,13
1106060,6,Mostly Positive,10,4,14
1106070,7,Positive,13,1,14
1106080,7,Positive,31,6,37
1106100,0,2 user reviews,2,0,2
1106130,0,5 user reviews,5,0,5
1106150,7,Positive,18,1,19
1106170,7,Positive,9,2,11
1106180,5,Mixed,18,8,26
1106200,0,4 user reviews,4,0,4
1106220,0,3 user reviews,1,2,3
1106221,0,1 user reviews,1,0,1
1106222,0,1 user reviews,0,1,1
1106223,0,1 user reviews,1,0,1
1106224,0,1 user reviews,0,1,1
1106225,0,1 user reviews,1,0,1
1106226,0,1 user reviews,1,0,1
1106227,0,1 user reviews,1,0,1
1106228,0,1 user reviews,1,0,1
1106231,0,1 user reviews,1,0,1
1106233,0,1 user reviews,0,1,1
1106234,0,1 user reviews,1,0,1
1106250,0,1 user reviews,1,0,1
1106290,0,1 user reviews,1,0,1
1106300,0,2 user reviews,2,0,2
1106310,0,1 user reviews,1,0,1
1106320,0,2 user reviews,2,0,2
1106321,0,1 user reviews,0,1,1
1106350,0,4 user reviews,2,2,4
1106360,0,1 user reviews,0,1,1
1106361,0,2 user reviews,2,0,2
1106362,0,1 user reviews,1,0,1
1106370,0,1 user reviews,1,0,1
1106371,0,1 user reviews,1,0,1
1106380,0,1 user reviews,1,0,1
1106391,0,1 user reviews,1,0,1
1106450,0,1 user reviews,1,0,1
1106451,0,2 user reviews,2,0,2
1106452,0,1 user reviews,1,0,1
1106530,8,Very Positive,926,160,1086
1106670,0,5 user reviews,3,2,5
1106690,0,2 user reviews,0,2,2
1106710,0,2 user reviews,1,1,2
1106750,6,Mostly Positive,1041,442,1483
1106780,0,3 user reviews,3,0,3
1106790,0,4 user reviews,3,1,4
1106820,0,1 user reviews,1,0,1
1106840,8,Very Positive,1986,347,2333
1106860,8,Very Positive,70,3,73
1106920,7,Positive,18,2,20
1106940,8,Very Positive,72,6,78
1106970,0,2 user reviews,0,2,2
1106980,0,2 user reviews,2,0,2
1107040,5,Mixed,10,6,16
1107050,0,1 user reviews,1,0,1
1107060,0,7 user reviews,7,0,7
1107090,0,1 user reviews,1,0,1
1107160,0,1 user reviews,0,1,1
1107180,6,Mostly Positive,35,10,45
1107190,0,1 user reviews,0,1,1
1107210,0,1 user reviews,1,0,1
1107230,7,Positive,44,3,47
1107260,0,2 user reviews,2,0,2
1107290,7,Positive,15,0,15
1107350,0,1 user reviews,0,1,1
1107370,5,Mixed,37,16,53
1107440,0,4 user reviews,2,2,4
1107470,0,9 user reviews,9,0,9
1107510,0,2 user reviews,1,1,2
1107720,0,2 user reviews,0,2,2
1107760,7,Positive,37,0,37
1107790,6,Mostly Positive,208,61,269
1107810,0,1 user reviews,0,1,1
1107811,0,2 user reviews,1,1,2
1107812,5,Mixed,7,9,16
1107813,0,9 user reviews,2,7,9
1107814,0,1 user reviews,1,0,1
1107820,0,7 user reviews,7,0,7
1107840,5,Mixed,43,33,76
1107920,0,1 user reviews,1,0,1
1108090,7,Positive,40,7,47
1108190,0,7 user reviews,5,2,7
1108250,0,2 user reviews,2,0,2
1108280,7,Positive,11,0,11
1108310,0,2 user reviews,2,0,2
1108320,7,Positive,9,2,11
1108350,8,Very Positive,96,11,107
1108370,8,Very Positive,582,70,652
1108380,0,5 user reviews,5,0,5
1108410,7,Positive,25,6,31
1108450,5,Mixed,23,27,50
1108460,7,Positive,12,3,15
1108540,7,Positive,9,1,10
1108550,0,7 user reviews,7,0,7
1108580,0,1 user reviews,1,0,1
1108620,5,Mixed,10,5,15
1108640,0,7 user reviews,6,1,7
1108650,0,2 user reviews,0,2,2
1108660,0,1 user reviews,1,0,1
1108740,5,Mixed,27,15,42
1108820,0,3 user reviews,2,1,3
1108860,0,2 user reviews,1,1,2
1108870,0,4 user reviews,4,0,4
1108900,5,Mixed,4,6,10
1108910,7,Positive,9,1,10
1108920,5,Mixed,9,7,16
1108930,0,2 user reviews,2,0,2
1109080,0,1 user reviews,1,0,1
1109110,0,2 user reviews,1,1,2
1109170,0,1 user reviews,1,0,1
1109200,0,2 user reviews,1,1,2
1109202,0,1 user reviews,0,1,1
1109203,0,4 user reviews,2,2,4
1109204,0,1 user reviews,1,0,1
1109205,0,9 user reviews,8,1,9
1109206,0,4 user reviews,3,1,4
1109207,0,2 user reviews,1,1,2
1109208,0,3 user reviews,2,1,3
1109209,5,Mixed,6,8,14
1109280,0,1 user reviews,1,0,1
1109310,0,8 user reviews,3,5,8
1109350,0,2 user reviews,2,0,2
1109360,8,Very Positive,48,3,51
1109380,0,2 user reviews,1,1,2
1109550,0,2 user reviews,1,1,2
1109562,0,1 user reviews,1,0,1
1109563,0,1 user reviews,1,0,1
1109650,0,1 user reviews,1,0,1
1109670,0,9 user reviews,1,8,9
1109690,5,Mixed,14,8,22
1109720,0,1 user reviews,1,0,1
1109740,0,8 user reviews,2,6,8
1109750,0,1 user reviews,1,0,1
1109800,0,1 user reviews,1,0,1
1109840,0,3 user reviews,3,0,3
1109940,0,2 user reviews,2,0,2
1109960,0,1 user reviews,1,0,1
1109980,0,3 user reviews,0,3,3
1110030,7,Positive,32,7,39
1110050,8,Very Positive,127,21,148
1110100,8,Very Positive,337,36,373
1110200,0,2 user reviews,1,1,2
1110220,0,3 user reviews,3,0,3
1110280,0,1 user reviews,1,0,1
1110340,0,3 user reviews,2,1,3
1110350,0,3 user reviews,3,0,3
1110380,7,Positive,21,2,23
1110410,6,Mostly Positive,34,14,48
1110490,0,1 user reviews,0,1,1
1110580,7,Positive,18,4,22
1110640,0,5 user reviews,1,4,5
1110650,0,1 user reviews,1,0,1
1110660,0,1 user reviews,1,0,1
1110700,0,1 user reviews,1,0,1
1110720,0,1 user reviews,1,0,1
1110770,0,4 user reviews,3,1,4
1110830,0,3 user reviews,2,1,3
1110840,0,3 user reviews,1,2,3
1110890,7,Positive,24,1,25
1110930,0,2 user reviews,2,0,2
1110980,7,Positive,17,2,19
1111030,7,Positive,22,4,26
1111090,0,1 user reviews,1,0,1
1111100,0,1 user reviews,1,0,1
1111110,0,1 user reviews,0,1,1
1111120,0,4 user reviews,4,0,4
1111140,0,3 user reviews,3,0,3
1111170,0,1 user reviews,1,0,1
1111200,0,1 user reviews,0,1,1
1111210,0,4 user reviews,3,1,4
1111220,0,2 user reviews,2,0,2
1111310,0,3 user reviews,2,1,3
1111370,8,Very Positive,287,0,287
1111380,6,Mostly Positive,26,9,35
1111390,0,9 user reviews,7,2,9
1111440,7,Positive,9,1,10
1111444,0,1 user reviews,1,0,1
1111447,0,4 user reviews,4,0,4
1111450,0,1 user reviews,1,0,1
1111471,0,1 user reviews,1,0,1
1111474,0,2 user reviews,1,1,2
1111500,0,3 user reviews,1,2,3
1111511,0,1 user reviews,1,0,1
1111516,0,1 user reviews,1,0,1
1111517,0,1 user reviews,1,0,1
1111518,0,2 user reviews,2,0,2
1111530,0,1 user reviews,1,0,1
1111610,0,4 user reviews,1,3,4
1111620,7,Positive,20,3,23
1111790,0,3 user reviews,2,1,3
1111810,6,Mostly Positive,25,7,32
1111940,6,Mostly Positive,22,7,29
1111970,0,7 user reviews,6,1,7
1111990,0,5 user reviews,1,4,5
1112010,0,2 user reviews,1,1,2
1112050,0,4 user reviews,4,0,4
1112081,0,1 user reviews,1,0,1
1112082,0,1 user reviews,1,0,1
1112083,0,1 user reviews,1,0,1
1112120,0,2 user reviews,0,2,2
1112150,0,8 user reviews,8,0,8
1112200,0,2 user reviews,1,1,2
1112240,5,Mixed,9,5,14
1112340,8,Very Positive,111,12,123
1112360,0,2 user reviews,2,0,2
1112370,7,Positive,18,3,21
1112420,0,3 user reviews,2,1,3
1112470,0,7 user reviews,7,0,7
1112481,0,1 user reviews,1,0,1
1112482,0,1 user reviews,1,0,1
1112483,0,6 user reviews,3,3,6
1112484,0,1 user reviews,1,0,1
1112520,7,Positive,14,1,15
1112521,0,7 user reviews,5,2,7
1112570,0,3 user reviews,2,1,3
1112580,0,5 user reviews,4,1,5
1112590,7,Positive,11,0,11
1112591,0,3 user reviews,2,1,3
1112620,7,Positive,32,8,40
1112640,6,Mostly Positive,11,3,14
1112690,7,Positive,11,2,13
1112700,0,5 user reviews,5,0,5
1112760,0,2 user reviews,2,0,2
1112790,5,Mixed,772,346,1118
1112830,5,Mixed,28,15,43
1112930,8,Very Positive,115,11,126
1112960,0,4 user reviews,2,2,4
1113000,9,Overwhelmingly Positive,18746,421,19167
1113040,0,2 user reviews,2,0,2
1113060,0,3 user reviews,3,0,3
1113090,0,1 user reviews,1,0,1
1113110,0,2 user reviews,1,1,2
1113140,0,2 user reviews,2,0,2
1113220,0,3 user reviews,3,0,3
1113230,0,1 user reviews,1,0,1
1113240,0,2 user reviews,2,0,2
1113300,6,Mostly Positive,21,7,28
1113310,7,Positive,21,1,22
1113360,0,1 user reviews,1,0,1
1113390,0,4 user reviews,4,0,4
1113410,5,Mixed,534,569,1103
1113430,0,1 user reviews,1,0,1
1113490,0,2 user reviews,2,0,2
1113550,7,Positive,14,0,14
1113620,0,8 user reviews,3,5,8
1113640,0,1 user reviews,0,1,1
1113650,0,1 user reviews,0,1,1
1113680,8,Very Positive,164,36,200
1113690,7,Positive,10,0,10
1113740,0,2 user reviews,1,1,2
1113750,0,8 user reviews,4,4,8
1113760,0,3 user reviews,3,0,3
1113770,7,Positive,10,0,10
1113780,7,Positive,15,3,18
1113820,5,Mixed,29,23,52
1113821,7,Positive,27,3,30
1113822,7,Positive,18,4,22
1113823,6,Mostly Positive,16,5,21
1113824,5,Mixed,11,6,17
1113910,8,Very Positive,94,20,114
1113930,0,4 user reviews,3,1,4
1113940,7,Positive,13,1,14
1113960,0,3 user reviews,3,0,3
1113970,7,Positive,14,0,14
1114000,0,7 user reviews,2,5,7
1114010,0,3 user reviews,3,0,3
1114020,0,1 user reviews,1,0,1
1114070,0,1 user reviews,1,0,1
1114110,0,1 user reviews,0,1,1
1114130,8,Very Positive,109,4,113
1114210,0,2 user reviews,2,0,2
1114220,8,Very Positive,186,25,211
1114230,0,3 user reviews,2,1,3
1114270,0,3 user reviews,2,1,3
1114360,0,8 user reviews,5,3,8
1114430,7,Positive,24,1,25
1114460,0,7 user reviews,7,0,7
1114530,7,Positive,30,4,34
1114550,6,Mostly Positive,46,12,58
1114561,7,Positive,26,0,26
1114620,0,8 user reviews,8,0,8
1114630,0,4 user reviews,3,1,4
1114700,0,2 user reviews,1,1,2
1114710,0,3 user reviews,0,3,3
1114730,7,Positive,17,3,20
1114750,0,2 user reviews,2,0,2
1114800,0,1 user reviews,1,0,1
1114830,5,Mixed,28,19,47
1114870,8,Very Positive,82,11,93
1114910,0,1 user reviews,1,0,1
1115040,0,2 user reviews,0,2,2
1115060,0,1 user reviews,0,1,1
1115420,0,5 user reviews,3,2,5
1115450,6,Mostly Positive,24,7,31
1115570,0,1 user reviews,0,1,1
1115580,7,Positive,26,0,26
1115600,0,3 user reviews,3,0,3
1115620,0,2 user reviews,2,0,2
1115630,0,1 user reviews,1,0,1
1115640,7,Positive,34,5,39
1115650,5,Mixed,7,8,15
1115690,8,Very Positive,1297,238,1535
1115760,0,3 user reviews,3,0,3
1115780,6,Mostly Positive,23,6,29
1115820,0,2 user reviews,2,0,2
1115840,0,2 user reviews,0,2,2
1115970,0,1 user reviews,1,0,1
1116020,0,4 user reviews,2,2,4
1116060,5,Mixed,8,6,14
1116110,7,Positive,14,1,15
1116160,0,2 user reviews,2,0,2
1116180,0,3 user reviews,3,0,3
1116200,0,1 user reviews,1,0,1
1116210,5,Mixed,8,5,13
1116230,8,Very Positive,59,9,68
1116240,0,3 user reviews,2,1,3
1116290,7,Positive,11,2,13
1116300,0,1 user reviews,1,0,1
1116310,7,Positive,29,1,30
1116340,6,Mostly Positive,22,9,31
1116350,0,1 user reviews,0,1,1
1116360,0,1 user reviews,1,0,1
1116430,7,Positive,14,1,15
1116450,0,2 user reviews,2,0,2
1116470,4,Mostly Negative,4,11,15
1116490,7,Positive,12,3,15
1116520,4,Mostly Negative,3,7,10
1116590,0,5 user reviews,3,2,5
1116600,0,2 user reviews,0,2,2
1116650,0,2 user reviews,2,0,2
1116670,0,2 user reviews,2,0,2
1116700,0,4 user reviews,4,0,4
1116770,7,Positive,12,2,14
1116780,7,Positive,32,2,34
1116800,0,1 user reviews,1,0,1
1116870,0,4 user reviews,3,1,4
1116880,7,Positive,14,1,15
1116890,0,3 user reviews,3,0,3
1116910,0,2 user reviews,1,1,2
1116940,0,2 user reviews,2,0,2
1116990,7,Positive,24,2,26
1117040,0,3 user reviews,2,1,3
1117120,0,2 user reviews,1,1,2
1117140,7,Positive,20,2,22
1117220,0,1 user reviews,1,0,1
1117250,7,Positive,22,4,26
1117310,8,Very Positive,88,2,90
1117330,0,1 user reviews,0,1,1
1117340,0,2 user reviews,2,0,2
1117360,0,3 user reviews,3,0,3
1117380,7,Positive,16,1,17
1117480,7,Positive,9,1,10
1117490,0,3 user reviews,1,2,3
1117520,0,3 user reviews,1,2,3
1117550,0,5 user reviews,4,1,5
1117630,6,Mostly Positive,136,36,172
1117641,0,2 user reviews,2,0,2
1117660,0,9 user reviews,4,5,9
1117670,7,Positive,13,2,15
1117680,0,6 user reviews,1,5,6
1117710,0,1 user reviews,0,1,1
1117760,0,2 user reviews,2,0,2
1117770,7,Positive,13,2,15
1117860,5,Mixed,12,6,18
1117880,7,Positive,19,1,20
1117890,0,4 user reviews,4,0,4
1117900,0,3 user reviews,2,1,3
1117930,0,1 user reviews,1,0,1
1117940,0,1 user reviews,1,0,1
1117950,0,2 user reviews,2,0,2
1117970,0,1 user reviews,1,0,1
1117980,0,1 user reviews,1,0,1
1117990,0,2 user reviews,2,0,2
1118000,0,6 user reviews,6,0,6
1118010,6,Mostly Positive,2696,997,3693
1118012,7,Positive,21,5,26
1118019,0,1 user reviews,1,0,1
1118021,7,Positive,13,0,13
1118022,0,2 user reviews,2,0,2
1118023,0,2 user reviews,2,0,2
1118024,0,9 user reviews,8,1,9
1118025,0,5 user reviews,5,0,5
1118026,7,Positive,22,0,22
1118029,0,8 user reviews,8,0,8
1118050,0,5 user reviews,4,1,5
1118130,0,1 user reviews,1,0,1
1118200,9,Overwhelmingly Positive,9222,108,9330
1118263,0,1 user reviews,1,0,1
1118270,7,Positive,14,0,14
1118271,0,1 user reviews,1,0,1
1118272,0,1 user reviews,1,0,1
1118274,0,2 user reviews,2,0,2
1118275,0,2 user reviews,2,0,2
1118280,0,1 user reviews,0,1,1
1118281,0,1 user reviews,0,1,1
1118282,0,1 user reviews,0,1,1
1118283,0,2 user reviews,1,1,2
1118284,0,4 user reviews,2,2,4
1118285,0,1 user reviews,0,1,1
1118286,0,1 user reviews,0,1,1
1118287,0,1 user reviews,0,1,1
1118288,0,2 user reviews,1,1,2
1118290,5,Mixed,7,5,12
1118291,0,1 user reviews,0,1,1
1118292,5,Mixed,9,5,14
1118293,0,1 user reviews,0,1,1
1118294,0,3 user reviews,2,1,3
1118320,0,1 user reviews,1,0,1
1118350,7,Positive,10,2,12
1118380,7,Positive,37,9,46
1118410,7,Positive,13,1,14
1118590,0,4 user reviews,1,3,4
1118690,0,1 user reviews,0,1,1
1118700,0,7 user reviews,5,2,7
1118730,0,2 user reviews,0,2,2
1118740,0,7 user reviews,7,0,7
1118820,0,3 user reviews,2,1,3
1118840,6,Mostly Positive,9,3,12
1118870,0,1 user reviews,0,1,1
1118880,7,Positive,28,1,29
1118910,0,4 user reviews,1,3,4
1118930,0,1 user reviews,0,1,1
1118940,0,3 user reviews,2,1,3
1118950,0,1 user reviews,1,0,1
1119030,0,5 user reviews,5,0,5
1119100,0,4 user reviews,4,0,4
1119110,0,1 user reviews,1,0,1
1119380,0,1 user reviews,1,0,1
1119430,0,5 user reviews,5,0,5
1119500,0,1 user reviews,0,1,1
1119520,0,1 user reviews,1,0,1
1119530,0,4 user reviews,3,1,4
1119570,5,Mixed,10,7,17
1119600,6,Mostly Positive,75,30,105
1119630,0,2 user reviews,1,1,2
1119640,0,1 user reviews,0,1,1
1119670,0,3 user reviews,3,0,3
1119700,6,Mostly Positive,114,42,156
1119710,6,Mostly Positive,14,4,18
1119740,0,1 user reviews,1,0,1
1119750,0,3 user reviews,2,1,3
1119760,0,4 user reviews,4,0,4
1119770,0,1 user reviews,0,1,1
1119790,0,6 user reviews,6,0,6
1119800,7,Positive,33,4,37
1119860,7,Positive,10,1,11
1119890,0,1 user reviews,1,0,1
1119940,7,Positive,15,1,16
1119960,0,7 user reviews,7,0,7
1119970,0,2 user reviews,1,1,2
1120020,0,1 user reviews,1,0,1
1120025,0,1 user reviews,1,0,1
1120160,0,2 user reviews,2,0,2
1120200,0,5 user reviews,5,0,5
1120210,6,Mostly Positive,7,3,10
1120240,0,3 user reviews,2,1,3
1120260,0,3 user reviews,1,2,3
1120280,0,7 user reviews,5,2,7
1120290,0,2 user reviews,1,1,2
1120300,5,Mixed,31,14,45
1120301,0,5 user reviews,3,2,5
1120302,5,Mixed,9,11,20
1120304,6,Mostly Positive,12,4,16
1120305,5,Mixed,38,24,62
1120310,0,4 user reviews,4,0,4
1120360,7,Positive,34,3,37
1120370,0,2 user reviews,2,0,2
1120390,0,1 user reviews,1,0,1
1120420,7,Positive,13,0,13
1120461,0,2 user reviews,2,0,2
1120550,5,Mixed,6,7,13
1120560,6,Mostly Positive,30,10,40
1120570,0,1 user reviews,1,0,1
1120580,0,5 user reviews,1,4,5
1120600,0,2 user reviews,2,0,2
1120640,0,1 user reviews,1,0,1
1120670,0,6 user reviews,5,1,6
1120680,0,2 user reviews,1,1,2
1120710,0,2 user reviews,2,0,2
1120800,0,3 user reviews,3,0,3
1120810,8,Very Positive,76,2,78
1120900,0,1 user reviews,0,1,1
1120920,0,5 user reviews,5,0,5
1120940,0,9 user reviews,8,1,9
1120950,7,Positive,10,0,10
1120960,0,2 user reviews,1,1,2
1120970,0,3 user reviews,3,0,3
1120980,7,Positive,19,0,19
1120990,0,8 user reviews,6,2,8
1121100,0,1 user reviews,1,0,1
1121230,0,2 user reviews,1,1,2
1121270,7,Positive,8,2,10
1121300,7,Positive,21,0,21
1121340,0,1 user reviews,1,0,1
1121400,0,2 user reviews,2,0,2
1121420,8,Very Positive,426,25,451
1121430,5,Mixed,11,7,18
1121490,0,2 user reviews,1,1,2
1121530,7,Positive,32,3,35
1121550,0,7 user reviews,6,1,7
1121560,8,Very Positive,722,89,811
1121580,4,Mostly Negative,12,20,32
1121590,7,Positive,36,5,41
1121600,0,1 user reviews,1,0,1
1121620,0,2 user reviews,2,0,2
1121621,0,4 user reviews,4,0,4
1121622,0,2 user reviews,1,1,2
1121650,0,4 user reviews,3,1,4
1121710,5,Mixed,26,14,40
1121720,7,Positive,9,1,10
1121770,0,2 user reviews,1,1,2
1121810,0,7 user reviews,6,1,7
1121960,0,2 user reviews,1,1,2
1122040,7,Positive,36,9,45
1122050,8,Very Positive,226,24,250
1122080,0,7 user reviews,7,0,7
1122100,7,Positive,36,2,38
1122110,0,5 user reviews,0,5,5
1122120,8,Very Positive,119,16,135
1122150,5,Mixed,8,9,17
1122180,6,Mostly Positive,21,6,27
1122200,0,1 user reviews,1,0,1
1122204,0,1 user reviews,1,0,1
1122210,0,1 user reviews,0,1,1
1122240,7,Positive,22,5,27
1122250,0,2 user reviews,1,1,2
1122260,0,3 user reviews,1,2,3
1122270,4,Mostly Negative,3,9,12
1122310,0,1 user reviews,1,0,1
1122400,7,Positive,10,1,11
1122440,0,1 user reviews,1,0,1
1122460,0,1 user reviews,0,1,1
1122490,0,7 user reviews,6,1,7
1122510,0,4 user reviews,3,1,4
1122540,0,2 user reviews,2,0,2
1122565,0,1 user reviews,0,1,1
1122611,0,1 user reviews,0,1,1
1122629,0,1 user reviews,1,0,1
1122633,0,1 user reviews,1,0,1
1122654,0,1 user reviews,1,0,1
1122660,0,1 user reviews,1,0,1
1122661,0,1 user reviews,1,0,1
1122662,0,1 user reviews,1,0,1
1122664,0,1 user reviews,1,0,1
1122710,0,2 user reviews,0,2,2
1122720,9,Overwhelmingly Positive,1351,47,1398
1122740,0,2 user reviews,2,0,2
1122780,0,9 user reviews,7,2,9
1122810,0,2 user reviews,2,0,2
1122830,0,5 user reviews,5,0,5
1122860,0,5 user reviews,2,3,5
1122920,0,3 user reviews,2,1,3
1122980,0,3 user reviews,1,2,3
1123000,0,3 user reviews,2,1,3
1123030,0,8 user reviews,8,0,8
1123060,0,3 user reviews,2,1,3
1123070,0,1 user reviews,1,0,1
1123080,0,1 user reviews,1,0,1
1123140,5,Mixed,21,11,32
1123190,0,1 user reviews,1,0,1
1123230,7,Positive,16,1,17
1123270,0,7 user reviews,6,1,7
1123310,0,2 user reviews,2,0,2
1123340,0,2 user reviews,2,0,2
1123400,0,3 user reviews,3,0,3
1123410,0,1 user reviews,0,1,1
1123441,0,1 user reviews,1,0,1
1123500,0,3 user reviews,1,2,3
1123540,0,5 user reviews,3,2,5
1123550,0,4 user reviews,2,2,4
1123610,0,4 user reviews,0,4,4
1123620,0,2 user reviews,2,0,2
1123650,0,4 user reviews,2,2,4
1123770,8,Very Positive,734,77,811
1123790,6,Mostly Positive,9,3,12
1123870,0,3 user reviews,1,2,3
1123890,0,1 user reviews,1,0,1
1123900,0,1 user reviews,1,0,1
1123910,0,1 user reviews,0,1,1
1123950,0,3 user reviews,2,1,3
1124030,0,2 user reviews,2,0,2
1124050,5,Mixed,10,7,17
1124060,7,Positive,20,1,21
1124114,0,1 user reviews,1,0,1
1124140,0,3 user reviews,3,0,3
1124153,0,2 user reviews,2,0,2
1124154,0,1 user reviews,0,1,1
1124155,0,1 user reviews,0,1,1
1124190,0,4 user reviews,3,1,4
1124210,0,1 user reviews,1,0,1
1124270,0,1 user reviews,0,1,1
1124310,0,1 user reviews,1,0,1
1124380,0,1 user reviews,1,0,1
1124390,0,4 user reviews,3,1,4
1124400,0,3 user reviews,1,2,3
1124410,0,2 user reviews,2,0,2
1124430,0,6 user reviews,5,1,6
1124510,0,1 user reviews,0,1,1
1124530,5,Mixed,7,10,17
1124540,0,7 user reviews,6,1,7
1124541,0,8 user reviews,8,0,8
1124550,0,1 user reviews,1,0,1
1124560,7,Positive,8,2,10
1124630,0,1 user reviews,1,0,1
1124660,8,Very Positive,182,24,206
1124710,0,5 user reviews,4,1,5
1124790,0,1 user reviews,0,1,1
1124830,7,Positive,11,0,11
1124860,0,1 user reviews,1,0,1
1124910,0,4 user reviews,4,0,4
1124950,0,1 user reviews,1,0,1
1124960,0,1 user reviews,1,0,1
1124980,0,2 user reviews,2,0,2
1124990,0,9 user reviews,9,0,9
1125000,0,1 user reviews,1,0,1
1125020,5,Mixed,58,54,112
1125030,0,4 user reviews,0,4,4
1125050,0,1 user reviews,0,1,1
1125060,0,2 user reviews,2,0,2
1125090,7,Positive,12,0,12
1125100,0,4 user reviews,3,1,4
1125110,7,Positive,37,5,42
1125130,0,2 user reviews,1,1,2
1125210,7,Positive,17,2,19
1125250,0,8 user reviews,6,2,8
1125260,7,Positive,11,1,12
1125270,7,Positive,16,2,18
1125330,8,Very Positive,84,16,100
1125340,0,2 user reviews,2,0,2
1125350,0,3 user reviews,3,0,3
1125360,0,6 user reviews,6,0,6
1125370,0,4 user reviews,4,0,4
1125400,0,6 user reviews,6,0,6
1125420,0,6 user reviews,6,0,6
1125450,0,1 user reviews,1,0,1
1125480,0,1 user reviews,0,1,1
1125490,0,6 user reviews,4,2,6
1125600,0,1 user reviews,0,1,1
1125630,5,Mixed,30,19,49
1125642,0,1 user reviews,0,1,1
1125760,7,Positive,9,1,10
1125770,0,1 user reviews,0,1,1
1125790,0,2 user reviews,2,0,2
1125800,0,4 user reviews,4,0,4
1125820,0,2 user reviews,2,0,2
1125860,7,Positive,19,0,19
1125900,0,3 user reviews,2,1,3
1125930,7,Positive,10,0,10
1126050,6,Mostly Positive,96,28,124
1126060,0,4 user reviews,4,0,4
1126070,0,4 user reviews,4,0,4
1126090,0,1 user reviews,1,0,1
1126100,0,1 user reviews,0,1,1
1126130,0,6 user reviews,5,1,6
1126190,5,Mixed,20,9,29
1126200,8,Very Positive,62,4,66
1126220,0,6 user reviews,3,3,6
1126270,7,Positive,26,1,27
1126290,6,Mostly Positive,148,43,191
1126300,0,2 user reviews,1,1,2
1126310,7,Positive,11,0,11
1126320,9,Overwhelmingly Positive,1556,34,1590
1126340,0,4 user reviews,3,1,4
1126420,8,Very Positive,68,8,76
1126440,0,3 user reviews,2,1,3
1126470,7,Positive,11,1,12
1126550,0,1 user reviews,1,0,1
1126560,0,4 user reviews,1,3,4
1126570,0,2 user reviews,1,1,2
1126600,7,Positive,20,1,21
1126710,0,8 user reviews,7,1,8
1126750,7,Positive,22,1,23
1126770,4,Mostly Negative,5,9,14
1126820,0,1 user reviews,1,0,1
1126840,0,3 user reviews,2,1,3
1126850,0,4 user reviews,4,0,4
1126860,0,1 user reviews,1,0,1
1126890,7,Positive,35,5,40
1126930,0,3 user reviews,3,0,3
1126950,0,2 user reviews,2,0,2
1126990,6,Mostly Positive,59,18,77
1127070,7,Positive,34,8,42
1127100,0,1 user reviews,1,0,1
1127120,0,1 user reviews,1,0,1
1127130,0,2 user reviews,2,0,2
1127170,0,3 user reviews,1,2,3
1127180,0,2 user reviews,1,1,2
1127190,8,Very Positive,237,36,273
1127200,0,1 user reviews,1,0,1
1127210,0,1 user reviews,1,0,1
1127230,0,1 user reviews,1,0,1
1127270,0,1 user reviews,1,0,1
1127290,0,6 user reviews,3,3,6
1127310,5,Mixed,24,13,37
1127350,0,2 user reviews,1,1,2
1127390,7,Positive,8,2,10
1127400,9,Overwhelmingly Positive,2904,73,2977
1127410,0,1 user reviews,1,0,1
1127411,0,1 user reviews,1,0,1
1127412,0,1 user reviews,1,0,1
1127420,0,1 user reviews,0,1,1
1127450,7,Positive,35,3,38
1127460,5,Mixed,300,297,597
1127480,0,1 user reviews,1,0,1
1127520,0,1 user reviews,1,0,1
1127530,0,1 user reviews,1,0,1
1127540,0,8 user reviews,7,1,8
1127580,0,1 user reviews,1,0,1
1127600,0,3 user reviews,2,1,3
1127610,8,Very Positive,74,7,81
1127680,7,Positive,25,0,25
1127690,0,1 user reviews,0,1,1
1127730,0,3 user reviews,2,1,3
1127800,0,1 user reviews,1,0,1
1127820,0,3 user reviews,2,1,3
1127840,8,Very Positive,277,34,311
1127850,8,Very Positive,63,0,63
1127860,0,5 user reviews,4,1,5
1127870,0,3 user reviews,2,1,3
1127880,0,2 user reviews,2,0,2
1127900,0,9 user reviews,7,2,9
1127920,0,1 user reviews,0,1,1
1127930,0,8 user reviews,5,3,8
1127980,8,Very Positive,513,106,619
1128000,5,Mixed,1652,2273,3925
1128020,7,Positive,21,1,22
1128070,0,1 user reviews,1,0,1
1128080,0,2 user reviews,1,1,2
1128100,7,Positive,20,5,25
1128140,5,Mixed,18,8,26
1128150,0,1 user reviews,0,1,1
1128160,0,1 user reviews,0,1,1
1128170,0,4 user reviews,3,1,4
1128180,7,Positive,41,5,46
1128190,7,Positive,26,6,32
1128200,0,1 user reviews,1,0,1
1128210,0,7 user reviews,6,1,7
1128220,0,9 user reviews,7,2,9
1128260,7,Positive,12,1,13
1128270,0,4 user reviews,3,1,4
1128310,0,1 user reviews,0,1,1
1128350,0,1 user reviews,0,1,1
1128370,0,1 user reviews,1,0,1
1128400,0,1 user reviews,1,0,1
1128420,0,2 user reviews,2,0,2
1128430,0,1 user reviews,1,0,1
1128440,0,3 user reviews,3,0,3
1128450,0,2 user reviews,2,0,2
1128510,0,1 user reviews,1,0,1
1128520,0,6 user reviews,6,0,6
1128540,4,Mostly Negative,26,56,82
1128550,0,2 user reviews,1,1,2
1128570,0,6 user reviews,6,0,6
1128610,0,6 user reviews,6,0,6
1128630,0,1 user reviews,1,0,1
1128660,0,1 user reviews,0,1,1
1128690,7,Positive,44,2,46
1128770,0,2 user reviews,2,0,2
1128800,5,Mixed,11,14,25
1128810,7,Positive,18,0,18
1128830,0,2 user reviews,2,0,2
1128840,0,3 user reviews,2,1,3
1128880,7,Positive,9,1,10
1128900,5,Mixed,28,16,44
1129010,8,Very Positive,98,17,115
1129030,0,9 user reviews,7,2,9
1129040,0,4 user reviews,4,0,4
1129050,7,Positive,28,4,32
1129080,0,2 user reviews,1,1,2
1129090,7,Positive,17,2,19
1129180,0,2 user reviews,2,0,2
1129200,0,1 user reviews,0,1,1
1129220,8,Very Positive,214,22,236
1129240,0,2 user reviews,2,0,2
1129250,7,Positive,17,0,17
1129310,8,Very Positive,923,113,1036
1129330,0,6 user reviews,6,0,6
1129350,0,6 user reviews,6,0,6
1129470,0,1 user reviews,1,0,1
1129580,8,Very Positive,3316,308,3624
1129660,6,Mostly Positive,21,6,27
1129680,0,5 user reviews,4,1,5
1129690,0,5 user reviews,5,0,5
1129720,0,2 user reviews,2,0,2
1129730,7,Positive,8,2,10
1129920,8,Very Positive,114,1,115
1130400,0,7 user reviews,5,2,7
1130410,8,Very Positive,107,2,109
1130430,0,2 user reviews,2,0,2
1130510,0,6 user reviews,5,1,6
1130560,6,Mostly Positive,32,9,41
1130570,0,6 user reviews,6,0,6
1130590,0,5 user reviews,3,2,5
1130620,8,Very Positive,84,11,95
1130630,7,Positive,20,1,21
1130690,0,1 user reviews,1,0,1
1130710,0,4 user reviews,3,1,4
1130720,0,5 user reviews,3,2,5
1130750,0,1 user reviews,1,0,1
1130770,0,4 user reviews,3,1,4
1130780,0,1 user reviews,1,0,1
1130790,0,1 user reviews,0,1,1
1130800,0,2 user reviews,1,1,2
1130810,0,2 user reviews,1,1,2
1130840,0,6 user reviews,5,1,6
1130880,0,5 user reviews,5,0,5
1130990,0,5 user reviews,5,0,5
1131050,0,8 user reviews,6,2,8
1131110,0,2 user reviews,2,0,2
1131160,0,1 user reviews,0,1,1
1131170,7,Positive,29,6,35
1131240,6,Mostly Positive,68,18,86
1131270,0,4 user reviews,3,1,4
1131280,0,1 user reviews,0,1,1
1131330,0,8 user reviews,6,2,8
1131400,5,Mixed,34,15,49
1131410,7,Positive,19,0,19
1131420,0,5 user reviews,0,5,5
1131430,0,1 user reviews,1,0,1
1131450,5,Mixed,7,4,11
1131520,0,3 user reviews,3,0,3
1131530,7,Positive,11,0,11
1131540,0,4 user reviews,4,0,4
1131580,0,1 user reviews,1,0,1
1131640,0,1 user reviews,1,0,1
1131660,0,1 user reviews,1,0,1
1131680,0,3 user reviews,2,1,3
1131720,0,4 user reviews,3,1,4
1131740,0,2 user reviews,2,0,2
1131750,7,Positive,27,1,28
1131780,0,1 user reviews,1,0,1
1131790,0,1 user reviews,1,0,1
1131810,0,4 user reviews,2,2,4
1131900,7,Positive,24,3,27
1131910,0,1 user reviews,1,0,1
1131930,0,5 user reviews,5,0,5
1131940,0,1 user reviews,1,0,1
1131990,0,4 user reviews,1,3,4
1132010,0,3 user reviews,1,2,3
1132060,0,1 user reviews,1,0,1
1132070,7,Positive,11,1,12
1132080,0,7 user reviews,4,3,7
1132090,0,5 user reviews,4,1,5
1132100,7,Positive,29,6,35
1132110,0,7 user reviews,6,1,7
1132120,7,Positive,22,3,25
1132160,0,6 user reviews,6,0,6
1132190,0,2 user reviews,2,0,2
1132210,6,Mostly Positive,632,255,887
1132220,0,6 user reviews,6,0,6
1132230,0,2 user reviews,1,1,2
1132240,0,3 user reviews,2,1,3
1132290,0,3 user reviews,2,1,3
1132300,0,1 user reviews,0,1,1
1132410,4,Mostly Negative,4,8,12
1132460,0,3 user reviews,2,1,3
1132510,0,2 user reviews,2,0,2
1132540,0,3 user reviews,2,1,3
1132600,0,4 user reviews,2,2,4
1132620,0,3 user reviews,3,0,3
1132640,0,1 user reviews,1,0,1
1132700,0,3 user reviews,3,0,3
1132710,7,Positive,19,3,22
1132730,0,8 user reviews,7,1,8
1132750,0,5 user reviews,2,3,5
1132840,0,1 user reviews,0,1,1
1132850,0,1 user reviews,1,0,1
1132871,0,1 user reviews,1,0,1
1132873,0,1 user reviews,1,0,1
1132920,0,1 user reviews,0,1,1
1132930,0,2 user reviews,2,0,2
1133000,8,Very Positive,53,13,66
1133020,7,Positive,16,4,20
1133070,7,Positive,16,3,19
1133200,0,1 user reviews,1,0,1
1133210,0,7 user reviews,6,1,7
1133230,0,9 user reviews,4,5,9
1133250,0,1 user reviews,1,0,1
1133260,0,3 user reviews,3,0,3
1133310,0,3 user reviews,2,1,3
1133320,8,Very Positive,134,25,159
1133330,5,Mixed,28,16,44
1133350,0,4 user reviews,1,3,4
1133420,5,Mixed,13,8,21
1133450,7,Positive,8,2,10
1133520,0,1 user reviews,1,0,1
1133550,0,1 user reviews,1,0,1
1133551,0,1 user reviews,1,0,1
1133580,7,Positive,28,2,30
1133590,8,Very Positive,64,3,67
1133770,6,Mostly Positive,33,10,43
1133780,0,2 user reviews,2,0,2
1133790,7,Positive,17,1,18
1133890,0,2 user reviews,2,0,2
1133930,7,Positive,20,4,24
1133950,0,3 user reviews,3,0,3
1133970,0,2 user reviews,2,0,2
1133980,0,1 user reviews,1,0,1
1133990,7,Positive,14,1,15
1134010,5,Mixed,9,9,18
1134040,0,1 user reviews,1,0,1
1134050,0,2 user reviews,1,1,2
1134120,0,1 user reviews,1,0,1
1134140,0,1 user reviews,1,0,1
1134160,7,Positive,17,0,17
1134180,7,Positive,21,4,25
1134190,0,6 user reviews,6,0,6
1134200,6,Mostly Positive,10,3,13
1134250,0,5 user reviews,4,1,5
1134360,0,5 user reviews,2,3,5
1134370,0,1 user reviews,1,0,1
1134380,0,4 user reviews,4,0,4
1134384,0,1 user reviews,1,0,1
1134387,0,4 user reviews,4,0,4
1134390,0,1 user reviews,0,1,1
1134400,0,1 user reviews,1,0,1
1134408,0,1 user reviews,1,0,1
1134410,0,2 user reviews,2,0,2
1134419,0,1 user reviews,1,0,1
1134432,0,2 user reviews,2,0,2
1134470,0,2 user reviews,2,0,2
1134480,5,Mixed,23,15,38
1134500,0,1 user reviews,0,1,1
1134520,7,Positive,34,7,41
1134630,0,9 user reviews,8,1,9
1135030,0,3 user reviews,2,1,3
1135040,0,4 user reviews,3,1,4
1135050,0,4 user reviews,2,2,4
1135060,0,5 user reviews,4,1,5
1135070,0,3 user reviews,1,2,3
1135090,0,8 user reviews,8,0,8
1135100,0,2 user reviews,0,2,2
1135110,0,4 user reviews,4,0,4
1135120,0,1 user reviews,0,1,1
1135130,0,6 user reviews,3,3,6
1135140,0,3 user reviews,0,3,3
1135150,0,3 user reviews,2,1,3
1135160,0,1 user reviews,0,1,1
1135170,0,1 user reviews,1,0,1
1135180,0,8 user reviews,6,2,8
1135190,0,2 user reviews,0,2,2
1135200,0,1 user reviews,1,0,1
1135210,0,5 user reviews,2,3,5
1135240,4,Mostly Negative,66,236,302
1135280,8,Very Positive,308,36,344
1135370,0,6 user reviews,5,1,6
1135380,0,1 user reviews,0,1,1
1135400,5,Mixed,9,8,17
1135410,0,2 user reviews,1,1,2
1135430,7,Positive,18,2,20
1135431,7,Positive,12,0,12
1135432,5,Mixed,9,11,20
1135433,7,Positive,21,0,21
1135434,7,Positive,9,1,10
1135435,0,8 user reviews,8,0,8
1135436,7,Positive,14,0,14
1135437,7,Positive,10,1,11
1135438,7,Positive,11,2,13
1135450,0,7 user reviews,6,1,7
1135520,0,1 user reviews,1,0,1
1135570,0,1 user reviews,1,0,1
1135640,0,1 user reviews,1,0,1
1135730,0,1 user reviews,1,0,1
1135740,7,Positive,19,4,23
1135750,0,1 user reviews,1,0,1
1135830,7,Positive,45,3,48
1135860,0,3 user reviews,2,1,3
1135900,0,6 user reviews,5,1,6
1135910,5,Mixed,46,28,74
1135960,8,Very Positive,54,8,62
1135970,0,1 user reviews,1,0,1
1135971,0,4 user reviews,4,0,4
1135972,0,4 user reviews,4,0,4
1136000,0,2 user reviews,2,0,2
1136001,0,2 user reviews,2,0,2
1136002,0,2 user reviews,2,0,2
1136010,0,1 user reviews,0,1,1
1136020,7,Positive,14,3,17
1136040,0,4 user reviews,4,0,4
1136070,0,9 user reviews,7,2,9
1136080,0,5 user reviews,5,0,5
1136090,0,2 user reviews,2,0,2
1136100,0,1 user reviews,1,0,1
1136110,0,8 user reviews,1,7,8
1136150,0,5 user reviews,2,3,5
1136160,6,Mostly Positive,463,166,629
1136310,0,1 user reviews,1,0,1
1136311,0,1 user reviews,1,0,1
1136313,0,1 user reviews,1,0,1
1136330,7,Positive,43,3,46
1136390,0,8 user reviews,2,6,8
1136420,0,1 user reviews,1,0,1
1136440,5,Mixed,7,9,16
1136820,0,1 user reviews,1,0,1
1136830,0,2 user reviews,1,1,2
1136880,7,Positive,16,0,16
1136910,6,Mostly Positive,7,3,10
1136930,0,3 user reviews,2,1,3
1136960,0,2 user reviews,2,0,2
1137020,7,Positive,29,3,32
1137040,0,2 user reviews,2,0,2
1137050,0,2 user reviews,1,1,2
1137110,0,7 user reviews,6,1,7
1137210,0,1 user reviews,1,0,1
1137220,0,1 user reviews,0,1,1
1137230,0,1 user reviews,0,1,1
1137250,0,1 user reviews,0,1,1
1137260,0,4 user reviews,1,3,4
1137330,7,Positive,9,1,10
1137350,8,Very Positive,150,8,158
1137360,0,1 user reviews,1,0,1
1137400,6,Mostly Positive,24,7,31
1137410,8,Very Positive,163,8,171
1137470,8,Very Positive,56,14,70
1137490,5,Mixed,42,23,65
1137532,0,1 user reviews,1,0,1
1137533,0,2 user reviews,2,0,2
1137540,0,5 user reviews,3,2,5
1137620,0,6 user reviews,4,2,6
1137640,0,2 user reviews,2,0,2
1137641,5,Mixed,15,21,36
1137660,0,3 user reviews,3,0,3
1137670,0,1 user reviews,0,1,1
1137680,0,1 user reviews,1,0,1
1137730,0,7 user reviews,5,2,7
1137770,0,4 user reviews,1,3,4
1137800,7,Positive,25,4,29
1137801,7,Positive,25,5,30
1137940,7,Positive,18,2,20
1138060,0,5 user reviews,1,4,5
1138080,5,Mixed,8,7,15
1138100,7,Positive,34,1,35
1138130,0,1 user reviews,1,0,1
1138150,0,2 user reviews,0,2,2
1138260,0,6 user reviews,6,0,6
1138280,0,1 user reviews,0,1,1
1138290,0,1 user reviews,1,0,1
1138300,0,2 user reviews,1,1,2
1138310,0,1 user reviews,1,0,1
1138320,0,3 user reviews,0,3,3
1138370,0,3 user reviews,3,0,3
1138400,5,Mixed,8,7,15
1138410,7,Positive,18,1,19
1138490,0,8 user reviews,8,0,8
1138580,7,Positive,43,4,47
1138630,0,4 user reviews,3,1,4
1138810,0,2 user reviews,1,1,2
1138910,7,Positive,17,0,17
1138960,7,Positive,22,0,22
1138970,7,Positive,14,2,16
1138990,0,2 user reviews,2,0,2
1139020,0,4 user reviews,2,2,4
1139080,6,Mostly Positive,57,15,72
1139100,0,1 user reviews,1,0,1
1139110,7,Positive,34,3,37
1139130,0,1 user reviews,0,1,1
1139140,7,Positive,10,1,11
1139240,0,5 user reviews,5,0,5
1139470,0,5 user reviews,4,1,5
1139480,0,7 user reviews,5,2,7
1139680,0,3 user reviews,3,0,3
1139760,0,5 user reviews,5,0,5
1139800,7,Positive,10,0,10
1139830,0,2 user reviews,1,1,2
1139852,0,1 user reviews,1,0,1
1139860,0,1 user reviews,1,0,1
1139870,5,Mixed,23,34,57
1139880,0,7 user reviews,7,0,7
1139890,8,Very Positive,310,13,323
1139900,8,Very Positive,1726,248,1974
1139930,0,3 user reviews,3,0,3
1139940,8,Very Positive,115,16,131
1139950,0,9 user reviews,7,2,9
1139980,8,Very Positive,379,18,397
1139990,0,2 user reviews,2,0,2
1140000,6,Mostly Positive,113,44,157
1140001,6,Mostly Positive,275,86,361
1140020,0,2 user reviews,0,2,2
1140030,6,Mostly Positive,10,4,14
1140070,0,2 user reviews,1,1,2
1140100,6,Mostly Positive,19,7,26
1140110,0,3 user reviews,1,2,3
1140120,0,2 user reviews,2,0,2
1140130,6,Mostly Positive,24,8,32
1140140,0,3 user reviews,2,1,3
1140260,0,1 user reviews,1,0,1
1140270,9,Overwhelmingly Positive,861,7,868
1140290,8,Very Positive,257,29,286
1140360,0,1 user reviews,1,0,1
1140400,0,2 user reviews,1,1,2
1140410,0,2 user reviews,0,2,2
1140420,0,3 user reviews,2,1,3
1140440,5,Mixed,47,22,69
1140460,7,Positive,15,0,15
1140500,0,9 user reviews,3,6,9
1140520,0,2 user reviews,2,0,2
1140530,0,1 user reviews,1,0,1
1140570,7,Positive,18,1,19
1140590,0,2 user reviews,2,0,2
1140610,0,5 user reviews,5,0,5
1140640,0,2 user reviews,2,0,2
1140690,0,4 user reviews,4,0,4
1140720,0,1 user reviews,1,0,1
1140880,6,Mostly Positive,9,3,12
1140900,0,1 user reviews,0,1,1
1140970,0,3 user reviews,1,2,3
1141070,0,1 user reviews,1,0,1
1141100,7,Positive,25,3,28
1141130,7,Positive,16,0,16
1141150,0,2 user reviews,1,1,2
1141160,0,1 user reviews,1,0,1
1141170,0,1 user reviews,0,1,1
1141180,0,2 user reviews,2,0,2
1141220,8,Very Positive,398,77,475
1141290,7,Positive,25,1,26
1141300,0,2 user reviews,2,0,2
1141360,7,Positive,8,2,10
1141380,0,2 user reviews,1,1,2
1141390,0,1 user reviews,1,0,1
1141450,0,8 user reviews,7,1,8
1141530,0,1 user reviews,0,1,1
1141570,0,6 user reviews,6,0,6
1141600,0,3 user reviews,2,1,3
1141640,0,1 user reviews,0,1,1
1141650,7,Positive,13,2,15
1141710,0,4 user reviews,4,0,4
1141711,0,9 user reviews,8,1,9
1141790,0,1 user reviews,1,0,1
1141810,0,2 user reviews,2,0,2
1141811,0,2 user reviews,1,1,2
1141840,0,1 user reviews,1,0,1
1141870,0,2 user reviews,2,0,2
1141880,0,5 user reviews,5,0,5
1141930,5,Mixed,11,6,17
1141950,0,8 user reviews,4,4,8
1141960,7,Positive,33,1,34
1141980,5,Mixed,8,6,14
1141990,0,9 user reviews,6,3,9
1142070,0,5 user reviews,2,3,5
1142090,0,3 user reviews,3,0,3
1142100,5,Mixed,86,40,126
1142130,0,1 user reviews,1,0,1
1142220,5,Mixed,18,9,27
1142230,0,2 user reviews,2,0,2
1142240,0,1 user reviews,1,0,1
1142250,0,4 user reviews,4,0,4
1142270,7,Positive,16,4,20
1142290,0,1 user reviews,1,0,1
1142300,0,7 user reviews,7,0,7
1142320,0,2 user reviews,2,0,2
1142330,5,Mixed,19,16,35
1142360,0,6 user reviews,4,2,6
1142390,5,Mixed,53,46,99
1142410,6,Mostly Positive,11,3,14
1142470,0,7 user reviews,4,3,7
1142480,7,Positive,15,2,17
1142500,8,Very Positive,1230,96,1326
1142550,0,9 user reviews,8,1,9
1142750,0,1 user reviews,1,0,1
1142800,7,Positive,13,2,15
1142810,7,Positive,18,0,18
1142830,7,Positive,23,0,23
1142850,0,5 user reviews,4,1,5
1142870,0,4 user reviews,0,4,4
1142880,5,Mixed,31,36,67
1142900,0,2 user reviews,1,1,2
1142920,0,1 user reviews,0,1,1
1143170,0,4 user reviews,3,1,4
1143320,0,1 user reviews,1,0,1
1143330,0,1 user reviews,1,0,1
1143350,7,Positive,17,1,18
1143390,0,3 user reviews,3,0,3
1143400,7,Positive,24,6,30
1143430,0,6 user reviews,5,1,6
1143440,0,6 user reviews,6,0,6
1143460,0,3 user reviews,2,1,3
1143510,0,1 user reviews,1,0,1
1143520,0,2 user reviews,2,0,2
1143550,0,1 user reviews,1,0,1
1143570,0,3 user reviews,3,0,3
1143650,5,Mixed,55,39,94
1143680,0,8 user reviews,8,0,8
1143710,0,4 user reviews,3,1,4
1143720,0,3 user reviews,2,1,3
1143740,0,3 user reviews,3,0,3
1143750,7,Positive,14,1,15
1143780,0,2 user reviews,2,0,2
1143800,0,7 user reviews,6,1,7
1143820,0,9 user reviews,5,4,9
1143840,8,Very Positive,170,17,187
1143850,0,7 user reviews,7,0,7
1143851,0,6 user reviews,5,1,6
1143852,0,6 user reviews,6,0,6
1143853,7,Positive,12,2,14
1143890,7,Positive,13,3,16
1143900,0,1 user reviews,1,0,1
1143977,0,1 user reviews,1,0,1
1143978,0,1 user reviews,1,0,1
1144020,8,Very Positive,123,6,129
1144030,8,Very Positive,690,38,728
1144060,0,1 user reviews,0,1,1
1144070,0,5 user reviews,2,3,5
1144100,0,6 user reviews,6,0,6
1144110,0,4 user reviews,4,0,4
1144140,7,Positive,9,1,10
1144150,7,Positive,20,0,20
1144180,0,6 user reviews,6,0,6
1144250,8,Very Positive,154,38,192
1144270,0,2 user reviews,2,0,2
1144280,7,Positive,33,0,33
1144290,0,1 user reviews,1,0,1
1144300,0,5 user reviews,4,1,5
1144310,0,5 user reviews,5,0,5
1144330,7,Positive,9,1,10
1144350,0,2 user reviews,1,1,2
1144400,8,Very Positive,187,7,194
1144410,6,Mostly Positive,114,31,145
1144420,7,Positive,41,6,47
1144440,7,Positive,30,6,36
1144450,0,1 user reviews,1,0,1
1144460,7,Positive,9,2,11
1144480,0,4 user reviews,4,0,4
1144490,0,3 user reviews,3,0,3
1144500,0,5 user reviews,5,0,5
1144510,0,6 user reviews,5,1,6
1144520,0,2 user reviews,0,2,2
1144550,0,3 user reviews,1,2,3
1144590,0,4 user reviews,4,0,4
1144630,0,2 user reviews,2,0,2
1144640,6,Mostly Positive,13,5,18
1144643,0,6 user reviews,2,4,6
1144645,0,4 user reviews,2,2,4
1144646,5,Mixed,36,38,74
1144690,0,1 user reviews,1,0,1
1144750,0,2 user reviews,2,0,2
1144780,0,2 user reviews,1,1,2
1144860,7,Positive,9,1,10
1144910,8,Very Positive,50,0,50
1144943,0,1 user reviews,0,1,1
1144944,0,2 user reviews,1,1,2
1144970,6,Mostly Positive,82,28,110
1145030,0,3 user reviews,3,0,3
1145040,0,6 user reviews,1,5,6
1145180,0,1 user reviews,1,0,1
1145210,0,1 user reviews,0,1,1
1145250,6,Mostly Positive,43,17,60
1145280,0,1 user reviews,1,0,1
1145360,9,Overwhelmingly Positive,25853,272,26125
1145380,0,3 user reviews,3,0,3
1145410,7,Positive,27,2,29
1145430,0,1 user reviews,0,1,1
1145450,0,6 user reviews,5,1,6
1145460,0,3 user reviews,0,3,3
1145520,0,2 user reviews,2,0,2
1145530,0,2 user reviews,2,0,2
1145560,7,Positive,13,1,14
1145570,6,Mostly Positive,19,7,26
1145580,0,1 user reviews,0,1,1
1145590,0,1 user reviews,0,1,1
1145660,6,Mostly Positive,196,60,256
1145680,0,2 user reviews,2,0,2
1145740,0,9 user reviews,6,3,9
1145760,0,1 user reviews,1,0,1
1145780,7,Positive,8,2,10
1145810,0,5 user reviews,3,2,5
1145820,0,5 user reviews,2,3,5
1145851,0,1 user reviews,1,0,1
1145860,0,1 user reviews,0,1,1
1145960,8,Very Positive,512,66,578
1145970,0,5 user reviews,5,0,5
1145990,0,1 user reviews,0,1,1
1146010,5,Mixed,16,12,28
1146090,0,1 user reviews,1,0,1
1146100,6,Mostly Positive,45,15,60
1146160,0,1 user reviews,1,0,1
1146170,7,Positive,24,3,27
1146210,0,3 user reviews,3,0,3
1146230,8,Very Positive,106,9,115
1146250,0,2 user reviews,1,1,2
1146260,0,3 user reviews,3,0,3
1146310,8,Very Positive,247,48,295
1146320,0,2 user reviews,1,1,2
1146350,0,1 user reviews,0,1,1
1146370,8,Very Positive,147,4,151
1146390,0,1 user reviews,1,0,1
1146510,7,Positive,46,1,47
1146520,0,7 user reviews,4,3,7
1146521,0,1 user reviews,0,1,1
1146522,0,4 user reviews,2,2,4
1146523,0,4 user reviews,0,4,4
1146560,0,3 user reviews,3,0,3
1146600,7,Positive,35,7,42
1146630,8,Very Positive,264,20,284
1146680,0,1 user reviews,1,0,1
1146700,0,3 user reviews,2,1,3
1146720,5,Mixed,14,7,21
1146780,0,1 user reviews,1,0,1
1146790,0,2 user reviews,2,0,2
1146810,0,2 user reviews,1,1,2
1146830,5,Mixed,31,24,55
1146870,0,6 user reviews,0,6,6
1146880,0,6 user reviews,6,0,6
1146890,0,2 user reviews,2,0,2
1146910,0,4 user reviews,4,0,4
1146920,0,5 user reviews,3,2,5
1146930,5,Mixed,81,73,154
1146940,6,Mostly Positive,63,19,82
1146950,8,Very Positive,293,17,310
1146960,6,Mostly Positive,228,69,297
1146970,7,Positive,25,0,25
1147010,4,Mostly Negative,140,214,354
1147020,0,2 user reviews,1,1,2
1147030,0,5 user reviews,3,2,5
1147040,0,2 user reviews,2,0,2
1147100,5,Mixed,31,24,55
1147110,7,Positive,10,1,11
1147140,0,1 user reviews,0,1,1
1147152,0,3 user reviews,1,2,3
1147153,6,Mostly Positive,10,3,13
1147154,0,5 user reviews,5,0,5
1147155,0,3 user reviews,3,0,3
1147157,4,Mostly Negative,4,12,16
1147158,5,Mixed,9,4,13
1147159,0,2 user reviews,1,1,2
1147220,0,1 user reviews,1,0,1
1147280,0,4 user reviews,4,0,4
1147370,0,2 user reviews,1,1,2
1147381,0,2 user reviews,2,0,2
1147382,0,7 user reviews,7,0,7
1147450,5,Mixed,17,9,26
1147480,0,8 user reviews,7,1,8
1147490,7,Positive,16,3,19
1147500,7,Positive,20,1,21
1147510,8,Very Positive,325,44,369
1147520,0,1 user reviews,0,1,1
1147550,9,Overwhelmingly Positive,1881,60,1941
1147560,8,Very Positive,798,59,857
1147600,0,3 user reviews,3,0,3
1147620,0,1 user reviews,0,1,1
1147660,5,Mixed,1118,675,1793
1147670,5,Mixed,23,12,35
1147760,0,5 user reviews,4,1,5
1147770,6,Mostly Positive,14,4,18
1147840,0,1 user reviews,1,0,1
1147850,0,4 user reviews,4,0,4
1147940,8,Very Positive,148,7,155
1147960,6,Mostly Positive,70,19,89
1147970,8,Very Positive,54,12,66
1147980,0,2 user reviews,1,1,2
1148010,0,6 user reviews,3,3,6
1148020,5,Mixed,34,16,50
1148021,0,8 user reviews,6,2,8
1148022,5,Mixed,17,16,33
1148080,0,1 user reviews,1,0,1
1148090,0,5 user reviews,5,0,5
1148150,8,Very Positive,301,34,335
1148180,0,6 user reviews,6,0,6
1148260,0,2 user reviews,2,0,2
1148270,0,1 user reviews,1,0,1
1148290,0,2 user reviews,2,0,2
1148320,7,Positive,14,3,17
1148430,0,3 user reviews,2,1,3
1148450,7,Positive,18,2,20
1148460,0,1 user reviews,0,1,1
1148470,0,7 user reviews,6,1,7
1148500,0,3 user reviews,3,0,3
1148510,8,Very Positive,164,14,178
1148530,0,6 user reviews,2,4,6
1148540,0,1 user reviews,1,0,1
1148550,0,4 user reviews,3,1,4
1148590,8,Very Positive,1429,90,1519
1148620,0,5 user reviews,5,0,5
1148640,0,1 user reviews,1,0,1
1148650,6,Mostly Positive,2273,621,2894
1148670,0,2 user reviews,2,0,2
1148680,0,1 user reviews,1,0,1
1148700,7,Positive,24,5,29
1148710,0,1 user reviews,1,0,1
1148730,7,Positive,16,1,17
1148740,0,1 user reviews,1,0,1
1148810,8,Very Positive,74,9,83
1148830,0,1 user reviews,0,1,1
1148890,0,1 user reviews,0,1,1
1148910,5,Mixed,8,5,13
1148920,0,4 user reviews,2,2,4
1148930,0,5 user reviews,5,0,5
1148940,0,4 user reviews,3,1,4
1148960,0,6 user reviews,4,2,6
1148980,7,Positive,8,2,10
1149080,0,8 user reviews,5,3,8
1149090,0,3 user reviews,2,1,3
1149120,0,1 user reviews,0,1,1
1149190,0,1 user reviews,0,1,1
1149200,0,1 user reviews,0,1,1
1149210,0,1 user reviews,1,0,1
1149220,0,1 user reviews,1,0,1
1149370,0,2 user reviews,1,1,2
1149400,6,Mostly Positive,97,34,131
1149440,8,Very Positive,152,25,177
1149510,0,6 user reviews,6,0,6
1149540,0,2 user reviews,2,0,2
1149550,8,Very Positive,79,4,83
1149580,0,2 user reviews,2,0,2
1149590,0,5 user reviews,5,0,5
1149640,8,Very Positive,679,111,790
1149660,6,Mostly Positive,105,31,136
1149690,0,7 user reviews,7,0,7
1149700,0,1 user reviews,1,0,1
1149710,6,Mostly Positive,13,5,18
1149720,0,4 user reviews,4,0,4
1149860,7,Positive,12,0,12
1149900,0,1 user reviews,0,1,1
1149930,0,2 user reviews,2,0,2
1149940,8,Very Positive,112,18,130
1150030,5,Mixed,6,6,12
1150031,6,Mostly Positive,8,3,11
1150032,0,2 user reviews,1,1,2
1150033,0,3 user reviews,2,1,3
1150050,0,6 user reviews,5,1,6
1150070,0,5 user reviews,5,0,5
1150080,6,Mostly Positive,563,200,763
1150160,0,2 user reviews,1,1,2
1150190,6,Mostly Positive,31,11,42
1150195,0,2 user reviews,2,0,2
1150250,0,1 user reviews,1,0,1
1150270,0,1 user reviews,0,1,1
1150310,0,1 user reviews,0,1,1
1150320,0,1 user reviews,0,1,1
1150370,0,1 user reviews,1,0,1
1150380,0,4 user reviews,1,3,4
1150400,0,5 user reviews,5,0,5
1150460,7,Positive,45,2,47
1150480,0,2 user reviews,2,0,2
1150500,0,9 user reviews,3,6,9
1150540,0,1 user reviews,1,0,1
1150550,7,Positive,10,0,10
1150580,0,2 user reviews,0,2,2
1150590,8,Very Positive,279,56,335
1150610,0,2 user reviews,2,0,2
1150620,6,Mostly Positive,18,6,24
1150640,8,Very Positive,395,94,489
1150680,0,1 user reviews,1,0,1
1150720,8,Very Positive,92,4,96
1150730,7,Positive,38,5,43
1150790,0,4 user reviews,3,1,4
1150810,0,2 user reviews,2,0,2
1150890,6,Mostly Positive,43,11,54
1150930,0,2 user reviews,2,0,2
1150940,0,3 user reviews,3,0,3
1150950,8,Very Positive,253,12,265
1151070,7,Positive,13,3,16
1151080,0,1 user reviews,1,0,1
1151110,5,Mixed,23,10,33
1151120,7,Positive,35,8,43
1151160,0,3 user reviews,2,1,3
1151170,6,Mostly Positive,49,21,70
1151180,0,2 user reviews,1,1,2
1151200,7,Positive,8,2,10
1151250,7,Positive,26,3,29
1151340,6,Mostly Positive,4982,1299,6281
1151390,7,Positive,28,1,29
1151400,0,3 user reviews,1,2,3
1151430,0,2 user reviews,2,0,2
1151440,8,Very Positive,63,0,63
1151580,0,1 user reviews,1,0,1
1151600,0,4 user reviews,4,0,4
1151630,7,Positive,8,2,10
1151640,6,Mostly Positive,10883,3280,14163
1151650,0,3 user reviews,3,0,3
1151670,0,3 user reviews,2,1,3
1151680,7,Positive,12,0,12
1151700,5,Mixed,190,87,277
1151730,0,8 user reviews,6,2,8
1151740,7,Positive,22,1,23
1151750,0,9 user reviews,6,3,9
1151770,0,2 user reviews,1,1,2
1151840,0,4 user reviews,3,1,4
1151910,0,1 user reviews,1,0,1
1151940,0,1 user reviews,1,0,1
1151950,0,1 user reviews,0,1,1
1152020,7,Positive,28,6,34
1152040,0,2 user reviews,2,0,2
1152050,0,7 user reviews,4,3,7
1152090,8,Very Positive,87,17,104
1152160,6,Mostly Positive,10,4,14
1152300,7,Positive,31,3,34
1152310,7,Positive,15,2,17
1152320,7,Positive,10,1,11
1152360,0,5 user reviews,3,2,5
1152410,7,Positive,11,2,13
1152420,7,Positive,12,1,13
1152440,5,Mixed,8,4,12
1152450,0,9 user reviews,9,0,9
1152540,0,1 user reviews,0,1,1
1152550,0,1 user reviews,1,0,1
1152560,0,1 user reviews,0,1,1
1152580,7,Positive,12,0,12
1152640,0,1 user reviews,1,0,1
1152670,0,5 user reviews,5,0,5
1152700,0,2 user reviews,0,2,2
1152810,0,2 user reviews,1,1,2
1152820,0,3 user reviews,3,0,3
1152830,0,1 user reviews,1,0,1
1152840,0,3 user reviews,3,0,3
1152900,0,4 user reviews,4,0,4
1152920,0,1 user reviews,1,0,1
1153070,0,8 user reviews,6,2,8
1153110,0,2 user reviews,1,1,2
1153200,7,Positive,20,1,21
1153220,0,1 user reviews,1,0,1
1153250,0,8 user reviews,4,4,8
1153330,0,2 user reviews,2,0,2
1153351,0,1 user reviews,1,0,1
1153353,0,1 user reviews,1,0,1
1153420,0,1 user reviews,1,0,1
1153430,8,Very Positive,61,13,74
1153443,0,2 user reviews,1,1,2
1153460,7,Positive,10,1,11
1153470,0,4 user reviews,3,1,4
1153540,7,Positive,16,3,19
1153550,0,1 user reviews,0,1,1
1153600,0,1 user reviews,1,0,1
1153630,0,3 user reviews,3,0,3
1153670,0,8 user reviews,8,0,8
1153680,0,1 user reviews,0,1,1
1153690,0,3 user reviews,2,1,3
1153700,0,1 user reviews,0,1,1
1153730,0,2 user reviews,0,2,2
1153840,0,1 user reviews,1,0,1
1153860,0,2 user reviews,0,2,2
1153890,0,6 user reviews,0,6,6
1153930,0,2 user reviews,1,1,2
1153950,0,5 user reviews,3,2,5
1153980,7,Positive,13,0,13
1153990,0,2 user reviews,1,1,2
1154010,0,1 user reviews,0,1,1
1154060,0,1 user reviews,1,0,1
1154080,6,Mostly Positive,35,9,44
1154110,8,Very Positive,54,11,65
1154170,0,6 user reviews,4,2,6
1154210,0,1 user reviews,0,1,1
1154300,7,Positive,12,0,12
1154311,0,4 user reviews,2,2,4
1154320,6,Mostly Positive,26,7,33
1154340,0,4 user reviews,4,0,4
1154440,0,6 user reviews,6,0,6
1154480,0,3 user reviews,2,1,3
1154490,0,2 user reviews,2,0,2
1154560,0,1 user reviews,0,1,1
1154591,7,Positive,11,0,11
1154640,0,1 user reviews,1,0,1
1154650,0,6 user reviews,4,2,6
1154680,0,6 user reviews,5,1,6
1154700,0,8 user reviews,6,2,8
1154720,5,Mixed,9,5,14
1154730,5,Mixed,6,5,11
1154760,5,Mixed,178,81,259
1154770,0,5 user reviews,4,1,5
1154780,6,Mostly Positive,17,5,22
1154810,8,Very Positive,200,13,213
1154850,8,Very Positive,154,11,165
1154940,0,7 user reviews,6,1,7
1154990,5,Mixed,6,5,11
1155030,0,2 user reviews,2,0,2
1155070,0,4 user reviews,4,0,4
1155090,0,1 user reviews,1,0,1
1155130,0,4 user reviews,4,0,4
1155230,0,2 user reviews,1,1,2
1155270,7,Positive,13,1,14
1155290,0,1 user reviews,1,0,1
1155320,7,Positive,20,3,23
1155340,0,2 user reviews,2,0,2
1155410,0,8 user reviews,7,1,8
1155420,0,5 user reviews,3,2,5
1155430,0,4 user reviews,3,1,4
1155440,0,2 user reviews,1,1,2
1155460,5,Mixed,8,7,15
1155480,0,4 user reviews,1,3,4
1155490,0,2 user reviews,0,2,2
1155500,0,2 user reviews,0,2,2
1155560,0,2 user reviews,2,0,2
1155620,0,2 user reviews,1,1,2
1155660,7,Positive,19,1,20
1155670,0,3 user reviews,2,1,3
1155680,0,4 user reviews,1,3,4
1155700,7,Positive,31,7,38
1155720,7,Positive,29,1,30
1155760,0,9 user reviews,5,4,9
1155790,0,5 user reviews,5,0,5
1155800,0,3 user reviews,2,1,3
1155810,0,4 user reviews,2,2,4
1155830,7,Positive,17,4,21
1155880,5,Mixed,24,15,39
1155910,0,1 user reviews,0,1,1
1155920,0,2 user reviews,0,2,2
1155930,0,1 user reviews,1,0,1
1155940,0,8 user reviews,7,1,8
1155950,0,2 user reviews,0,2,2
1155960,0,4 user reviews,4,0,4
1155980,0,5 user reviews,4,1,5
1155990,0,6 user reviews,4,2,6
1156000,8,Very Positive,55,5,60
1156030,0,2 user reviews,0,2,2
1156050,0,9 user reviews,5,4,9
1156130,0,1 user reviews,0,1,1
1156160,0,1 user reviews,1,0,1
1156200,0,1 user reviews,0,1,1
1156250,7,Positive,30,5,35
1156360,7,Positive,45,2,47
1156420,0,1 user reviews,0,1,1
1156550,0,6 user reviews,5,1,6
1156590,7,Positive,36,7,43
1156630,7,Positive,10,1,11
1156640,0,1 user reviews,1,0,1
1156650,0,2 user reviews,1,1,2
1156670,0,6 user reviews,5,1,6
1156680,0,3 user reviews,2,1,3
1156710,0,4 user reviews,4,0,4
1156730,5,Mixed,12,7,19
1156740,0,1 user reviews,1,0,1
1156780,0,2 user reviews,2,0,2
1156810,0,1 user reviews,0,1,1
1156900,0,1 user reviews,1,0,1
1156910,0,2 user reviews,0,2,2
1156960,0,1 user reviews,1,0,1
1156980,0,4 user reviews,3,1,4
1156990,0,6 user reviews,6,0,6
1157010,0,4 user reviews,4,0,4
1157040,0,3 user reviews,2,1,3
1157080,0,2 user reviews,1,1,2
1157120,0,1 user reviews,0,1,1
1157170,0,9 user reviews,7,2,9
1157230,0,4 user reviews,4,0,4
1157260,0,7 user reviews,7,0,7
1157300,0,9 user reviews,9,0,9
1157310,0,5 user reviews,5,0,5
1157320,0,2 user reviews,2,0,2
1157340,6,Mostly Positive,201,53,254
1157350,0,2 user reviews,0,2,2
1157480,0,1 user reviews,0,1,1
1157550,8,Very Positive,53,7,60
1157620,6,Mostly Positive,14,6,20
1157640,6,Mostly Positive,18,5,23
1157650,0,3 user reviews,3,0,3
1157730,7,Positive,11,0,11
1157731,0,4 user reviews,4,0,4
1157732,0,4 user reviews,4,0,4
1157750,7,Positive,26,6,32
1157780,0,2 user reviews,2,0,2
1157790,5,Mixed,13,6,19
1157810,0,6 user reviews,6,0,6
1157820,0,1 user reviews,1,0,1
1157850,0,1 user reviews,1,0,1
1157890,0,1 user reviews,0,1,1
1157910,0,4 user reviews,4,0,4
1157940,5,Mixed,28,15,43
1157980,0,1 user reviews,1,0,1
1158010,6,Mostly Positive,16,5,21
1158100,4,Mostly Negative,277,429,706
1158111,0,1 user reviews,0,1,1
1158120,0,5 user reviews,4,1,5
1158130,0,1 user reviews,0,1,1
1158150,0,2 user reviews,2,0,2
1158180,6,Mostly Positive,158,52,210
1158200,0,8 user reviews,5,3,8
1158210,0,1 user reviews,1,0,1
1158230,0,1 user reviews,0,1,1
1158240,0,2 user reviews,2,0,2
1158260,7,Positive,10,0,10
1158270,0,4 user reviews,3,1,4
1158280,7,Positive,43,5,48
1158290,7,Positive,36,1,37
1158310,8,Very Positive,10448,842,11290
1158320,7,Positive,12,3,15
1158390,0,1 user reviews,0,1,1
1158410,7,Positive,10,0,10
1158430,0,2 user reviews,0,2,2
1158470,8,Very Positive,103,2,105
1158490,0,5 user reviews,4,1,5
1158500,5,Mixed,7,5,12
1158590,0,5 user reviews,0,5,5
1158650,0,1 user reviews,0,1,1
1158660,8,Very Positive,59,8,67
1158690,8,Very Positive,54,12,66
1158730,4,Mostly Negative,17,48,65
1158780,0,1 user reviews,1,0,1
1158830,0,1 user reviews,1,0,1
1158910,0,6 user reviews,5,1,6
1158940,8,Very Positive,132,30,162
1158970,6,Mostly Positive,14,4,18
1159010,0,2 user reviews,0,2,2
1159020,0,2 user reviews,1,1,2
1159030,0,8 user reviews,7,1,8
1159040,0,1 user reviews,0,1,1
1159060,4,Mostly Negative,10,25,35
1159130,0,1 user reviews,1,0,1
1159200,0,1 user reviews,1,0,1
1159310,0,1 user reviews,1,0,1
1159316,0,1 user reviews,1,0,1
1159323,0,2 user reviews,2,0,2
1159325,0,1 user reviews,1,0,1
1159329,0,2 user reviews,1,1,2
1159360,0,1 user reviews,1,0,1
1159450,7,Positive,14,1,15
1159480,0,1 user reviews,1,0,1
1159500,7,Positive,13,1,14
1159510,0,8 user reviews,5,3,8
1159520,6,Mostly Positive,69,22,91
1159530,0,1 user reviews,1,0,1
1159540,6,Mostly Positive,12,4,16
1159560,8,Very Positive,76,2,78
1159580,0,2 user reviews,1,1,2
1159590,0,3 user reviews,0,3,3
1159610,0,3 user reviews,3,0,3
1159640,8,Very Positive,371,61,432
1159680,0,9 user reviews,9,0,9
1159700,3,Negative,3,21,24
1159770,0,1 user reviews,1,0,1
1159890,0,1 user reviews,1,0,1
1159920,0,1 user reviews,0,1,1
1160020,7,Positive,13,1,14
1160050,0,4 user reviews,2,2,4
1160100,0,2 user reviews,2,0,2
1160140,0,1 user reviews,0,1,1
1160190,0,1 user reviews,1,0,1
1160220,8,Very Positive,288,10,298
1160243,7,Positive,8,2,10
1160330,8,Very Positive,140,3,143
1160360,5,Mixed,49,35,84
1160390,0,1 user reviews,1,0,1
1160440,0,7 user reviews,7,0,7
1160480,0,6 user reviews,1,5,6
1160490,8,Very Positive,196,2,198
1160500,0,9 user reviews,5,4,9
1160580,0,7 user reviews,4,3,7
1160610,0,1 user reviews,1,0,1
1160620,0,4 user reviews,4,0,4
1160670,0,3 user reviews,3,0,3
1160700,7,Positive,13,0,13
1160760,0,1 user reviews,1,0,1
1160780,0,2 user reviews,1,1,2
1160790,0,3 user reviews,3,0,3
1160800,0,1 user reviews,1,0,1
1160820,0,7 user reviews,7,0,7
1160870,0,7 user reviews,7,0,7
1160880,0,9 user reviews,7,2,9
1160900,0,2 user reviews,1,1,2
1160930,0,1 user reviews,0,1,1
1160950,5,Mixed,14,7,21
1160980,0,1 user reviews,1,0,1
1161120,0,1 user reviews,1,0,1
1161180,0,8 user reviews,8,0,8
1161190,0,3 user reviews,3,0,3
1161270,5,Mixed,23,11,34
1161300,0,1 user reviews,1,0,1
1161320,0,3 user reviews,0,3,3
1161330,0,1 user reviews,1,0,1
1161360,7,Positive,15,0,15
1161370,0,2 user reviews,2,0,2
1161410,0,7 user reviews,6,1,7
1161420,0,7 user reviews,5,2,7
1161421,7,Positive,13,3,16
1161440,0,2 user reviews,0,2,2
1161490,8,Very Positive,488,64,552
1161510,0,2 user reviews,2,0,2
1161570,6,Mostly Positive,10,3,13
1161580,8,Very Positive,4004,362,4366
1161600,0,1 user reviews,1,0,1
1161601,0,2 user reviews,1,1,2
1161602,0,1 user reviews,1,0,1
1161603,0,1 user reviews,1,0,1
1161650,7,Positive,16,1,17
1161660,0,2 user reviews,2,0,2
1161670,0,1 user reviews,1,0,1
1161680,0,1 user reviews,1,0,1
1161870,0,4 user reviews,4,0,4
1161880,7,Positive,39,2,41
1161900,0,8 user reviews,3,5,8
1161910,0,3 user reviews,3,0,3
1161930,0,1 user reviews,1,0,1
1162010,0,1 user reviews,1,0,1
1162050,7,Positive,8,2,10
1162070,7,Positive,35,2,37
1162110,0,6 user reviews,6,0,6
1162130,5,Mixed,150,101,251
1162160,8,Very Positive,71,0,71
1162170,5,Mixed,16,7,23
1162200,7,Positive,19,2,21
1162201,4,Mostly Negative,4,12,16
1162202,7,Positive,14,1,15
1162203,3,Negative,4,19,23
1162204,7,Positive,13,0,13
1162205,0,5 user reviews,4,1,5
1162208,7,Positive,27,3,30
1162230,4,Mostly Negative,3,7,10
1162280,7,Positive,14,0,14
1162290,0,3 user reviews,0,3,3
1162320,0,4 user reviews,4,0,4
1162340,7,Positive,8,2,10
1162341,0,3 user reviews,3,0,3
1162342,0,8 user reviews,5,3,8
1162350,7,Positive,17,2,19
1162380,7,Positive,48,0,48
1162430,0,7 user reviews,7,0,7
1162440,0,5 user reviews,3,2,5
1162470,7,Positive,34,4,38
1162480,0,8 user reviews,8,0,8
1162520,5,Mixed,85,67,152
1162560,8,Very Positive,132,8,140
1162590,6,Mostly Positive,7,3,10
1162601,5,Mixed,32,41,73
1162602,4,Mostly Negative,43,83,126
1162640,0,1 user reviews,1,0,1
1162650,0,3 user reviews,3,0,3
1162670,5,Mixed,8,8,16
1162680,8,Very Positive,150,31,181
1162690,0,3 user reviews,2,1,3
1162710,0,1 user reviews,1,0,1
1162723,0,3 user reviews,3,0,3
1162730,0,3 user reviews,0,3,3
1162750,8,Very Positive,127,10,137
1162760,0,5 user reviews,5,0,5
1162880,0,4 user reviews,2,2,4
1162900,0,3 user reviews,2,1,3
1162920,0,1 user reviews,1,0,1
1162950,0,2 user reviews,0,2,2
1163040,7,Positive,37,4,41
1163070,7,Positive,27,3,30
1163090,0,7 user reviews,7,0,7
1163140,0,1 user reviews,1,0,1
1163150,5,Mixed,11,6,17
1163170,0,3 user reviews,3,0,3
1163290,0,6 user reviews,4,2,6
1163300,0,3 user reviews,1,2,3
1163320,0,2 user reviews,0,2,2
1163340,7,Positive,39,8,47
1163460,5,Mixed,11,6,17
1163470,0,3 user reviews,3,0,3
1163490,0,1 user reviews,0,1,1
1163520,0,9 user reviews,4,5,9
1163550,5,Mixed,289,172,461
1163560,0,8 user reviews,6,2,8
1163570,0,3 user reviews,3,0,3
1163590,8,Very Positive,59,11,70
1163600,6,Mostly Positive,38,12,50
1163640,0,5 user reviews,5,0,5
1163660,0,4 user reviews,3,1,4
1163740,8,Very Positive,106,0,106
1163770,5,Mixed,46,21,67
1163780,0,2 user reviews,1,1,2
1163790,0,1 user reviews,1,0,1
1163910,8,Very Positive,136,11,147
1163950,0,2 user reviews,1,1,2
1163960,0,3 user reviews,3,0,3
1163990,0,2 user reviews,1,1,2
1164000,0,1 user reviews,1,0,1
1164010,6,Mostly Positive,18,5,23
1164050,8,Very Positive,145,6,151
1164110,4,Mostly Negative,13,21,34
1164210,0,4 user reviews,4,0,4
1164213,0,1 user reviews,0,1,1
1164217,0,1 user reviews,0,1,1
1164240,0,1 user reviews,1,0,1
1164310,0,3 user reviews,3,0,3
1164330,0,4 user reviews,4,0,4
1164410,0,4 user reviews,4,0,4
1164440,0,2 user reviews,0,2,2
1164470,0,3 user reviews,2,1,3
1164480,0,4 user reviews,4,0,4
1164520,0,1 user reviews,0,1,1
1164550,0,5 user reviews,4,1,5
1164660,0,2 user reviews,1,1,2
1164740,7,Positive,37,1,38
1164750,7,Positive,20,3,23
1164850,0,9 user reviews,8,1,9
1164910,0,5 user reviews,5,0,5
1164930,3,Negative,3,16,19
1164950,0,1 user reviews,0,1,1
1164970,0,6 user reviews,6,0,6
1164990,0,1 user reviews,0,1,1
1165020,0,1 user reviews,1,0,1
1165070,7,Positive,18,0,18
1165090,0,2 user reviews,2,0,2
1165100,0,1 user reviews,1,0,1
1165140,0,9 user reviews,7,2,9
1165180,0,7 user reviews,7,0,7
1165270,7,Positive,22,3,25
1165280,0,3 user reviews,1,2,3
1165300,0,1 user reviews,1,0,1
1165380,5,Mixed,16,10,26
1165400,0,9 user reviews,7,2,9
1165410,0,2 user reviews,1,1,2
1165420,0,2 user reviews,2,0,2
1165460,0,1 user reviews,0,1,1
1165510,7,Positive,19,3,22
1165590,0,4 user reviews,2,2,4
1165610,0,1 user reviews,0,1,1
1165740,0,2 user reviews,2,0,2
1165750,7,Positive,12,2,14
1165840,6,Mostly Positive,12,4,16
1165860,6,Mostly Positive,7,3,10
1165870,8,Very Positive,84,9,93
1165910,0,4 user reviews,3,1,4
1165920,0,5 user reviews,3,2,5
1166000,0,4 user reviews,4,0,4
1166100,0,1 user reviews,0,1,1
1166110,5,Mixed,9,6,15
1166120,0,4 user reviews,4,0,4
1166130,0,6 user reviews,6,0,6
1166230,7,Positive,9,1,10
1166240,0,2 user reviews,1,1,2
1166290,8,Very Positive,818,79,897
1166320,0,4 user reviews,4,0,4
1166350,0,1 user reviews,0,1,1
1166420,0,1 user reviews,1,0,1
1166470,7,Positive,16,2,18
1166471,6,Mostly Positive,31,9,40
1166472,6,Mostly Positive,17,5,22
1166490,0,4 user reviews,2,2,4
1166510,0,1 user reviews,0,1,1
1166580,7,Positive,12,2,14
1166600,7,Positive,27,5,32
1166721,0,1 user reviews,1,0,1
1166730,0,5 user reviews,5,0,5
1166740,4,Mostly Negative,4,8,12
1166760,0,2 user reviews,0,2,2
1166780,6,Mostly Positive,8,3,11
1166800,0,3 user reviews,3,0,3
1166840,7,Positive,36,1,37
1166860,8,Very Positive,162,31,193
1166980,0,5 user reviews,4,1,5
1167090,0,1 user reviews,0,1,1
1167270,0,1 user reviews,0,1,1
1167310,0,7 user reviews,0,7,7
1167320,8,Very Positive,101,21,122
1167330,0,4 user reviews,2,2,4
1167450,8,Very Positive,936,114,1050
1167460,0,6 user reviews,6,0,6
1167470,0,5 user reviews,1,4,5
1167500,0,1 user reviews,1,0,1
1167510,0,2 user reviews,2,0,2
1167520,0,9 user reviews,9,0,9
1167530,0,2 user reviews,2,0,2
1167540,0,1 user reviews,1,0,1
1167550,0,8 user reviews,7,1,8
1167630,9,Overwhelmingly Positive,1069,37,1106
1167640,7,Positive,9,2,11
1167660,7,Positive,12,2,14
1167661,0,5 user reviews,4,1,5
1167662,0,6 user reviews,4,2,6
1167663,6,Mostly Positive,7,3,10
1167710,0,1 user reviews,1,0,1
1167760,0,6 user reviews,5,1,6
1167770,0,3 user reviews,2,1,3
1167850,0,5 user reviews,5,0,5
1167860,0,6 user reviews,6,0,6
1167870,7,Positive,13,2,15
1167880,0,4 user reviews,4,0,4
1167910,6,Mostly Positive,99,28,127
1167950,8,Very Positive,120,28,148
1167970,0,6 user reviews,5,1,6
1168030,7,Positive,32,6,38
1168050,0,1 user reviews,1,0,1
1168060,0,4 user reviews,4,0,4
1168070,0,4 user reviews,4,0,4
1168170,5,Mixed,26,18,44
1168200,0,1 user reviews,0,1,1
1168290,0,2 user reviews,0,2,2
1168320,0,1 user reviews,0,1,1
1168360,0,2 user reviews,2,0,2
1168380,0,6 user reviews,6,0,6
1168420,0,3 user reviews,2,1,3
1168470,0,3 user reviews,3,0,3
1168480,0,1 user reviews,1,0,1
1168500,0,3 user reviews,0,3,3
1168516,0,1 user reviews,1,0,1
1168523,0,1 user reviews,1,0,1
1168526,0,1 user reviews,0,1,1
1168564,0,1 user reviews,1,0,1
1168566,0,1 user reviews,1,0,1
1168600,0,1 user reviews,1,0,1
1168630,0,8 user reviews,8,0,8
1168650,0,9 user reviews,5,4,9
1168660,6,Mostly Positive,35,10,45
1168680,7,Positive,11,2,13
1168820,0,1 user reviews,1,0,1
1168830,0,6 user reviews,4,2,6
1168870,6,Mostly Positive,59,20,79
1168880,8,Very Positive,226,22,248
1168940,0,1 user reviews,0,1,1
1168960,0,3 user reviews,3,0,3
1168970,0,1 user reviews,1,0,1
1168990,0,3 user reviews,1,2,3
1169020,8,Very Positive,57,5,62
1169030,0,3 user reviews,1,2,3
1169040,7,Positive,30,6,36
1169050,0,1 user reviews,1,0,1
1169060,0,1 user reviews,1,0,1
1169070,0,3 user reviews,1,2,3
1169100,8,Very Positive,65,4,69
1169160,0,7 user reviews,6,1,7
1169180,7,Positive,9,1,10
1169182,0,5 user reviews,3,2,5
1169310,0,2 user reviews,1,1,2
1169320,0,3 user reviews,2,1,3
1169420,0,5 user reviews,4,1,5
1169430,0,1 user reviews,1,0,1
1169510,0,2 user reviews,1,1,2
1169610,0,1 user reviews,1,0,1
1169720,0,1 user reviews,1,0,1
1169721,0,1 user reviews,1,0,1
1169726,0,3 user reviews,2,1,3
1169740,7,Positive,15,3,18
1169770,0,2 user reviews,1,1,2
1169810,0,1 user reviews,1,0,1
1169811,0,4 user reviews,2,2,4
1169880,0,4 user reviews,4,0,4
1169930,0,1 user reviews,1,0,1
1169960,0,2 user reviews,1,1,2
1169990,0,2 user reviews,2,0,2
1170010,6,Mostly Positive,10,4,14
1170050,0,7 user reviews,6,1,7
1170110,0,1 user reviews,1,0,1
1170120,7,Positive,25,0,25
1170160,0,1 user reviews,1,0,1
1170170,0,1 user reviews,1,0,1
1170180,5,Mixed,7,7,14
1170190,7,Positive,9,1,10
1170210,0,6 user reviews,5,1,6
1170290,0,5 user reviews,2,3,5
1170320,7,Positive,12,1,13
1170330,0,6 user reviews,5,1,6
1170340,7,Positive,10,0,10
1170400,0,1 user reviews,0,1,1
1170522,0,1 user reviews,1,0,1
1170526,0,1 user reviews,1,0,1
1170610,5,Mixed,9,4,13
1170630,0,3 user reviews,0,3,3
1170710,0,5 user reviews,5,0,5
1170712,0,1 user reviews,0,1,1
1170720,7,Positive,13,0,13
1170730,0,1 user reviews,1,0,1
1170750,0,3 user reviews,3,0,3
1170760,8,Very Positive,105,9,114
1170803,0,3 user reviews,0,3,3
1170807,0,4 user reviews,3,1,4
1170814,5,Mixed,6,7,13
1170830,0,1 user reviews,0,1,1
1170840,0,2 user reviews,2,0,2
1170960,0,8 user reviews,8,0,8
1170980,0,7 user reviews,5,2,7
1171030,0,1 user reviews,1,0,1
1171070,0,4 user reviews,3,1,4
1171080,0,1 user reviews,1,0,1
1171120,7,Positive,15,1,16
1171130,7,Positive,14,0,14
1171160,0,5 user reviews,5,0,5
1171190,6,Mostly Positive,14,4,18
1171240,6,Mostly Positive,55,14,69
1171260,6,Mostly Positive,8,3,11
1171270,7,Positive,40,4,44
1171310,5,Mixed,36,18,54
1171370,0,6 user reviews,6,0,6
1171380,0,3 user reviews,2,1,3
1171420,0,4 user reviews,4,0,4
1171430,0,1 user reviews,0,1,1
1171440,0,9 user reviews,9,0,9
1171460,0,1 user reviews,1,0,1
1171470,0,2 user reviews,2,0,2
1171560,0,4 user reviews,4,0,4
1171570,0,1 user reviews,1,0,1
1171620,0,1 user reviews,1,0,1
1171640,0,5 user reviews,2,3,5
1171660,7,Positive,16,0,16
1171770,0,1 user reviews,1,0,1
1171810,0,1 user reviews,0,1,1
1171820,7,Positive,24,3,27
1171840,7,Positive,14,2,16
1171880,0,1 user reviews,1,0,1
1171890,5,Mixed,6,6,12
1171950,0,1 user reviews,0,1,1
1172000,0,1 user reviews,0,1,1
1172050,6,Mostly Positive,75,22,97
1172060,6,Mostly Positive,12,4,16
1172080,0,1 user reviews,0,1,1
1172110,0,7 user reviews,7,0,7
1172130,0,6 user reviews,6,0,6
1172150,0,4 user reviews,4,0,4
1172170,7,Positive,19,2,21
1172220,0,1 user reviews,1,0,1
1172270,0,1 user reviews,1,0,1
1172290,0,1 user reviews,1,0,1
1172340,0,1 user reviews,0,1,1
1172380,8,Very Positive,31538,2969,34507
1172390,5,Mixed,8,4,12
1172410,0,7 user reviews,7,0,7
1172420,0,3 user reviews,3,0,3
1172430,5,Mixed,22,16,38
1172450,7,Positive,13,0,13
1172480,0,2 user reviews,2,0,2
1172490,0,4 user reviews,4,0,4
1172500,7,Positive,14,0,14
1172510,8,Very Positive,71,1,72
1172520,7,Positive,36,1,37
1172530,7,Positive,21,2,23
1172540,0,8 user reviews,5,3,8
1172550,0,2 user reviews,1,1,2
1172610,0,2 user reviews,2,0,2
1172620,8,Very Positive,12045,1226,13271
1172640,0,1 user reviews,1,0,1
1172660,0,2 user reviews,1,1,2
1172700,0,1 user reviews,1,0,1
1172720,0,1 user reviews,1,0,1
1172760,0,1 user reviews,0,1,1
1172860,7,Positive,17,3,20
1172890,0,2 user reviews,2,0,2
1172940,6,Mostly Positive,199,54,253
1173030,0,4 user reviews,4,0,4
1173031,0,1 user reviews,1,0,1
1173050,0,5 user reviews,5,0,5
1173120,0,6 user reviews,6,0,6
1173140,7,Positive,23,3,26
1173150,0,6 user reviews,4,2,6
1173200,8,Very Positive,60,3,63
1173210,0,3 user reviews,3,0,3
1173230,0,9 user reviews,7,2,9
1173240,0,1 user reviews,0,1,1
1173250,0,3 user reviews,3,0,3
1173260,0,1 user reviews,0,1,1
1173270,5,Mixed,5,7,12
1173310,7,Positive,9,1,10
1173340,0,4 user reviews,0,4,4
1173350,5,Mixed,20,9,29
1173380,8,Very Positive,128,13,141
1173410,5,Mixed,57,30,87
1173500,0,3 user reviews,1,2,3
1173510,8,Very Positive,49,9,58
1173610,0,1 user reviews,1,0,1
1173650,0,1 user reviews,0,1,1
1173740,7,Positive,10,1,11
1173751,0,1 user reviews,0,1,1
1173760,0,1 user reviews,1,0,1
1173830,7,Positive,30,1,31
1173850,0,3 user reviews,3,0,3
1173860,0,2 user reviews,2,0,2
1173870,7,Positive,10,1,11
1173900,6,Mostly Positive,17,5,22
1173940,7,Positive,11,0,11
1174090,7,Positive,9,2,11
1174120,0,2 user reviews,2,0,2
1174170,0,3 user reviews,3,0,3
1174180,8,Very Positive,28609,6495,35104
1174260,0,2 user reviews,1,1,2
1174290,0,4 user reviews,1,3,4
1174320,0,5 user reviews,5,0,5
1174360,0,1 user reviews,1,0,1
1174370,8,Very Positive,289,19,308
1174390,7,Positive,34,5,39
1174400,7,Positive,45,2,47
1174410,0,5 user reviews,5,0,5
1174420,0,5 user reviews,3,2,5
1174430,0,1 user reviews,1,0,1
1174440,0,2 user reviews,2,0,2
1174470,5,Mixed,10,5,15
1174500,0,6 user reviews,5,1,6
1174550,5,Mixed,8,6,14
1174580,0,9 user reviews,9,0,9
1174581,0,2 user reviews,2,0,2
1174620,0,1 user reviews,1,0,1
1174630,0,5 user reviews,5,0,5
1174631,0,6 user reviews,4,2,6
1174632,0,2 user reviews,2,0,2
1174670,7,Positive,14,0,14
1174690,8,Very Positive,53,6,59
1174720,5,Mixed,59,37,96
1174730,0,4 user reviews,4,0,4
1174780,0,4 user reviews,4,0,4
1174830,0,7 user reviews,5,2,7
1174860,0,7 user reviews,6,1,7
1174890,0,1 user reviews,0,1,1
1174900,0,2 user reviews,1,1,2
1174980,0,2 user reviews,2,0,2
1174990,0,1 user reviews,1,0,1
1175060,7,Positive,12,2,14
1175070,0,2 user reviews,2,0,2
1175090,7,Positive,35,0,35
1175130,0,1 user reviews,1,0,1
1175140,0,2 user reviews,2,0,2
1175160,0,2 user reviews,2,0,2
1175170,0,1 user reviews,1,0,1
1175200,6,Mostly Positive,39,15,54
1175222,0,1 user reviews,1,0,1
1175250,0,4 user reviews,4,0,4
1175360,8,Very Positive,121,8,129
1175390,4,Mostly Negative,12,21,33
1175420,0,8 user reviews,7,1,8
1175430,7,Positive,22,0,22
1175470,0,3 user reviews,1,2,3
1175480,5,Mixed,8,4,12
1175500,0,1 user reviews,0,1,1
1175510,0,2 user reviews,1,1,2
1175550,0,1 user reviews,0,1,1
1175581,0,2 user reviews,2,0,2
1175590,0,4 user reviews,3,1,4
1175640,7,Positive,12,3,15
1175650,0,1 user reviews,1,0,1
1175900,0,3 user reviews,1,2,3
1175930,0,5 user reviews,4,1,5
1175950,5,Mixed,5,6,11
1175980,0,1 user reviews,1,0,1
1176020,7,Positive,33,6,39
1176040,0,2 user reviews,1,1,2
1176050,0,2 user reviews,2,0,2
1176110,6,Mostly Positive,14,4,18
1176130,0,6 user reviews,3,3,6
1176160,0,5 user reviews,4,1,5
1176170,6,Mostly Positive,13,5,18
1176190,0,9 user reviews,4,5,9
1176360,0,3 user reviews,0,3,3
1176373,0,1 user reviews,1,0,1
1176378,0,1 user reviews,1,0,1
1176440,0,1 user reviews,1,0,1
1176460,7,Positive,12,2,14
1176480,0,2 user reviews,1,1,2
1176560,0,8 user reviews,1,7,8
1176580,5,Mixed,6,5,11
1176590,0,1 user reviews,1,0,1
1176610,0,1 user reviews,0,1,1
1176611,0,1 user reviews,0,1,1
1176613,0,1 user reviews,0,1,1
1176614,0,3 user reviews,3,0,3
1176616,0,2 user reviews,2,0,2
1176618,0,1 user reviews,1,0,1
1176660,0,2 user reviews,2,0,2
1176681,0,1 user reviews,1,0,1
1176700,0,7 user reviews,7,0,7
1176710,6,Mostly Positive,280,79,359
1176740,0,7 user reviews,2,5,7
1176750,0,1 user reviews,1,0,1
1176760,0,1 user reviews,1,0,1
1176850,0,2 user reviews,2,0,2
1176870,7,Positive,16,0,16
1176920,0,3 user reviews,3,0,3
1176923,0,1 user reviews,1,0,1
1176970,0,3 user reviews,2,1,3
1176990,0,6 user reviews,6,0,6
1177000,0,3 user reviews,2,1,3
1177020,0,1 user reviews,1,0,1
1177030,0,9 user reviews,7,2,9
1177050,0,6 user reviews,5,1,6
1177060,0,1 user reviews,0,1,1
1177080,0,1 user reviews,1,0,1
1177110,7,Positive,10,2,12
1177130,8,Very Positive,66,2,68
1177170,0,1 user reviews,1,0,1
1177350,0,1 user reviews,0,1,1
1177420,8,Very Positive,136,5,141
1177460,0,1 user reviews,1,0,1
1177510,0,1 user reviews,1,0,1
1177610,7,Positive,15,3,18
1177640,0,8 user reviews,8,0,8
1177660,6,Mostly Positive,41,11,52
1177690,7,Positive,24,5,29
1177720,0,8 user reviews,7,1,8
1177776,0,1 user reviews,1,0,1
1177777,0,1 user reviews,1,0,1
1177810,0,2 user reviews,1,1,2
1177820,0,1 user reviews,1,0,1
1177830,0,2 user reviews,2,0,2
1177850,0,1 user reviews,1,0,1
1177880,7,Positive,43,1,44
1177890,6,Mostly Positive,12,4,16
1177950,0,1 user reviews,0,1,1
1177990,0,9 user reviews,7,2,9
1178000,0,8 user reviews,8,0,8
1178020,0,2 user reviews,0,2,2
1178060,0,1 user reviews,0,1,1
1178120,7,Positive,22,5,27
1178140,8,Very Positive,52,1,53
1178150,0,6 user reviews,6,0,6
1178180,0,2 user reviews,1,1,2
1178200,6,Mostly Positive,12,4,16
1178210,0,5 user reviews,5,0,5
1178280,4,Mostly Negative,4,16,20
1178290,7,Positive,11,0,11
1178310,0,3 user reviews,1,2,3
1178320,0,1 user reviews,1,0,1
1178321,0,6 user reviews,6,0,6
1178330,0,2 user reviews,2,0,2
1178380,0,2 user reviews,1,1,2
1178400,6,Mostly Positive,44,16,60
1178460,7,Positive,33,5,38
1178490,8,Very Positive,98,24,122
1178500,0,3 user reviews,2,1,3
1178570,0,1 user reviews,0,1,1
1178610,5,Mixed,8,8,16
1178630,0,1 user reviews,1,0,1
1178640,0,6 user reviews,3,3,6
1178660,0,1 user reviews,1,0,1
1178670,0,4 user reviews,3,1,4
1178680,0,9 user reviews,9,0,9
1178710,0,3 user reviews,0,3,3
1178780,8,Very Positive,143,6,149
1178870,0,3 user reviews,1,2,3
1178871,0,1 user reviews,0,1,1
1178873,0,2 user reviews,0,2,2
1178879,0,1 user reviews,0,1,1
1178880,8,Very Positive,70,9,79
1178920,0,1 user reviews,0,1,1
1178950,0,1 user reviews,1,0,1
1179170,0,1 user reviews,1,0,1
1179190,0,1 user reviews,1,0,1
1179210,8,Very Positive,268,9,277
1179220,0,7 user reviews,6,1,7
1179290,7,Positive,38,1,39
1179300,0,2 user reviews,2,0,2
1179340,0,1 user reviews,1,0,1
1179390,0,1 user reviews,0,1,1
1179410,0,8 user reviews,5,3,8
1179420,0,1 user reviews,0,1,1
1179440,0,1 user reviews,1,0,1
1179450,7,Positive,9,1,10
1179451,0,2 user reviews,2,0,2
1179452,0,2 user reviews,2,0,2
1179453,0,2 user reviews,2,0,2
1179454,0,1 user reviews,1,0,1
1179457,0,1 user reviews,1,0,1
1179460,0,9 user reviews,9,0,9
1179492,0,1 user reviews,1,0,1
1179493,0,1 user reviews,1,0,1
1179500,0,3 user reviews,3,0,3
1179540,0,4 user reviews,4,0,4
1179560,7,Positive,19,3,22
1179570,0,3 user reviews,3,0,3
1179620,0,3 user reviews,3,0,3
1179635,0,1 user reviews,1,0,1
1179653,0,1 user reviews,1,0,1
1179656,0,1 user reviews,1,0,1
1179710,5,Mixed,43,35,78
1179720,4,Mostly Negative,16,31,47
1179830,7,Positive,18,0,18
1179840,0,2 user reviews,0,2,2
1179880,0,1 user reviews,1,0,1
1179930,0,5 user reviews,4,1,5
1179950,0,4 user reviews,2,2,4
1180000,0,1 user reviews,1,0,1
1180010,7,Positive,13,1,14
1180070,0,1 user reviews,1,0,1
1180120,8,Very Positive,51,1,52
1180190,0,2 user reviews,2,0,2
1180250,7,Positive,30,3,33
1180270,6,Mostly Positive,11,3,14
1180330,6,Mostly Positive,25,7,32
1180370,0,3 user reviews,2,1,3
1180420,0,3 user reviews,2,1,3
1180450,0,3 user reviews,2,1,3
1180490,7,Positive,18,0,18
1180491,7,Positive,18,1,19
1180510,7,Positive,12,0,12
1180540,7,Positive,40,0,40
1180550,0,1 user reviews,0,1,1
1180560,0,2 user reviews,2,0,2
1180570,0,1 user reviews,1,0,1
1180610,0,9 user reviews,9,0,9
1180620,0,6 user reviews,4,2,6
1180650,0,2 user reviews,1,1,2
1180660,8,Very Positive,481,48,529
1180690,0,1 user reviews,1,0,1
1180700,0,2 user reviews,2,0,2
1180730,0,2 user reviews,1,1,2
1180820,0,1 user reviews,0,1,1
1180900,7,Positive,15,0,15
1180910,0,2 user reviews,0,2,2
1180940,0,3 user reviews,2,1,3
1180950,0,2 user reviews,1,1,2
1180970,0,6 user reviews,5,1,6
1181000,8,Very Positive,51,1,52
1181020,0,1 user reviews,0,1,1
1181030,7,Positive,13,2,15
1181120,0,6 user reviews,4,2,6
1181130,5,Mixed,7,4,11
1181140,6,Mostly Positive,72,21,93
1181170,0,1 user reviews,0,1,1
1181220,0,3 user reviews,3,0,3
1181270,0,7 user reviews,4,3,7
1181280,0,3 user reviews,1,2,3
1181290,0,2 user reviews,1,1,2
1181330,0,5 user reviews,4,1,5
1181400,7,Positive,39,0,39
1181440,7,Positive,31,7,38
1181470,0,3 user reviews,2,1,3
1181510,0,1 user reviews,1,0,1
1181520,7,Positive,9,2,11
1181530,0,5 user reviews,4,1,5
1181570,7,Positive,32,1,33
1181600,0,5 user reviews,5,0,5
1181630,0,2 user reviews,2,0,2
1181750,0,1 user reviews,1,0,1
1181770,0,4 user reviews,4,0,4
1181771,7,Positive,9,1,10
1181772,0,2 user reviews,2,0,2
1181773,0,1 user reviews,1,0,1
1181774,0,2 user reviews,2,0,2
1181790,0,2 user reviews,2,0,2
1181820,0,1 user reviews,0,1,1
1181830,8,Very Positive,363,21,384
1181880,0,1 user reviews,1,0,1
1181910,0,5 user reviews,5,0,5
1181990,5,Mixed,8,4,12
1182000,7,Positive,15,3,18
1182020,0,3 user reviews,3,0,3
1182060,5,Mixed,11,7,18
1182090,0,8 user reviews,8,0,8
1182190,0,6 user reviews,4,2,6
1182200,0,6 user reviews,5,1,6
1182291,0,2 user reviews,2,0,2
1182292,0,1 user reviews,1,0,1
1182293,0,1 user reviews,1,0,1
1182294,0,1 user reviews,1,0,1
1182300,0,1 user reviews,1,0,1
1182301,0,1 user reviews,1,0,1
1182303,0,1 user reviews,1,0,1
1182304,0,1 user reviews,1,0,1
1182305,0,1 user reviews,1,0,1
1182306,0,1 user reviews,1,0,1
1182308,0,1 user reviews,1,0,1
1182330,0,1 user reviews,0,1,1
1182340,0,2 user reviews,2,0,2
1182360,0,1 user reviews,0,1,1
1182390,0,1 user reviews,0,1,1
1182470,7,Positive,9,1,10
1182670,0,4 user reviews,3,1,4
1182690,0,1 user reviews,0,1,1
1182720,0,2 user reviews,2,0,2
1182760,5,Mixed,8,8,16
1182770,0,2 user reviews,2,0,2
1182830,8,Very Positive,49,3,52
1182890,0,1 user reviews,1,0,1
1182920,8,Very Positive,86,6,92
1182930,5,Mixed,10,5,15
1182940,6,Mostly Positive,12,5,17
1182970,5,Mixed,7,10,17
1183030,5,Mixed,44,20,64
1183050,0,9 user reviews,6,3,9
1183051,0,4 user reviews,2,2,4
1183052,0,3 user reviews,3,0,3
1183080,0,8 user reviews,6,2,8
1183100,0,5 user reviews,5,0,5
1183101,0,4 user reviews,4,0,4
1183102,0,3 user reviews,3,0,3
1183140,0,4 user reviews,4,0,4
1183170,0,8 user reviews,7,1,8
1183200,0,1 user reviews,1,0,1
1183210,0,2 user reviews,2,0,2
1183230,0,4 user reviews,4,0,4
1183240,0,6 user reviews,5,1,6
1183260,0,5 user reviews,5,0,5
1183280,0,3 user reviews,2,1,3
1183300,0,5 user reviews,3,2,5
1183410,0,1 user reviews,1,0,1
1183470,7,Positive,37,6,43
1183480,0,3 user reviews,3,0,3
1183500,7,Positive,22,2,24
1183510,0,6 user reviews,2,4,6
1183540,0,5 user reviews,4,1,5
1183580,0,2 user reviews,2,0,2
1183590,7,Positive,11,1,12
1183670,0,5 user reviews,4,1,5
1183720,7,Positive,30,7,37
1183840,0,4 user reviews,4,0,4
1183970,8,Very Positive,1465,109,1574
1184040,0,6 user reviews,5,1,6
1184050,8,Very Positive,1157,266,1423
1184070,0,1 user reviews,0,1,1
1184090,0,7 user reviews,4,3,7
1184100,0,1 user reviews,1,0,1
1184101,0,1 user reviews,1,0,1
1184230,0,3 user reviews,1,2,3
1184240,0,3 user reviews,2,1,3
1184290,0,3 user reviews,3,0,3
1184310,0,1 user reviews,1,0,1
1184350,7,Positive,13,0,13
1184400,5,Mixed,9,8,17
1184410,8,Very Positive,137,11,148
1184411,5,Mixed,140,98,238
1184412,5,Mixed,44,44,88
1184420,0,2 user reviews,2,0,2
1184450,7,Positive,13,0,13
1184470,0,1 user reviews,1,0,1
1184480,8,Very Positive,178,10,188
1184550,6,Mostly Positive,9,3,12
1184570,0,4 user reviews,2,2,4
1184700,0,1 user reviews,1,0,1
1184770,9,Overwhelmingly Positive,695,27,722
1184780,0,2 user reviews,2,0,2
1184810,8,Very Positive,55,1,56
1184840,7,Positive,41,2,43
1184880,0,3 user reviews,2,1,3
1184900,7,Positive,17,0,17
1184960,0,9 user reviews,9,0,9
1184980,0,1 user reviews,0,1,1
1184990,7,Positive,45,4,49
1185000,0,3 user reviews,2,1,3
1185160,8,Very Positive,52,12,64
1185270,0,1 user reviews,0,1,1
1185280,0,3 user reviews,3,0,3
1185330,0,6 user reviews,4,2,6
1185390,0,1 user reviews,1,0,1
1185440,0,3 user reviews,3,0,3
1185470,0,7 user reviews,7,0,7
1185480,0,3 user reviews,3,0,3
1185520,8,Very Positive,82,18,100
1185560,5,Mixed,327,160,487
1185600,0,1 user reviews,0,1,1
1185630,0,2 user reviews,2,0,2
1185660,0,4 user reviews,3,1,4
1185680,0,6 user reviews,1,5,6
1185700,7,Positive,14,2,16
1185730,0,5 user reviews,5,0,5
1185740,0,5 user reviews,4,1,5
1185760,0,1 user reviews,0,1,1
1185820,7,Positive,36,2,38
1185870,7,Positive,8,2,10
1185910,0,6 user reviews,5,1,6
1185950,0,4 user reviews,3,1,4
1185960,0,2 user reviews,1,1,2
1185990,0,1 user reviews,0,1,1
1186010,0,1 user reviews,0,1,1
1186030,0,5 user reviews,4,1,5
1186100,0,5 user reviews,4,1,5
1186160,7,Positive,14,2,16
1186220,7,Positive,16,1,17
1186260,5,Mixed,7,7,14
1186270,0,1 user reviews,1,0,1
1186280,0,2 user reviews,2,0,2
1186290,0,8 user reviews,2,6,8
1186310,0,1 user reviews,1,0,1
1186340,0,4 user reviews,4,0,4
1186350,0,2 user reviews,2,0,2
1186400,6,Mostly Positive,69,19,88
1186460,0,4 user reviews,4,0,4
1186510,0,2 user reviews,1,1,2
1186530,0,3 user reviews,2,1,3
1186560,5,Mixed,11,6,17
1186561,5,Mixed,8,5,13
1186570,0,2 user reviews,2,0,2
1186580,0,9 user reviews,8,1,9
1186600,5,Mixed,4,6,10
1186630,0,3 user reviews,1,2,3
1186640,8,Very Positive,392,17,409
1186650,0,2 user reviews,0,2,2
1186690,0,1 user reviews,1,0,1
1186720,0,1 user reviews,1,0,1
1186740,0,1 user reviews,1,0,1
1186770,0,1 user reviews,0,1,1
1186870,0,2 user reviews,2,0,2
1186871,0,1 user reviews,1,0,1
1186872,0,2 user reviews,2,0,2
1186873,0,1 user reviews,1,0,1
1186874,0,3 user reviews,3,0,3
1186875,0,1 user reviews,1,0,1
1186876,0,2 user reviews,2,0,2
1186877,0,4 user reviews,4,0,4
1186880,7,Positive,24,4,28
1186940,0,1 user reviews,0,1,1
1187030,0,1 user reviews,0,1,1
1187110,0,2 user reviews,1,1,2
1187153,0,1 user reviews,1,0,1
1187170,0,3 user reviews,3,0,3
1187190,0,2 user reviews,2,0,2
1187230,0,1 user reviews,1,0,1
1187240,0,2 user reviews,2,0,2
1187330,8,Very Positive,77,14,91
1187420,0,7 user reviews,3,4,7
1187490,0,4 user reviews,3,1,4
1187510,8,Very Positive,86,5,91
1187600,7,Positive,14,2,16
1187620,0,6 user reviews,3,3,6
1187630,0,3 user reviews,2,1,3
1187631,0,5 user reviews,4,1,5
1187650,0,4 user reviews,3,1,4
1187680,0,1 user reviews,1,0,1
1187740,0,3 user reviews,1,2,3
1187790,0,5 user reviews,3,2,5
1187830,0,1 user reviews,1,0,1
1187900,0,1 user reviews,1,0,1
1187940,5,Mixed,24,28,52
1187950,0,1 user reviews,1,0,1
1188000,7,Positive,15,0,15
1188040,0,2 user reviews,2,0,2
1188060,0,2 user reviews,1,1,2
1188080,7,Positive,40,3,43
1188090,0,2 user reviews,1,1,2
1188120,0,1 user reviews,1,0,1
1188140,0,5 user reviews,4,1,5
1188250,7,Positive,39,5,44
1188260,5,Mixed,29,16,45
1188280,0,1 user reviews,1,0,1
1188310,0,5 user reviews,5,0,5
1188330,8,Very Positive,151,8,159
1188430,0,5 user reviews,2,3,5
1188540,7,Positive,22,4,26
1188580,0,2 user reviews,2,0,2
1188600,0,6 user reviews,4,2,6
1188608,0,1 user reviews,1,0,1
1188609,0,2 user reviews,0,2,2
1188610,0,2 user reviews,2,0,2
1188611,0,2 user reviews,2,0,2
1188615,0,4 user reviews,4,0,4
1188616,0,1 user reviews,0,1,1
1188617,0,2 user reviews,0,2,2
1188618,0,2 user reviews,1,1,2
1188619,0,2 user reviews,2,0,2
1188620,0,1 user reviews,1,0,1
1188660,0,3 user reviews,3,0,3
1188670,0,1 user reviews,1,0,1
1188680,6,Mostly Positive,190,67,257
1188760,7,Positive,17,2,19
1188800,0,2 user reviews,2,0,2
1188930,8,Very Positive,128,8,136
1188970,8,Very Positive,79,17,96
1188990,0,6 user reviews,5,1,6
1189020,0,2 user reviews,0,2,2
1189040,0,1 user reviews,0,1,1
1189050,5,Mixed,7,6,13
1189080,0,4 user reviews,2,2,4
1189120,0,1 user reviews,0,1,1
1189200,0,1 user reviews,1,0,1
1189230,6,Mostly Positive,98,33,131
1189360,0,5 user reviews,5,0,5
1189440,7,Positive,19,4,23
1189460,6,Mostly Positive,10,3,13
1189480,5,Mixed,22,19,41
1189490,7,Positive,14,0,14
1189520,0,2 user reviews,2,0,2
1189600,0,1 user reviews,1,0,1
1189630,8,Very Positive,364,16,380
1189650,0,2 user reviews,1,1,2
1189700,0,3 user reviews,1,2,3
1189740,6,Mostly Positive,11,4,15
1189750,0,4 user reviews,3,1,4
1189770,0,1 user reviews,1,0,1
1189780,7,Positive,26,6,32
1189800,6,Mostly Positive,525,199,724
1189871,0,1 user reviews,1,0,1
1189890,0,7 user reviews,4,3,7
1189900,0,6 user reviews,2,4,6
1189910,5,Mixed,5,5,10
1190010,0,1 user reviews,1,0,1
1190060,0,4 user reviews,4,0,4
1190110,8,Very Positive,240,21,261
1190120,0,4 user reviews,1,3,4
1190130,0,3 user reviews,1,2,3
1190150,0,5 user reviews,3,2,5
1190160,8,Very Positive,63,5,68
1190180,0,1 user reviews,1,0,1
1190210,0,1 user reviews,1,0,1
1190310,0,2 user reviews,2,0,2
1190380,6,Mostly Positive,8,3,11
1190400,8,Very Positive,117,22,139
1190410,0,3 user reviews,2,1,3
1190460,8,Very Positive,6427,532,6959
1190480,0,2 user reviews,1,1,2
1190490,0,1 user reviews,1,0,1
1190570,0,3 user reviews,2,1,3
1190590,0,1 user reviews,1,0,1
1190620,0,6 user reviews,1,5,6
1190640,0,1 user reviews,1,0,1
1190760,0,3 user reviews,0,3,3
1190770,0,1 user reviews,1,0,1
1190780,0,2 user reviews,0,2,2
1190810,0,7 user reviews,7,0,7
1190820,0,5 user reviews,5,0,5
1190840,0,7 user reviews,7,0,7
1190910,0,1 user reviews,1,0,1
1190930,0,7 user reviews,7,0,7
1190950,0,2 user reviews,2,0,2
1190980,0,1 user reviews,0,1,1
1190990,0,4 user reviews,4,0,4
1191010,0,7 user reviews,7,0,7
1191070,6,Mostly Positive,24,8,32
1191100,7,Positive,11,2,13
1191160,0,6 user reviews,4,2,6
1191161,7,Positive,13,1,14
1191162,0,8 user reviews,6,2,8
1191190,0,2 user reviews,2,0,2
1191210,8,Very Positive,138,33,171
1191280,0,4 user reviews,2,2,4
1191440,0,1 user reviews,0,1,1
1191490,7,Positive,16,0,16
1191500,5,Mixed,6,6,12
1191510,0,1 user reviews,0,1,1
1191580,8,Very Positive,222,20,242
1191590,0,9 user reviews,9,0,9
1191610,0,1 user reviews,1,0,1
1191630,8,Very Positive,333,32,365
1191790,0,5 user reviews,2,3,5
1191810,0,1 user reviews,1,0,1
1191820,0,2 user reviews,2,0,2
1191840,7,Positive,15,1,16
1191860,7,Positive,13,1,14
1191940,8,Very Positive,68,7,75
1192020,0,8 user reviews,4,4,8
1192060,0,3 user reviews,0,3,3
1192070,0,1 user reviews,1,0,1
1192160,0,1 user reviews,1,0,1
1192260,0,1 user reviews,1,0,1
1192270,0,1 user reviews,1,0,1
1192310,0,6 user reviews,4,2,6
1192340,0,3 user reviews,2,1,3
1192350,0,4 user reviews,3,1,4
1192380,7,Positive,11,1,12
1192390,0,2 user reviews,0,2,2
1192450,0,7 user reviews,6,1,7
1192500,0,1 user reviews,0,1,1
1192561,0,2 user reviews,0,2,2
1192580,5,Mixed,9,4,13
1192610,6,Mostly Positive,74,20,94
1192640,8,Very Positive,58,7,65
1192650,0,2 user reviews,2,0,2
1192680,0,2 user reviews,2,0,2
1192730,5,Mixed,21,12,33
1192740,0,3 user reviews,3,0,3
1192750,5,Mixed,11,5,16
1192820,5,Mixed,29,25,54
1192840,0,1 user reviews,1,0,1
1192860,0,2 user reviews,2,0,2
1192890,6,Mostly Positive,11,4,15
1192910,0,1 user reviews,1,0,1
1193110,0,2 user reviews,1,1,2
1193160,0,1 user reviews,0,1,1
1193200,0,3 user reviews,3,0,3
1193210,0,2 user reviews,2,0,2
1193330,0,3 user reviews,3,0,3
1193340,8,Very Positive,119,26,145
1193370,0,2 user reviews,2,0,2
1193390,0,1 user reviews,1,0,1
1193420,0,1 user reviews,1,0,1
1193430,0,2 user reviews,2,0,2
1193450,0,1 user reviews,0,1,1
1193460,0,1 user reviews,1,0,1
1193520,0,2 user reviews,1,1,2
1193530,0,2 user reviews,1,1,2
1193560,0,6 user reviews,6,0,6
1193780,0,1 user reviews,1,0,1
1193870,0,1 user reviews,1,0,1
1193871,7,Positive,12,3,15
1193890,0,1 user reviews,0,1,1
1193930,0,2 user reviews,2,0,2
1193950,0,1 user reviews,1,0,1
1193990,0,8 user reviews,7,1,8
1194000,0,2 user reviews,1,1,2
1194010,6,Mostly Positive,39,13,52
1194021,0,2 user reviews,2,0,2
1194100,0,1 user reviews,0,1,1
1194110,8,Very Positive,97,17,114
1194120,7,Positive,16,2,18
1194140,5,Mixed,12,10,22
1194160,0,2 user reviews,2,0,2
1194170,0,1 user reviews,1,0,1
1194220,0,2 user reviews,2,0,2
1194380,0,1 user reviews,1,0,1
1194390,0,4 user reviews,4,0,4
1194440,0,2 user reviews,2,0,2
1194470,0,2 user reviews,2,0,2
1194480,7,Positive,10,0,10
1194540,0,1 user reviews,1,0,1
1194570,7,Positive,14,3,17
1194600,0,1 user reviews,1,0,1
1194610,0,8 user reviews,7,1,8
1194630,6,Mostly Positive,21,9,30
1194680,8,Very Positive,48,7,55
1194690,0,4 user reviews,1,3,4
1194770,5,Mixed,13,9,22
1194780,0,1 user reviews,1,0,1
1194781,0,1 user reviews,1,0,1
1194790,0,8 user reviews,4,4,8
1194830,8,Very Positive,63,5,68
1194840,8,Very Positive,52,0,52
1194910,0,3 user reviews,3,0,3
1194930,5,Mixed,214,98,312
1194940,7,Positive,12,3,15
1195020,8,Very Positive,68,17,85
1195090,0,1 user reviews,1,0,1
1195150,0,3 user reviews,2,1,3
1195160,0,2 user reviews,2,0,2
1195170,0,4 user reviews,2,2,4
1195216,0,1 user reviews,0,1,1
1195230,7,Positive,12,0,12
1195240,5,Mixed,8,4,12
1195270,7,Positive,10,1,11
1195320,7,Positive,29,0,29
1195350,0,2 user reviews,1,1,2
1195360,5,Mixed,11,5,16
1195410,7,Positive,18,1,19
1195430,0,4 user reviews,4,0,4
1195460,5,Mixed,1009,523,1532
1195480,7,Positive,23,5,28
1195530,0,4 user reviews,4,0,4
1195540,0,1 user reviews,1,0,1
1195550,0,1 user reviews,0,1,1
1195570,0,2 user reviews,2,0,2
1195600,0,2 user reviews,2,0,2
1195620,0,2 user reviews,2,0,2
1195710,0,2 user reviews,2,0,2
1195750,0,1 user reviews,1,0,1
1195820,0,2 user reviews,0,2,2
1195906,0,1 user reviews,1,0,1
1195907,0,1 user reviews,1,0,1
1195910,7,Positive,15,1,16
1195920,7,Positive,10,2,12
1196040,0,1 user reviews,0,1,1
1196041,0,3 user reviews,2,1,3
1196080,6,Mostly Positive,13,4,17
1196100,0,7 user reviews,7,0,7
1196130,0,2 user reviews,2,0,2
1196150,7,Positive,12,3,15
1196160,0,2 user reviews,0,2,2
1196170,0,4 user reviews,4,0,4
1196190,0,2 user reviews,1,1,2
1196260,0,5 user reviews,2,3,5
1196280,0,1 user reviews,1,0,1
1196310,7,Positive,25,3,28
1196320,0,1 user reviews,1,0,1
1196350,0,1 user reviews,0,1,1
1196380,0,2 user reviews,2,0,2
1196390,0,4 user reviews,4,0,4
1196400,7,Positive,13,1,14
1196420,7,Positive,16,0,16
1196450,7,Positive,10,0,10
1196500,7,Positive,15,3,18
1196520,0,3 user reviews,1,2,3
1196570,0,3 user reviews,2,1,3
1196580,0,5 user reviews,5,0,5
1196630,8,Very Positive,356,44,400
1196651,0,6 user reviews,5,1,6
1196670,5,Mixed,6,6,12
1196690,0,1 user reviews,1,0,1
1196710,0,7 user reviews,5,2,7
1196750,0,5 user reviews,3,2,5
1196770,5,Mixed,84,47,131
1196780,0,7 user reviews,6,1,7
1196781,0,5 user reviews,4,1,5
1196782,0,3 user reviews,3,0,3
1196783,0,5 user reviews,5,0,5
1196784,0,8 user reviews,8,0,8
1196785,0,3 user reviews,2,1,3
1196786,0,2 user reviews,2,0,2
1196787,0,7 user reviews,7,0,7
1196788,7,Positive,10,1,11
1196789,0,2 user reviews,2,0,2
1196790,0,5 user reviews,5,0,5
1196791,7,Positive,46,1,47
1196792,0,4 user reviews,4,0,4
1196793,0,7 user reviews,7,0,7
1196794,7,Positive,9,1,10
1196800,0,9 user reviews,9,0,9
1196850,0,1 user reviews,0,1,1
1196890,0,7 user reviews,6,1,7
1196930,7,Positive,31,7,38
1196940,0,2 user reviews,2,0,2
1196970,0,2 user reviews,2,0,2
1197010,0,3 user reviews,2,1,3
1197020,0,1 user reviews,1,0,1
1197030,7,Positive,20,0,20
1197060,0,2 user reviews,2,0,2
1197100,0,5 user reviews,3,2,5
1197110,0,5 user reviews,1,4,5
1197150,0,5 user reviews,4,1,5
1197210,0,3 user reviews,2,1,3
1197220,6,Mostly Positive,47,15,62
1197230,0,7 user reviews,7,0,7
1197280,0,6 user reviews,4,2,6
1197340,0,1 user reviews,0,1,1
1197350,0,7 user reviews,7,0,7
1197360,0,1 user reviews,1,0,1
1197370,8,Very Positive,145,12,157
1197380,0,1 user reviews,1,0,1
1197390,7,Positive,13,0,13
1197440,0,4 user reviews,1,3,4
1197500,0,1 user reviews,1,0,1
1197520,7,Positive,13,0,13
1197530,0,3 user reviews,3,0,3
1197550,0,9 user reviews,1,8,9
1197590,6,Mostly Positive,23,6,29
1197620,0,5 user reviews,4,1,5
1197650,7,Positive,16,1,17
1197651,0,2 user reviews,2,0,2
1197710,0,2 user reviews,2,0,2
1197770,6,Mostly Positive,60,23,83
1197800,0,1 user reviews,1,0,1
1197810,0,4 user reviews,4,0,4
1197820,7,Positive,25,5,30
1197840,0,1 user reviews,0,1,1
1197860,0,3 user reviews,3,0,3
1197980,0,2 user reviews,2,0,2
1197990,0,6 user reviews,6,0,6
1198020,0,1 user reviews,0,1,1
1198040,8,Very Positive,68,1,69
1198050,6,Mostly Positive,39,14,53
1198060,0,3 user reviews,1,2,3
1198070,0,2 user reviews,2,0,2
1198110,0,3 user reviews,2,1,3
1198146,0,1 user reviews,1,0,1
1198163,0,1 user reviews,1,0,1
1198165,0,1 user reviews,0,1,1
1198186,0,1 user reviews,0,1,1
1198220,0,3 user reviews,1,2,3
1198240,0,3 user reviews,2,1,3
1198280,0,2 user reviews,1,1,2
1198290,7,Positive,10,0,10
1198310,0,1 user reviews,1,0,1
1198360,5,Mixed,13,7,20
1198361,0,6 user reviews,6,0,6
1198380,0,3 user reviews,2,1,3
1198390,0,5 user reviews,3,2,5
1198400,7,Positive,12,0,12
1198410,0,1 user reviews,0,1,1
1198440,0,2 user reviews,2,0,2
1198450,7,Positive,13,3,16
1198460,7,Positive,22,1,23
1198461,0,4 user reviews,4,0,4
1198462,7,Positive,10,0,10
1198470,5,Mixed,25,16,41
1198480,0,2 user reviews,2,0,2
1198481,0,2 user reviews,2,0,2
1198510,8,Very Positive,94,2,96
1198550,0,1 user reviews,1,0,1
1198600,7,Positive,15,1,16
1198620,0,2 user reviews,0,2,2
1198630,0,7 user reviews,5,2,7
1198700,7,Positive,9,1,10
1198730,8,Very Positive,48,10,58
1198740,7,Positive,37,1,38
1198780,0,6 user reviews,6,0,6
1198810,0,3 user reviews,3,0,3
1198820,0,9 user reviews,7,2,9
1198840,0,1 user reviews,1,0,1
1198860,0,9 user reviews,7,2,9
1198900,0,4 user reviews,4,0,4
1198940,0,4 user reviews,2,2,4
1198960,0,8 user reviews,8,0,8
1199010,0,7 user reviews,7,0,7
1199030,8,Very Positive,238,38,276
1199120,7,Positive,45,1,46
1199140,7,Positive,18,0,18
1199150,0,1 user reviews,1,0,1
1199170,0,4 user reviews,4,0,4
1199180,0,2 user reviews,2,0,2
1199210,0,2 user reviews,2,0,2
1199220,0,6 user reviews,3,3,6
1199240,0,1 user reviews,1,0,1
1199270,0,8 user reviews,8,0,8
1199360,0,5 user reviews,4,1,5
1199370,4,Mostly Negative,5,11,16
1199420,0,4 user reviews,3,1,4
1199450,5,Mixed,8,4,12
1199470,0,3 user reviews,3,0,3
1199500,0,1 user reviews,0,1,1
1199530,0,1 user reviews,1,0,1
1199531,0,8 user reviews,5,3,8
1199532,0,1 user reviews,1,0,1
1199550,7,Positive,14,0,14
1199560,0,2 user reviews,2,0,2
1199601,0,1 user reviews,1,0,1
1199610,0,1 user reviews,0,1,1
1199630,6,Mostly Positive,8,3,11
1199650,0,1 user reviews,1,0,1
1199660,7,Positive,31,1,32
1199740,0,2 user reviews,2,0,2
1199780,0,2 user reviews,2,0,2
1199790,5,Mixed,9,5,14
1199880,5,Mixed,109,58,167
1199900,0,4 user reviews,3,1,4
1200110,0,3 user reviews,3,0,3
1200140,0,3 user reviews,2,1,3
1200150,0,3 user reviews,3,0,3
1200160,0,1 user reviews,1,0,1
1200170,0,1 user reviews,1,0,1
1200171,0,1 user reviews,1,0,1
1200180,0,1 user reviews,1,0,1
1200200,0,1 user reviews,0,1,1
1200230,5,Mixed,16,17,33
1200270,0,9 user reviews,5,4,9
1200290,0,2 user reviews,2,0,2
1200300,0,1 user reviews,1,0,1
1200330,8,Very Positive,50,12,62
1200341,0,8 user reviews,6,2,8
1200342,0,2 user reviews,2,0,2
1200343,0,1 user reviews,1,0,1
1200344,0,2 user reviews,2,0,2
1200345,0,1 user reviews,1,0,1
1200346,0,1 user reviews,1,0,1
1200400,0,2 user reviews,0,2,2
1200420,0,4 user reviews,4,0,4
1200430,0,2 user reviews,1,1,2
1200520,0,1 user reviews,1,0,1
1200550,7,Positive,16,4,20
1200552,7,Positive,9,1,10
1200590,0,2 user reviews,1,1,2
1200600,0,1 user reviews,1,0,1
1200610,0,4 user reviews,3,1,4
1200630,0,1 user reviews,0,1,1
1200650,0,2 user reviews,1,1,2
1200710,6,Mostly Positive,69,20,89
1200720,8,Very Positive,172,1,173
1200730,8,Very Positive,60,6,66
1200780,0,2 user reviews,2,0,2
1200910,0,5 user reviews,5,0,5
1200930,0,1 user reviews,0,1,1
1201000,0,6 user reviews,2,4,6
1201050,0,5 user reviews,5,0,5
1201220,0,2 user reviews,1,1,2
1201260,0,3 user reviews,2,1,3
1201310,0,9 user reviews,7,2,9
1201350,0,2 user reviews,1,1,2
1201360,8,Very Positive,149,4,153
1201370,0,8 user reviews,6,2,8
1201430,0,1 user reviews,1,0,1
1201450,0,8 user reviews,6,2,8
1201500,0,1 user reviews,0,1,1
1201550,7,Positive,46,2,48
1201630,6,Mostly Positive,16,6,22
1201750,0,3 user reviews,3,0,3
1201790,0,2 user reviews,2,0,2
1201800,0,8 user reviews,8,0,8
1201810,5,Mixed,11,5,16
1201830,8,Very Positive,59,9,68
1201840,8,Very Positive,101,17,118
1201880,0,1 user reviews,1,0,1
1201910,4,Mostly Negative,4,7,11
1201950,0,1 user reviews,1,0,1
1201960,0,3 user reviews,3,0,3
1202013,0,1 user reviews,1,0,1
1202070,7,Positive,35,3,38
1202090,0,5 user reviews,2,3,5
1202150,7,Positive,12,3,15
1202160,0,2 user reviews,1,1,2
1202170,0,8 user reviews,8,0,8
1202190,0,6 user reviews,4,2,6
1202220,0,1 user reviews,1,0,1
1202240,0,7 user reviews,7,0,7
1202250,0,1 user reviews,1,0,1
1202310,8,Very Positive,57,13,70
1202400,0,3 user reviews,3,0,3
1202420,0,7 user reviews,7,0,7
1202460,0,7 user reviews,6,1,7
1202520,5,Mixed,137,167,304
1202540,8,Very Positive,136,1,137
1202550,0,1 user reviews,0,1,1
1202560,0,3 user reviews,2,1,3
1202570,0,4 user reviews,4,0,4
1202603,0,2 user reviews,0,2,2
1202610,0,1 user reviews,1,0,1
1202630,0,6 user reviews,5,1,6
1202640,0,5 user reviews,3,2,5
1202650,6,Mostly Positive,15,4,19
1202660,0,4 user reviews,3,1,4
1202710,0,3 user reviews,3,0,3
1202730,0,3 user reviews,3,0,3
1202770,0,5 user reviews,5,0,5
1202780,0,5 user reviews,3,2,5
1202790,0,5 user reviews,2,3,5
1202820,0,1 user reviews,1,0,1
1202830,0,1 user reviews,0,1,1
1202850,0,1 user reviews,1,0,1
1202860,0,1 user reviews,0,1,1
1202870,7,Positive,12,1,13
1202900,8,Very Positive,600,68,668
1202930,0,1 user reviews,1,0,1
1202970,0,9 user reviews,8,1,9
1202990,0,4 user reviews,3,1,4
1203040,0,6 user reviews,6,0,6
1203042,0,4 user reviews,0,4,4
1203050,0,1 user reviews,1,0,1
1203140,0,4 user reviews,3,1,4
1203240,0,5 user reviews,5,0,5
1203280,0,1 user reviews,1,0,1
1203310,0,1 user reviews,1,0,1
1203350,4,Mostly Negative,14,25,39
1203360,8,Very Positive,85,10,95
1203370,5,Mixed,6,4,10
1203400,0,1 user reviews,1,0,1
1203430,0,1 user reviews,0,1,1
1203440,0,5 user reviews,3,2,5
1203460,7,Positive,9,1,10
1203500,0,3 user reviews,3,0,3
1203510,7,Positive,18,2,20
1203530,0,1 user reviews,0,1,1
1203540,0,1 user reviews,1,0,1
1203541,0,1 user reviews,1,0,1
1203542,0,1 user reviews,0,1,1
1203560,7,Positive,27,6,33
1203570,7,Positive,11,1,12
1203580,0,2 user reviews,2,0,2
1203630,8,Very Positive,461,21,482
1203640,0,2 user reviews,2,0,2
1203650,5,Mixed,14,12,26
1203720,0,4 user reviews,2,2,4
1203750,0,8 user reviews,8,0,8
1203760,0,4 user reviews,2,2,4
1203770,0,4 user reviews,2,2,4
1203790,0,5 user reviews,5,0,5
1203830,0,1 user reviews,1,0,1
1203850,0,4 user reviews,4,0,4
1203930,6,Mostly Positive,184,47,231
1203960,0,7 user reviews,5,2,7
1203970,7,Positive,10,0,10
1203990,0,6 user reviews,5,1,6
1204030,0,1 user reviews,1,0,1
1204070,0,3 user reviews,3,0,3
1204100,0,1 user reviews,1,0,1
1204130,8,Very Positive,145,4,149
1204200,0,2 user reviews,2,0,2
1204210,0,2 user reviews,2,0,2
1204220,7,Positive,9,2,11
1204230,6,Mostly Positive,23,6,29
1204270,0,2 user reviews,1,1,2
1204280,0,4 user reviews,4,0,4
1204320,0,9 user reviews,9,0,9
1204370,7,Positive,20,4,24
1204470,7,Positive,14,1,15
1204480,0,1 user reviews,1,0,1
1204530,0,1 user reviews,1,0,1
1204560,0,5 user reviews,4,1,5
1204580,0,3 user reviews,3,0,3
1204630,0,2 user reviews,2,0,2
1204660,0,3 user reviews,1,2,3
1204700,0,2 user reviews,1,1,2
1204710,7,Positive,13,0,13
1204720,8,Very Positive,104,13,117
1204760,0,8 user reviews,7,1,8
1204850,4,Mostly Negative,4,12,16
1204860,0,1 user reviews,0,1,1
1204880,0,3 user reviews,2,1,3
1204920,5,Mixed,12,16,28
1204930,0,7 user reviews,7,0,7
1205020,0,1 user reviews,0,1,1
1205040,8,Very Positive,94,3,97
1205060,0,5 user reviews,4,1,5
1205100,0,4 user reviews,1,3,4
1205120,0,2 user reviews,2,0,2
1205180,0,2 user reviews,1,1,2
1205230,0,1 user reviews,1,0,1
1205240,8,Very Positive,47,7,54
1205250,0,1 user reviews,1,0,1
1205260,0,6 user reviews,6,0,6
1205361,4,Mostly Negative,4,13,17
1205380,0,6 user reviews,1,5,6
1205430,5,Mixed,91,94,185
1205500,0,2 user reviews,2,0,2
1205501,0,1 user reviews,1,0,1
1205510,0,2 user reviews,2,0,2
1205540,0,7 user reviews,7,0,7
1205600,0,8 user reviews,3,5,8
1205620,0,7 user reviews,3,4,7
1205630,7,Positive,13,0,13
1205670,0,1 user reviews,1,0,1
1205789,0,1 user reviews,1,0,1
1205790,0,1 user reviews,1,0,1
1205800,0,1 user reviews,1,0,1
1205866,0,1 user reviews,0,1,1
1205887,0,1 user reviews,0,1,1
1205900,7,Positive,46,1,47
1205930,7,Positive,10,0,10
1205950,8,Very Positive,117,17,134
1205960,8,Very Positive,77,8,85
1206000,0,7 user reviews,5,2,7
1206040,0,4 user reviews,3,1,4
1206050,0,1 user reviews,1,0,1
1206080,0,4 user reviews,0,4,4
1206110,0,7 user reviews,6,1,7
1206140,0,2 user reviews,1,1,2
1206180,0,1 user reviews,0,1,1
1206190,0,3 user reviews,3,0,3
1206200,5,Mixed,195,241,436
1206230,0,5 user reviews,3,2,5
1206260,0,4 user reviews,4,0,4
1206270,0,2 user reviews,2,0,2
1206280,0,2 user reviews,2,0,2
1206290,0,6 user reviews,6,0,6
1206310,0,1 user reviews,1,0,1
1206320,0,1 user reviews,0,1,1
1206330,0,4 user reviews,4,0,4
1206340,7,Positive,28,0,28
1206350,0,3 user reviews,3,0,3
1206380,0,1 user reviews,1,0,1
1206430,8,Very Positive,109,21,130
1206460,0,1 user reviews,0,1,1
1206470,0,4 user reviews,4,0,4
1206480,5,Mixed,17,13,30
1206490,5,Mixed,12,9,21
1206570,0,3 user reviews,2,1,3
1206620,0,5 user reviews,5,0,5
1206630,0,1 user reviews,1,0,1
1206640,0,1 user reviews,1,0,1
1206660,0,2 user reviews,1,1,2
1206670,7,Positive,33,1,34
1206682,0,1 user reviews,0,1,1
1206683,0,1 user reviews,1,0,1
1206700,7,Positive,10,2,12
1206720,0,3 user reviews,2,1,3
1206730,0,1 user reviews,0,1,1
1206770,0,4 user reviews,4,0,4
1206810,0,2 user reviews,2,0,2
1206821,0,2 user reviews,2,0,2
1206840,0,2 user reviews,0,2,2
1206900,0,3 user reviews,3,0,3
1206910,0,4 user reviews,4,0,4
1206940,7,Positive,11,1,12
1206960,5,Mixed,5,6,11
1207000,0,7 user reviews,7,0,7
1207030,5,Mixed,5,7,12
1207130,0,1 user reviews,1,0,1
1207210,0,1 user reviews,1,0,1
1207230,0,5 user reviews,5,0,5
1207240,0,1 user reviews,1,0,1
1207260,0,2 user reviews,2,0,2
1207310,0,8 user reviews,8,0,8
1207320,0,8 user reviews,7,1,8
1207380,0,4 user reviews,3,1,4
1207400,0,4 user reviews,4,0,4
1207420,0,3 user reviews,3,0,3
1207460,0,1 user reviews,1,0,1
1207480,0,5 user reviews,4,1,5
1207500,0,1 user reviews,1,0,1
1207520,0,1 user reviews,1,0,1
1207540,0,5 user reviews,5,0,5
1207660,0,1 user reviews,1,0,1
1207710,0,7 user reviews,5,2,7
1207780,8,Very Positive,242,25,267
1207840,0,5 user reviews,5,0,5
1207850,5,Mixed,11,15,26
1207860,0,3 user reviews,3,0,3
1207880,7,Positive,29,4,33
1208030,0,3 user reviews,3,0,3
1208050,0,1 user reviews,1,0,1
1208080,0,1 user reviews,1,0,1
1208090,0,4 user reviews,0,4,4
1208120,0,3 user reviews,1,2,3
1208220,7,Positive,9,2,11
1208260,8,Very Positive,124,13,137
1208292,0,1 user reviews,0,1,1
1208330,0,6 user reviews,4,2,6
1208400,0,1 user reviews,1,0,1
1208440,0,4 user reviews,4,0,4
1208470,0,1 user reviews,0,1,1
1208490,0,4 user reviews,2,2,4
1208550,0,2 user reviews,2,0,2
1208580,0,2 user reviews,2,0,2
1208600,8,Very Positive,90,9,99
1208660,0,7 user reviews,7,0,7
1208760,0,9 user reviews,8,1,9
1208770,6,Mostly Positive,64,26,90
1208810,7,Positive,21,0,21
1208850,0,3 user reviews,3,0,3
1208880,0,4 user reviews,3,1,4
1208900,0,7 user reviews,6,1,7
1208950,0,3 user reviews,1,2,3
1209000,0,2 user reviews,1,1,2
1209060,0,4 user reviews,0,4,4
1209110,6,Mostly Positive,108,32,140
1209120,6,Mostly Positive,386,145,531
1209130,4,Mostly Negative,14,24,38
1209131,0,1 user reviews,1,0,1
1209132,0,7 user reviews,3,4,7
1209133,0,5 user reviews,2,3,5
1209134,0,2 user reviews,2,0,2
1209135,0,2 user reviews,2,0,2
1209140,0,1 user reviews,1,0,1
1209150,5,Mixed,7,7,14
1209160,0,1 user reviews,1,0,1
1209170,0,2 user reviews,1,1,2
1209190,0,3 user reviews,1,2,3
1209200,0,4 user reviews,1,3,4
1209330,7,Positive,14,3,17
1209360,6,Mostly Positive,9,3,12
1209430,7,Positive,13,3,16
1209440,0,4 user reviews,3,1,4
1209450,7,Positive,22,0,22
1209461,5,Mixed,28,23,51
1209470,8,Very Positive,186,21,207
1209480,0,1 user reviews,0,1,1
1209490,8,Very Positive,526,110,636
1209520,0,3 user reviews,3,0,3
1209530,0,6 user reviews,6,0,6
1209531,0,8 user reviews,7,1,8
1209532,7,Positive,15,0,15
1209560,0,1 user reviews,1,0,1
1209570,0,6 user reviews,6,0,6
1209590,0,1 user reviews,1,0,1
1209650,0,7 user reviews,6,1,7
1209720,0,4 user reviews,2,2,4
1209740,5,Mixed,6,5,11
1209760,0,2 user reviews,1,1,2
1209900,0,3 user reviews,3,0,3
1209910,7,Positive,34,6,40
1210000,0,2 user reviews,2,0,2
1210010,0,9 user reviews,8,1,9
1210030,0,4 user reviews,4,0,4
1210060,0,4 user reviews,3,1,4
1210090,0,1 user reviews,1,0,1
1210110,5,Mixed,101,49,150
1210150,0,8 user reviews,7,1,8
1210170,0,8 user reviews,5,3,8
1210171,5,Mixed,5,6,11
1210230,7,Positive,31,0,31
1210250,0,5 user reviews,5,0,5
1210270,0,3 user reviews,3,0,3
1210300,0,1 user reviews,1,0,1
1210330,0,6 user reviews,6,0,6
1210340,0,4 user reviews,4,0,4
1210570,0,5 user reviews,5,0,5
1210610,8,Very Positive,81,6,87
1210620,0,7 user reviews,5,2,7
1210660,7,Positive,10,0,10
1210700,0,2 user reviews,1,1,2
1210770,0,6 user reviews,4,2,6
1210790,0,2 user reviews,2,0,2
1210800,7,Positive,27,0,27
1210820,0,4 user reviews,1,3,4
1210830,0,5 user reviews,4,1,5
1210870,7,Positive,15,1,16
1210880,0,2 user reviews,1,1,2
1210960,0,1 user reviews,1,0,1
1210970,0,3 user reviews,3,0,3
1211020,8,Very Positive,161,8,169
1211070,0,1 user reviews,1,0,1
1211100,0,2 user reviews,2,0,2
1211110,8,Very Positive,58,1,59
1211170,7,Positive,10,1,11
1211171,0,2 user reviews,2,0,2
1211173,0,8 user reviews,8,0,8
1211174,7,Positive,45,4,49
1211175,0,2 user reviews,2,0,2
1211176,0,6 user reviews,6,0,6
1211177,0,3 user reviews,3,0,3
1211178,7,Positive,10,0,10
1211179,0,3 user reviews,3,0,3
1211200,0,2 user reviews,2,0,2
1211201,0,5 user reviews,4,1,5
1211202,0,3 user reviews,2,1,3
1211203,0,2 user reviews,2,0,2
1211204,0,3 user reviews,3,0,3
1211205,0,3 user reviews,2,1,3
1211206,0,7 user reviews,7,0,7
1211207,0,5 user reviews,5,0,5
1211208,7,Positive,10,0,10
1211209,7,Positive,10,0,10
1211320,0,2 user reviews,0,2,2
1211360,6,Mostly Positive,42,15,57
1211420,0,3 user reviews,0,3,3
1211470,7,Positive,17,2,19
1211471,0,3 user reviews,1,2,3
1211472,0,2 user reviews,2,0,2
1211473,0,4 user reviews,4,0,4
1211474,0,4 user reviews,3,1,4
1211475,5,Mixed,4,6,10
1211476,0,9 user reviews,5,4,9
1211478,4,Mostly Negative,3,7,10
1211479,0,5 user reviews,4,1,5
1211480,6,Mostly Positive,38,10,48
1211490,0,3 user reviews,2,1,3
1211540,0,3 user reviews,3,0,3
1211610,0,1 user reviews,1,0,1
1211630,8,Very Positive,301,13,314
1211640,5,Mixed,6,8,14
1211671,0,1 user reviews,1,0,1
1211672,0,3 user reviews,3,0,3
1211673,0,5 user reviews,4,1,5
1211674,0,1 user reviews,1,0,1
1211676,0,3 user reviews,3,0,3
1211678,0,1 user reviews,1,0,1
1211680,0,3 user reviews,1,2,3
1211681,0,1 user reviews,1,0,1
1211780,0,1 user reviews,0,1,1
1211820,0,1 user reviews,1,0,1
1211900,0,3 user reviews,2,1,3
1211950,0,2 user reviews,2,0,2
1211960,5,Mixed,5,5,10
1212020,8,Very Positive,95,15,110
1212040,0,4 user reviews,2,2,4
1212080,0,7 user reviews,4,3,7
1212090,0,3 user reviews,2,1,3
1212100,7,Positive,23,4,27
1212110,7,Positive,11,0,11
1212170,0,8 user reviews,6,2,8
1212190,0,9 user reviews,8,1,9
1212290,0,2 user reviews,1,1,2
1212300,0,6 user reviews,6,0,6
1212320,0,1 user reviews,1,0,1
1212370,0,3 user reviews,3,0,3
1212400,7,Positive,36,3,39
1212440,0,2 user reviews,2,0,2
1212450,0,2 user reviews,0,2,2
1212470,0,1 user reviews,0,1,1
1212530,0,2 user reviews,1,1,2
1212590,0,2 user reviews,2,0,2
1212600,0,5 user reviews,0,5,5
1212610,0,3 user reviews,1,2,3
1212620,8,Very Positive,188,13,201
1212640,0,2 user reviews,2,0,2
1212710,0,1 user reviews,1,0,1
1212750,0,2 user reviews,0,2,2
1212810,0,1 user reviews,1,0,1
1212817,0,3 user reviews,3,0,3
1212830,6,Mostly Positive,61,26,87
1212860,0,1 user reviews,1,0,1
1212910,0,2 user reviews,2,0,2
1212930,0,3 user reviews,2,1,3
1212940,8,Very Positive,85,15,100
1213000,0,1 user reviews,1,0,1
1213070,0,2 user reviews,1,1,2
1213140,0,2 user reviews,2,0,2
1213180,0,8 user reviews,5,3,8
1213210,8,Very Positive,7754,649,8403
1213310,0,2 user reviews,0,2,2
1213330,0,3 user reviews,2,1,3
1213370,7,Positive,11,1,12
1213390,6,Mostly Positive,12,4,16
1213420,0,2 user reviews,1,1,2
1213440,6,Mostly Positive,8,3,11
1213480,0,1 user reviews,0,1,1
1213540,0,9 user reviews,6,3,9
1213550,7,Positive,19,0,19
1213570,7,Positive,11,0,11
1213590,0,2 user reviews,0,2,2
1213600,0,2 user reviews,1,1,2
1213640,0,3 user reviews,2,1,3
1213660,0,2 user reviews,2,0,2
1213680,6,Mostly Positive,17,5,22
1213700,8,Very Positive,218,26,244
1213740,6,Mostly Positive,105,32,137
1213750,8,Very Positive,208,16,224
1213760,0,1 user reviews,1,0,1
1213770,0,7 user reviews,7,0,7
1213780,0,2 user reviews,1,1,2
1213860,0,3 user reviews,2,1,3
1213870,0,1 user reviews,1,0,1
1213890,0,1 user reviews,1,0,1
1213940,7,Positive,14,0,14
1213950,0,5 user reviews,4,1,5
1214130,0,1 user reviews,1,0,1
1214150,0,2 user reviews,1,1,2
1214170,0,1 user reviews,1,0,1
1214290,0,1 user reviews,1,0,1
1214320,0,1 user reviews,1,0,1
1214330,8,Very Positive,70,7,77
1214400,0,2 user reviews,1,1,2
1214410,7,Positive,10,0,10
1214420,8,Very Positive,574,101,675
1214450,8,Very Positive,61,4,65
1214460,0,1 user reviews,1,0,1
1214480,7,Positive,17,4,21
1214520,7,Positive,17,0,17
1214530,0,1 user reviews,1,0,1
1214540,0,1 user reviews,1,0,1
1214570,7,Positive,18,1,19
1214590,0,2 user reviews,1,1,2
1214600,0,4 user reviews,1,3,4
1214630,0,1 user reviews,0,1,1
1214680,0,2 user reviews,2,0,2
1214760,0,2 user reviews,2,0,2
1214810,0,7 user reviews,5,2,7
1214850,7,Positive,12,0,12
1214920,0,2 user reviews,2,0,2
1214970,0,1 user reviews,0,1,1
1214980,0,6 user reviews,4,2,6
1214990,0,1 user reviews,1,0,1
1215000,0,8 user reviews,8,0,8
1215050,0,8 user reviews,8,0,8
1215110,7,Positive,10,1,11
1215160,0,2 user reviews,2,0,2
1215180,5,Mixed,25,27,52
1215200,7,Positive,24,3,27
1215230,0,1 user reviews,1,0,1
1215260,6,Mostly Positive,22,6,28
1215270,7,Positive,44,1,45
1215280,7,Positive,27,2,29
1215320,7,Positive,10,0,10
1215350,0,1 user reviews,1,0,1
1215360,0,1 user reviews,1,0,1
1215380,0,1 user reviews,1,0,1
1215390,8,Very Positive,120,3,123
1215410,0,5 user reviews,1,4,5
1215500,0,6 user reviews,6,0,6
1215520,0,1 user reviews,1,0,1
1215540,0,3 user reviews,2,1,3
1215550,5,Mixed,5,6,11
1215640,0,1 user reviews,1,0,1
1215650,0,5 user reviews,3,2,5
1215660,0,1 user reviews,1,0,1
1215690,0,2 user reviews,1,1,2
1215700,0,3 user reviews,3,0,3
1215710,0,8 user reviews,4,4,8
1215750,7,Positive,10,0,10
1215770,0,6 user reviews,6,0,6
1215830,0,1 user reviews,1,0,1
1215860,5,Mixed,6,4,10
1215870,4,Mostly Negative,4,7,11
1215900,0,2 user reviews,2,0,2
1215930,0,8 user reviews,5,3,8
1215950,0,2 user reviews,0,2,2
1215960,0,3 user reviews,2,1,3
1216050,0,6 user reviews,6,0,6
1216130,0,6 user reviews,5,1,6
1216150,0,3 user reviews,3,0,3
1216180,0,4 user reviews,3,1,4
1216200,0,3 user reviews,3,0,3
1216230,7,Positive,20,2,22
1216300,0,3 user reviews,3,0,3
1216320,8,Very Positive,1251,113,1364
1216350,0,7 user reviews,6,1,7
1216370,0,4 user reviews,1,3,4
1216480,0,1 user reviews,1,0,1
1216490,8,Very Positive,78,0,78
1216510,0,2 user reviews,1,1,2
1216540,7,Positive,12,2,14
1216550,0,2 user reviews,1,1,2
1216590,7,Positive,13,3,16
1216610,0,4 user reviews,2,2,4
1216640,0,2 user reviews,1,1,2
1216660,0,4 user reviews,2,2,4
1216710,8,Very Positive,103,11,114
1216720,0,7 user reviews,3,4,7
1216790,0,1 user reviews,1,0,1
1216792,0,1 user reviews,1,0,1
1216793,0,1 user reviews,1,0,1
1216794,0,2 user reviews,1,1,2
1216880,8,Very Positive,67,14,81
1216930,0,2 user reviews,1,1,2
1216950,0,4 user reviews,4,0,4
1216952,0,1 user reviews,1,0,1
1216954,0,1 user reviews,1,0,1
1216980,0,1 user reviews,1,0,1
1217050,8,Very Positive,65,7,72
1217060,9,Overwhelmingly Positive,8178,327,8505
1217070,0,2 user reviews,2,0,2
1217220,0,1 user reviews,0,1,1
1217260,0,6 user reviews,5,1,6
1217310,0,4 user reviews,4,0,4
1217330,0,6 user reviews,5,1,6
1217350,0,9 user reviews,9,0,9
1217370,0,2 user reviews,1,1,2
1217380,0,5 user reviews,4,1,5
1217390,7,Positive,35,1,36
1217401,0,2 user reviews,2,0,2
1217480,0,1 user reviews,0,1,1
1217560,0,1 user reviews,1,0,1
1217570,7,Positive,8,2,10
1217580,0,1 user reviews,1,0,1
1217610,0,3 user reviews,2,1,3
1217630,0,2 user reviews,0,2,2
1217640,0,4 user reviews,3,1,4
1217720,7,Positive,13,1,14
1217840,0,3 user reviews,3,0,3
1217860,0,7 user reviews,5,2,7
1217870,0,3 user reviews,3,0,3
1217900,0,4 user reviews,4,0,4
1217970,0,1 user reviews,1,0,1
1218010,0,1 user reviews,0,1,1
1218030,0,1 user reviews,1,0,1
1218090,0,2 user reviews,1,1,2
1218200,0,3 user reviews,2,1,3
1218230,7,Positive,9,1,10
1218280,8,Very Positive,128,22,150
1218310,0,3 user reviews,3,0,3
1218390,0,1 user reviews,0,1,1
1218420,0,2 user reviews,0,2,2
1218520,7,Positive,21,0,21
1218560,0,1 user reviews,1,0,1
1218570,7,Positive,18,3,21
1218580,0,2 user reviews,2,0,2
1218680,0,3 user reviews,2,1,3
1218710,0,2 user reviews,0,2,2
1218720,0,9 user reviews,5,4,9
1218760,0,2 user reviews,1,1,2
1218770,0,4 user reviews,1,3,4
1218790,0,3 user reviews,2,1,3
1218810,0,3 user reviews,3,0,3
1218830,7,Positive,14,2,16
1218890,0,8 user reviews,6,2,8
1218920,6,Mostly Positive,14,4,18
1219020,0,6 user reviews,5,1,6
1219120,0,1 user reviews,1,0,1
1219130,0,3 user reviews,3,0,3
1219140,0,1 user reviews,1,0,1
1219220,0,1 user reviews,0,1,1
1219230,0,8 user reviews,6,2,8
1219320,0,9 user reviews,7,2,9
1219420,0,4 user reviews,4,0,4
1219440,0,1 user reviews,1,0,1
1219500,0,3 user reviews,3,0,3
1219520,0,3 user reviews,0,3,3
1219580,0,9 user reviews,7,2,9
1219610,0,6 user reviews,4,2,6
1219650,0,5 user reviews,4,1,5
1219700,0,8 user reviews,8,0,8
1219730,0,4 user reviews,4,0,4
1219750,0,1 user reviews,1,0,1
1219820,0,1 user reviews,1,0,1
1219850,0,1 user reviews,1,0,1
1219852,0,1 user reviews,1,0,1
1219860,0,6 user reviews,5,1,6
1219940,5,Mixed,11,7,18
1219950,8,Very Positive,140,16,156
1219980,0,4 user reviews,4,0,4
1219990,0,9 user reviews,9,0,9
1220070,0,1 user reviews,0,1,1
1220080,7,Positive,8,2,10
1220120,5,Mixed,6,4,10
1220160,0,1 user reviews,1,0,1
1220190,0,4 user reviews,2,2,4
1220340,0,5 user reviews,2,3,5
1220360,0,1 user reviews,0,1,1
1220370,6,Mostly Positive,14,4,18
1220420,0,1 user reviews,1,0,1
1220421,0,1 user reviews,1,0,1
1220510,0,2 user reviews,2,0,2
1220520,0,1 user reviews,1,0,1
1220540,0,1 user reviews,0,1,1
1220580,0,1 user reviews,0,1,1
1220690,0,2 user reviews,2,0,2
1220710,0,3 user reviews,3,0,3
1220850,0,2 user reviews,1,1,2
1220890,0,2 user reviews,1,1,2
1220910,0,1 user reviews,1,0,1
1220920,0,4 user reviews,3,1,4
1220980,0,2 user reviews,0,2,2
1221030,0,5 user reviews,5,0,5
1221050,0,7 user reviews,4,3,7
1221070,0,4 user reviews,3,1,4
1221080,8,Very Positive,165,38,203
1221220,0,1 user reviews,1,0,1
1221230,0,4 user reviews,4,0,4
1221240,5,Mixed,6,5,11
1221280,0,1 user reviews,1,0,1
1221290,0,4 user reviews,3,1,4
1221320,0,4 user reviews,4,0,4
1221330,0,1 user reviews,1,0,1
1221360,0,1 user reviews,1,0,1
1221390,0,1 user reviews,1,0,1
1221400,0,1 user reviews,1,0,1
1221440,6,Mostly Positive,7,3,10
1221460,0,8 user reviews,3,5,8
1221510,0,2 user reviews,1,1,2
1221520,0,2 user reviews,1,1,2
1221540,7,Positive,24,6,30
1221590,7,Positive,8,2,10
1221600,0,1 user reviews,1,0,1
1221630,0,4 user reviews,4,0,4
1221640,7,Positive,15,0,15
1221660,0,1 user reviews,0,1,1
1221700,0,7 user reviews,5,2,7
1221790,0,3 user reviews,3,0,3
1221800,7,Positive,10,1,11
1221830,0,2 user reviews,2,0,2
1221850,0,1 user reviews,1,0,1
1221860,0,3 user reviews,3,0,3
1221880,0,4 user reviews,4,0,4
1221900,0,4 user reviews,3,1,4
1221990,7,Positive,10,0,10
1222000,0,2 user reviews,2,0,2
1222020,7,Positive,15,0,15
1222040,8,Very Positive,64,5,69
1222050,5,Mixed,20,14,34
1222140,8,Very Positive,3801,440,4241
1222160,0,8 user reviews,7,1,8
1222170,0,7 user reviews,6,1,7
1222180,0,7 user reviews,4,3,7
1222220,0,1 user reviews,1,0,1
1222230,0,1 user reviews,1,0,1
1222240,0,1 user reviews,1,0,1
1222250,0,1 user reviews,1,0,1
1222270,0,4 user reviews,4,0,4
1222300,8,Very Positive,67,5,72
1222400,6,Mostly Positive,31,13,44
1222470,0,6 user reviews,4,2,6
1222580,0,4 user reviews,3,1,4
1222600,7,Positive,25,4,29
1222610,0,8 user reviews,7,1,8
1222640,0,6 user reviews,2,4,6
1222670,8,Very Positive,1416,200,1616
1222680,8,Very Positive,2821,645,3466
1222690,6,Mostly Positive,634,264,898
1222700,8,Very Positive,1388,227,1615
1222730,6,Mostly Positive,7122,2492,9614
1222760,0,4 user reviews,3,1,4
1222870,0,1 user reviews,0,1,1
1222930,0,9 user reviews,6,3,9
1222980,0,2 user reviews,2,0,2
1223060,6,Mostly Positive,19,5,24
1223090,0,4 user reviews,2,2,4
1223110,0,7 user reviews,7,0,7
1223130,0,1 user reviews,1,0,1
1223210,0,2 user reviews,1,1,2
1223250,7,Positive,14,1,15
1223260,0,6 user reviews,6,0,6
1223270,0,3 user reviews,1,2,3
1223290,0,3 user reviews,3,0,3
1223300,0,1 user reviews,1,0,1
1223350,0,9 user reviews,5,4,9
1223370,0,5 user reviews,5,0,5
1223380,0,2 user reviews,1,1,2
1223390,0,3 user reviews,3,0,3
1223490,5,Mixed,21,10,31
1223500,8,Very Positive,126,7,133
1223580,8,Very Positive,45,6,51
1223750,6,Mostly Positive,279,105,384
1223810,8,Very Positive,115,3,118
1223830,0,1 user reviews,1,0,1
1223860,7,Positive,40,1,41
1223880,0,2 user reviews,2,0,2
1223910,5,Mixed,8,9,17
1224000,0,3 user reviews,3,0,3
1224020,8,Very Positive,106,19,125
1224100,0,1 user reviews,1,0,1
1224120,7,Positive,17,3,20
1224130,0,5 user reviews,3,2,5
1224140,0,1 user reviews,1,0,1
1224160,8,Very Positive,174,8,182
1224290,8,Very Positive,206,13,219
1224320,0,1 user reviews,1,0,1
1224340,5,Mixed,14,8,22
1224341,5,Mixed,12,9,21
1224350,0,7 user reviews,7,0,7
1224370,0,1 user reviews,1,0,1
1224380,0,9 user reviews,4,5,9
1224450,7,Positive,22,0,22
1224480,6,Mostly Positive,11,4,15
1224490,0,1 user reviews,1,0,1
1224530,6,Mostly Positive,34,13,47
1224550,0,1 user reviews,1,0,1
1224600,8,Very Positive,94,17,111
1224690,5,Mixed,38,24,62
1224720,0,3 user reviews,0,3,3
1224740,0,1 user reviews,1,0,1
1224760,0,1 user reviews,1,0,1
1224783,0,1 user reviews,1,0,1
1224796,0,1 user reviews,0,1,1
1224820,0,5 user reviews,5,0,5
1224821,0,1 user reviews,1,0,1
1224827,0,2 user reviews,2,0,2
1224832,0,1 user reviews,1,0,1
1224872,0,1 user reviews,1,0,1
1224940,0,2 user reviews,0,2,2
1225070,6,Mostly Positive,10,3,13
1225110,5,Mixed,14,12,26
1225120,7,Positive,11,0,11
1225130,0,7 user reviews,6,1,7
1225140,7,Positive,27,2,29
1225210,7,Positive,18,3,21
1225260,0,5 user reviews,3,2,5
1225300,0,1 user reviews,1,0,1
1225320,0,2 user reviews,1,1,2
1225330,5,Mixed,847,959,1806
1225370,0,1 user reviews,1,0,1
1225550,5,Mixed,6,6,12
1225560,8,Very Positive,120,22,142
1225570,8,Very Positive,86,21,107
1225580,7,Positive,27,4,31
1225590,8,Very Positive,120,18,138
1225600,7,Positive,9,1,10
1225610,0,6 user reviews,6,0,6
1225640,0,2 user reviews,2,0,2
1225710,0,2 user reviews,2,0,2
1225720,0,1 user reviews,1,0,1
1225740,0,3 user reviews,1,2,3
1225780,0,8 user reviews,8,0,8
1225840,0,2 user reviews,2,0,2
1225870,0,8 user reviews,6,2,8
1225910,0,1 user reviews,0,1,1
1225920,0,3 user reviews,1,2,3
1225960,0,2 user reviews,2,0,2
1226000,7,Positive,38,4,42
1226010,0,3 user reviews,3,0,3
1226080,0,2 user reviews,1,1,2
1226170,0,1 user reviews,1,0,1
1226210,0,7 user reviews,5,2,7
1226230,0,1 user reviews,1,0,1
1226420,0,1 user reviews,0,1,1
1226470,5,Mixed,32,32,64
1226490,0,2 user reviews,1,1,2
1226500,0,1 user reviews,1,0,1
1226530,8,Very Positive,64,4,68
1226540,5,Mixed,11,8,19
1226640,6,Mostly Positive,36,10,46
1226690,5,Mixed,8,5,13
1226850,0,1 user reviews,1,0,1
1226890,0,4 user reviews,3,1,4
1226910,0,5 user reviews,1,4,5
1226920,0,1 user reviews,1,0,1
1226940,0,1 user reviews,0,1,1
1226960,3,Negative,2,11,13
1226990,8,Very Positive,191,19,210
1227000,0,3 user reviews,0,3,3
1227010,0,3 user reviews,3,0,3
1227030,0,2 user reviews,2,0,2
1227090,0,1 user reviews,0,1,1
1227160,5,Mixed,19,13,32
1227190,0,1 user reviews,1,0,1
1227350,6,Mostly Positive,62,18,80
1227360,5,Mixed,12,6,18
1227390,0,1 user reviews,1,0,1
1227400,8,Very Positive,49,2,51
1227490,0,2 user reviews,1,1,2
1227510,0,1 user reviews,1,0,1
1227530,6,Mostly Positive,199,53,252
1227580,0,1 user reviews,0,1,1
1227590,0,8 user reviews,7,1,8
1227600,7,Positive,9,1,10
1227730,0,6 user reviews,5,1,6
1227740,0,4 user reviews,4,0,4
1227750,7,Positive,12,2,14
1227760,0,5 user reviews,2,3,5
1227780,6,Mostly Positive,337,105,442
1227860,0,9 user reviews,9,0,9
1227890,8,Very Positive,79,7,86
1227900,0,1 user reviews,1,0,1
1227910,0,8 user reviews,7,1,8
1228340,0,3 user reviews,3,0,3
1228410,0,2 user reviews,2,0,2
1228440,0,1 user reviews,1,0,1
1228490,0,1 user reviews,1,0,1
1228510,0,4 user reviews,2,2,4
1228520,8,Very Positive,303,56,359
1228530,8,Very Positive,76,10,86
1228560,7,Positive,33,6,39
1228570,4,Mostly Negative,6,14,20
1228600,7,Positive,20,1,21
1228660,0,5 user reviews,4,1,5
1228680,0,8 user reviews,7,1,8
1228720,0,2 user reviews,1,1,2
1228730,0,1 user reviews,1,0,1
1228740,0,6 user reviews,6,0,6
1228760,0,2 user reviews,2,0,2
1228790,0,6 user reviews,4,2,6
1228810,0,7 user reviews,6,1,7
1228840,0,1 user reviews,0,1,1
1228860,0,1 user reviews,1,0,1
1228870,0,6 user reviews,6,0,6
1228910,0,2 user reviews,1,1,2
1228920,0,2 user reviews,0,2,2
1228960,0,4 user reviews,4,0,4
1228970,0,1 user reviews,1,0,1
1229010,0,3 user reviews,1,2,3
1229030,7,Positive,19,4,23
1229040,0,2 user reviews,1,1,2
1229100,0,1 user reviews,1,0,1
1229170,0,1 user reviews,1,0,1
1229190,0,1 user reviews,1,0,1
1229250,0,3 user reviews,1,2,3
1229260,0,4 user reviews,4,0,4
1229280,0,5 user reviews,5,0,5
1229310,6,Mostly Positive,14,5,19
1229320,0,4 user reviews,3,1,4
1229370,0,2 user reviews,1,1,2
1229420,5,Mixed,14,18,32
1229490,9,Overwhelmingly Positive,2384,9,2393
1229500,0,6 user reviews,2,4,6
1229510,0,2 user reviews,1,1,2
1229580,8,Very Positive,86,2,88
1229590,0,1 user reviews,1,0,1
1229640,0,1 user reviews,0,1,1
1229650,0,3 user reviews,3,0,3
1229720,0,1 user reviews,0,1,1
1229730,5,Mixed,5,6,11
1229900,8,Very Positive,123,14,137
1229970,0,1 user reviews,1,0,1
1230100,0,5 user reviews,2,3,5
1230140,8,Very Positive,132,3,135
1230200,0,9 user reviews,8,1,9
1230230,7,Positive,22,0,22
1230270,0,7 user reviews,2,5,7
1230271,7,Positive,15,1,16
1230272,0,2 user reviews,2,0,2
1230273,0,3 user reviews,3,0,3
1230274,0,3 user reviews,3,0,3
1230275,4,Mostly Negative,5,10,15
1230276,0,2 user reviews,2,0,2
1230277,3,Negative,3,14,17
1230278,0,2 user reviews,1,1,2
1230279,7,Positive,37,1,38
1230300,0,2 user reviews,2,0,2
1230340,7,Positive,9,2,11
1230430,0,1 user reviews,1,0,1
1230480,0,1 user reviews,1,0,1
1230481,0,5 user reviews,3,2,5
1230483,0,1 user reviews,0,1,1
1230510,6,Mostly Positive,27,7,34
1230560,7,Positive,22,5,27
1230570,0,2 user reviews,1,1,2
1230580,0,1 user reviews,1,0,1
1230650,0,5 user reviews,5,0,5
1230660,0,2 user reviews,2,0,2
1230760,7,Positive,26,4,30
1230790,0,1 user reviews,0,1,1
1230800,8,Very Positive,51,4,55
1230830,0,3 user reviews,3,0,3
1230860,7,Positive,32,3,35
1230870,0,1 user reviews,0,1,1
1230990,0,7 user reviews,7,0,7
1231040,0,1 user reviews,0,1,1
1231090,0,2 user reviews,0,2,2
1231120,0,1 user reviews,1,0,1
1231130,0,1 user reviews,1,0,1
1231180,0,1 user reviews,0,1,1
1231190,0,1 user reviews,0,1,1
1231250,0,3 user reviews,3,0,3
1231270,0,1 user reviews,1,0,1
1231290,0,5 user reviews,5,0,5
1231520,6,Mostly Positive,14,4,18
1231580,0,8 user reviews,4,4,8
1231640,0,3 user reviews,3,0,3
1231660,0,2 user reviews,2,0,2
1231670,0,1 user reviews,1,0,1
1231690,0,2 user reviews,2,0,2
1231740,0,7 user reviews,6,1,7
1231750,0,4 user reviews,2,2,4
1231760,0,2 user reviews,0,2,2
1231800,0,1 user reviews,0,1,1
1231820,0,2 user reviews,0,2,2
1231940,0,4 user reviews,4,0,4
1231950,7,Positive,12,1,13
1231970,7,Positive,14,3,17
1231980,0,1 user reviews,1,0,1
1232010,7,Positive,16,0,16
1232030,0,2 user reviews,2,0,2
1232070,8,Very Positive,52,10,62
1232100,7,Positive,14,0,14
1232120,0,1 user reviews,0,1,1
1232130,7,Positive,43,4,47
1232140,6,Mostly Positive,10,3,13
1232180,8,Very Positive,419,7,426
1232230,0,1 user reviews,1,0,1
1232251,4,Mostly Negative,9,26,35
1232252,0,3 user reviews,0,3,3
1232253,5,Mixed,28,23,51
1232254,5,Mixed,18,24,42
1232255,2,Very Negative,11,67,78
1232256,8,Very Positive,181,16,197
1232257,6,Mostly Positive,234,87,321
1232260,0,3 user reviews,3,0,3
1232290,0,1 user reviews,1,0,1
1232310,0,4 user reviews,3,1,4
1232330,8,Very Positive,52,2,54
1232380,0,3 user reviews,1,2,3
1232390,0,2 user reviews,2,0,2
1232430,0,3 user reviews,3,0,3
1232460,6,Mostly Positive,37,14,51
1232500,0,2 user reviews,1,1,2
1232520,0,7 user reviews,7,0,7
1232540,0,1 user reviews,0,1,1
1232570,8,Very Positive,106,4,110
1232580,8,Very Positive,47,10,57
1232590,7,Positive,20,3,23
1232640,0,9 user reviews,8,1,9
1232670,0,1 user reviews,1,0,1
1232730,0,1 user reviews,0,1,1
1232740,0,6 user reviews,6,0,6
1232780,0,1 user reviews,1,0,1
1232810,0,8 user reviews,8,0,8
1232830,0,1 user reviews,1,0,1
1232910,0,2 user reviews,2,0,2
1232940,7,Positive,36,3,39
1233030,0,1 user reviews,1,0,1
1233060,5,Mixed,90,104,194
1233061,4,Mostly Negative,95,182,277
1233062,5,Mixed,45,29,74
1233100,0,7 user reviews,7,0,7
1233120,0,1 user reviews,0,1,1
1233170,5,Mixed,12,6,18
1233220,0,9 user reviews,9,0,9
1233230,0,5 user reviews,5,0,5
1233240,0,1 user reviews,1,0,1
1233250,0,5 user reviews,5,0,5
1233260,5,Mixed,302,142,444
1233270,8,Very Positive,82,7,89
1233280,0,1 user reviews,1,0,1
1233330,0,2 user reviews,2,0,2
1233340,0,1 user reviews,1,0,1
1233350,5,Mixed,8,4,12
1233370,0,7 user reviews,3,4,7
1233371,5,Mixed,7,5,12
1233380,0,8 user reviews,4,4,8
1233420,6,Mostly Positive,7,3,10
1233460,0,1 user reviews,1,0,1
1233540,7,Positive,33,0,33
1233550,6,Mostly Positive,262,85,347
1233570,8,Very Positive,761,164,925
1233580,0,3 user reviews,3,0,3
1233600,0,1 user reviews,0,1,1
1233690,7,Positive,43,2,45
1233710,5,Mixed,25,20,45
1233720,7,Positive,17,2,19
1233780,6,Mostly Positive,53,17,70
1233800,8,Very Positive,45,8,53
1233820,7,Positive,22,3,25
1233840,0,5 user reviews,3,2,5
1233850,0,7 user reviews,3,4,7
1233880,8,Very Positive,101,3,104
1233900,5,Mixed,13,12,25
1233950,8,Very Positive,96,2,98
1233990,0,1 user reviews,0,1,1
1234030,0,1 user reviews,1,0,1
1234120,0,2 user reviews,1,1,2
1234190,8,Very Positive,51,9,60
1234220,7,Positive,19,2,21
1234240,7,Positive,20,2,22
1234260,7,Positive,18,2,20
1234270,0,1 user reviews,1,0,1
1234380,0,3 user reviews,0,3,3
1234392,0,1 user reviews,0,1,1
1234450,5,Mixed,10,15,25
1234490,0,1 user reviews,1,0,1
1234520,8,Very Positive,285,12,297
1234540,0,2 user reviews,2,0,2
1234550,6,Mostly Positive,10,4,14
1234580,0,2 user reviews,2,0,2
1234620,8,Very Positive,64,7,71
1234700,0,5 user reviews,5,0,5
1234750,0,5 user reviews,4,1,5
1234760,0,4 user reviews,2,2,4
1234820,0,1 user reviews,0,1,1
1234830,0,9 user reviews,7,2,9
1234840,5,Mixed,7,4,11
1234850,0,3 user reviews,3,0,3
1234890,0,1 user reviews,1,0,1
1234900,0,2 user reviews,1,1,2
1234930,0,1 user reviews,1,0,1
1234940,7,Positive,12,0,12
1234950,6,Mostly Positive,10,4,14
1234980,0,2 user reviews,1,1,2
1235060,0,1 user reviews,1,0,1
1235080,0,1 user reviews,1,0,1
1235090,0,4 user reviews,3,1,4
1235110,7,Positive,40,4,44
1235120,7,Positive,28,4,32
1235130,0,3 user reviews,3,0,3
1235160,0,1 user reviews,1,0,1
1235330,0,1 user reviews,1,0,1
1235350,0,3 user reviews,3,0,3
1235360,8,Very Positive,60,3,63
1235400,0,2 user reviews,2,0,2
1235460,0,8 user reviews,5,3,8
1235480,0,2 user reviews,0,2,2
1235520,0,2 user reviews,1,1,2
1235570,0,2 user reviews,2,0,2
1235720,0,3 user reviews,3,0,3
1235721,5,Mixed,6,4,10
1235722,0,3 user reviews,1,2,3
1235730,0,1 user reviews,1,0,1
1235731,0,1 user reviews,1,0,1
1235732,0,4 user reviews,3,1,4
1235733,0,4 user reviews,3,1,4
1235734,0,3 user reviews,3,0,3
1235743,0,2 user reviews,1,1,2
1235746,0,2 user reviews,2,0,2
1235747,0,1 user reviews,0,1,1
1235751,0,1 user reviews,1,0,1
1235755,0,1 user reviews,0,1,1
1235757,0,1 user reviews,1,0,1
1235758,0,1 user reviews,1,0,1
1235759,0,1 user reviews,1,0,1
1235766,0,1 user reviews,1,0,1
1235770,0,1 user reviews,1,0,1
1235910,6,Mostly Positive,7,3,10
1236000,0,3 user reviews,2,1,3
1236040,7,Positive,10,2,12
1236140,0,2 user reviews,1,1,2
1236160,7,Positive,11,0,11
1236190,7,Positive,9,2,11
1236260,0,1 user reviews,1,0,1
1236320,0,4 user reviews,1,3,4
1236330,0,1 user reviews,0,1,1
1236360,5,Mixed,14,9,23
1236400,0,5 user reviews,2,3,5
1236450,0,1 user reviews,1,0,1
1236480,0,3 user reviews,1,2,3
1236500,5,Mixed,17,9,26
1236501,0,8 user reviews,6,2,8
1236530,0,6 user reviews,4,2,6
1236640,0,5 user reviews,5,0,5
1236670,0,3 user reviews,2,1,3
1236700,7,Positive,43,1,44
1236720,8,Very Positive,143,17,160
1236760,0,5 user reviews,3,2,5
1236790,0,1 user reviews,1,0,1
1236810,0,4 user reviews,4,0,4
1236860,0,5 user reviews,5,0,5
1236880,0,1 user reviews,1,0,1
1236890,7,Positive,16,0,16
1236900,0,9 user reviews,8,1,9
1236920,0,1 user reviews,0,1,1
1236960,0,1 user reviews,1,0,1
1236990,8,Very Positive,686,48,734
1237020,0,1 user reviews,1,0,1
1237080,5,Mixed,16,10,26
1237090,0,2 user reviews,2,0,2
1237100,0,1 user reviews,1,0,1
1237220,0,6 user reviews,3,3,6
1237260,0,3 user reviews,3,0,3
1237270,7,Positive,17,3,20
1237410,0,1 user reviews,0,1,1
1237420,0,2 user reviews,2,0,2
1237430,0,8 user reviews,8,0,8
1237480,0,1 user reviews,0,1,1
1237490,0,7 user reviews,6,1,7
1237523,0,9 user reviews,8,1,9
1237524,0,4 user reviews,4,0,4
1237530,7,Positive,10,1,11
1237540,5,Mixed,22,14,36
1237560,0,1 user reviews,1,0,1
1237570,0,5 user reviews,4,1,5
1237610,6,Mostly Positive,43,15,58
1237630,0,2 user reviews,1,1,2
1237670,0,1 user reviews,1,0,1
1237700,0,1 user reviews,1,0,1
1237720,0,5 user reviews,3,2,5
1237721,4,Mostly Negative,8,16,24
1237760,0,3 user reviews,2,1,3
1237770,0,2 user reviews,2,0,2
1237800,0,5 user reviews,3,2,5
1237820,0,2 user reviews,1,1,2
1237830,6,Mostly Positive,8,3,11
1237840,0,1 user reviews,0,1,1
1237860,0,1 user reviews,0,1,1
1237870,0,3 user reviews,3,0,3
1237880,0,5 user reviews,4,1,5
1237900,0,2 user reviews,2,0,2
1237950,8,Very Positive,2953,490,3443
1237970,9,Overwhelmingly Positive,13377,505,13882
1237980,6,Mostly Positive,154,66,220
1238000,6,Mostly Positive,664,180,844
1238020,5,Mixed,267,138,405
1238030,5,Mixed,7,6,13
1238040,6,Mostly Positive,215,61,276
1238050,5,Mixed,5,7,12
1238060,6,Mostly Positive,409,130,539
1238070,4,Mostly Negative,7,13,20
1238080,5,Mixed,492,323,815
1238090,0,5 user reviews,5,0,5
1238100,0,4 user reviews,4,0,4
1238101,3,Negative,0,27,27
1238102,0,1 user reviews,1,0,1
1238103,7,Positive,21,3,24
1238104,0,4 user reviews,3,1,4
1238105,0,4 user reviews,3,1,4
1238200,0,1 user reviews,1,0,1
1238220,0,1 user reviews,1,0,1
1238250,0,5 user reviews,5,0,5
1238320,6,Mostly Positive,9,3,12
1238330,7,Positive,14,1,15
1238340,0,1 user reviews,1,0,1
1238360,7,Positive,8,2,10
1238400,0,9 user reviews,7,2,9
1238430,0,3 user reviews,3,0,3
1238440,5,Mixed,97,64,161
1238520,0,5 user reviews,4,1,5
1238630,0,1 user reviews,0,1,1
1238660,0,2 user reviews,2,0,2
1238680,0,6 user reviews,6,0,6
1238710,0,1 user reviews,1,0,1
1238730,7,Positive,40,0,40
1238760,7,Positive,15,3,18
1238810,5,Mixed,925,505,1430
1238820,5,Mixed,441,412,853
1238831,0,1 user reviews,0,1,1
1238840,6,Mostly Positive,827,220,1047
1238851,0,2 user reviews,2,0,2
1238860,6,Mostly Positive,1820,456,2276
1238871,0,5 user reviews,3,2,5
1238880,5,Mixed,105,85,190
1238970,0,1 user reviews,1,0,1
1239000,7,Positive,9,2,11
1239010,0,4 user reviews,4,0,4
1239050,8,Very Positive,126,13,139
1239090,0,1 user reviews,0,1,1
1239110,0,1 user reviews,1,0,1
1239120,0,1 user reviews,1,0,1
1239130,0,5 user reviews,5,0,5
1239150,0,1 user reviews,1,0,1
1239250,0,3 user reviews,2,1,3
1239260,6,Mostly Positive,20,7,27
1239270,0,2 user reviews,1,1,2
1239400,0,1 user reviews,1,0,1
1239430,4,Mostly Negative,148,235,383
1239440,5,Mixed,51,26,77
1239450,7,Positive,38,0,38
1239470,0,3 user reviews,3,0,3
1239490,0,1 user reviews,1,0,1
1239510,0,6 user reviews,6,0,6
1239511,0,5 user reviews,5,0,5
1239512,0,3 user reviews,3,0,3
1239513,0,4 user reviews,4,0,4
1239514,7,Positive,13,0,13
1239520,5,Mixed,434,565,999
1239580,7,Positive,12,1,13
1239590,0,2 user reviews,0,2,2
1239660,5,Mixed,13,14,27
1239680,0,1 user reviews,1,0,1
1239690,9,Overwhelmingly Positive,1108,44,1152
1239700,8,Very Positive,445,21,466
1239890,0,4 user reviews,4,0,4
1239970,0,2 user reviews,1,1,2
1239990,0,2 user reviews,2,0,2
1240040,0,2 user reviews,2,0,2
1240050,7,Positive,35,8,43
1240090,0,3 user reviews,2,1,3
1240100,0,1 user reviews,1,0,1
1240200,0,1 user reviews,1,0,1
1240210,9,Overwhelmingly Positive,1486,36,1522
1240230,8,Very Positive,113,14,127
1240240,7,Positive,19,0,19
1240360,6,Mostly Positive,9,3,12
1240370,0,6 user reviews,6,0,6
1240390,0,9 user reviews,9,0,9
1240490,0,2 user reviews,0,2,2
1240600,0,1 user reviews,0,1,1
1240630,7,Positive,11,2,13
1240690,0,3 user reviews,3,0,3
1240730,0,8 user reviews,5,3,8
1240750,0,4 user reviews,4,0,4
1240760,0,1 user reviews,1,0,1
1240770,0,1 user reviews,1,0,1
1240830,0,1 user reviews,0,1,1
1240840,0,2 user reviews,2,0,2
1240890,0,3 user reviews,1,2,3
1240930,0,2 user reviews,2,0,2
1241020,5,Mixed,11,9,20
1241040,6,Mostly Positive,47,17,64
1241100,5,Mixed,15,7,22
1241110,0,3 user reviews,2,1,3
1241140,0,3 user reviews,2,1,3
1241260,0,1 user reviews,1,0,1
1241261,0,6 user reviews,4,2,6
1241262,0,5 user reviews,3,2,5
1241263,0,1 user reviews,1,0,1
1241264,0,2 user reviews,2,0,2
1241265,0,2 user reviews,2,0,2
1241266,0,2 user reviews,2,0,2
1241267,0,8 user reviews,8,0,8
1241268,0,4 user reviews,4,0,4
1241269,0,1 user reviews,1,0,1
1241271,7,Positive,30,1,31
1241272,0,1 user reviews,1,0,1
1241273,0,1 user reviews,1,0,1
1241274,0,1 user reviews,1,0,1
1241275,0,6 user reviews,6,0,6
1241276,0,3 user reviews,3,0,3
1241277,0,3 user reviews,3,0,3
1241278,0,2 user reviews,2,0,2
1241279,0,4 user reviews,4,0,4
1241280,0,1 user reviews,1,0,1
1241281,0,1 user reviews,1,0,1
1241282,0,1 user reviews,1,0,1
1241283,0,2 user reviews,2,0,2
1241284,0,3 user reviews,3,0,3
1241285,0,1 user reviews,1,0,1
1241286,0,2 user reviews,2,0,2
1241287,0,4 user reviews,4,0,4
1241288,0,2 user reviews,1,1,2
1241290,0,2 user reviews,2,0,2
1241291,0,1 user reviews,1,0,1
1241292,0,1 user reviews,1,0,1
1241293,0,1 user reviews,1,0,1
1241294,0,1 user reviews,1,0,1
1241295,0,2 user reviews,1,1,2
1241296,0,2 user reviews,2,0,2
1241297,0,1 user reviews,1,0,1
1241298,0,2 user reviews,2,0,2
1241299,0,1 user reviews,1,0,1
1241300,0,3 user reviews,3,0,3
1241340,0,3 user reviews,1,2,3
1241510,9,Overwhelmingly Positive,2448,113,2561
1241520,8,Very Positive,598,39,637
1241550,5,Mixed,90,54,144
1241570,0,8 user reviews,6,2,8
1241780,0,1 user reviews,1,0,1
1241860,0,1 user reviews,1,0,1
1241880,0,3 user reviews,3,0,3
1241910,6,Mostly Positive,31,12,43
1242670,0,5 user reviews,5,0,5
1242680,0,1 user reviews,0,1,1
1242710,0,1 user reviews,1,0,1
1242740,0,7 user reviews,7,0,7
1242748,0,2 user reviews,2,0,2
1242749,7,Positive,14,0,14
1242750,0,4 user reviews,4,0,4
1242751,0,5 user reviews,5,0,5
1242752,0,4 user reviews,4,0,4
1242753,7,Positive,45,0,45
1242754,7,Positive,35,0,35
1242755,0,4 user reviews,4,0,4
1242756,7,Positive,24,0,24
1242757,0,4 user reviews,4,0,4
1242758,0,3 user reviews,3,0,3
1242759,0,8 user reviews,8,0,8
1242760,0,8 user reviews,7,1,8
1242761,0,7 user reviews,7,0,7
1242762,0,1 user reviews,1,0,1
1242763,0,2 user reviews,2,0,2
1242764,0,1 user reviews,1,0,1
1242765,0,1 user reviews,1,0,1
1242766,0,1 user reviews,1,0,1
1242767,0,1 user reviews,1,0,1
1242768,0,2 user reviews,2,0,2
1242769,0,1 user reviews,1,0,1
1242770,0,3 user reviews,3,0,3
1242771,0,1 user reviews,1,0,1
1242777,0,3 user reviews,3,0,3
1242778,7,Positive,9,2,11
1242779,0,4 user reviews,4,0,4
1242820,0,4 user reviews,3,1,4
1242850,0,1 user reviews,1,0,1
1242910,5,Mixed,5,6,11
1242960,0,5 user reviews,5,0,5
1242970,0,1 user reviews,1,0,1
1243100,0,4 user reviews,1,3,4
1243150,0,2 user reviews,2,0,2
1243220,8,Very Positive,67,12,79
1243240,0,2 user reviews,0,2,2
1243270,0,3 user reviews,2,1,3
1243290,0,3 user reviews,3,0,3
1243320,0,7 user reviews,2,5,7
1243360,0,5 user reviews,5,0,5
1243370,0,2 user reviews,2,0,2
1243390,0,1 user reviews,0,1,1
1243410,0,1 user reviews,1,0,1
1243420,6,Mostly Positive,38,14,52
1243450,0,1 user reviews,0,1,1
1243530,0,6 user reviews,6,0,6
1243560,0,1 user reviews,1,0,1
1243670,8,Very Positive,75,6,81
1243710,0,4 user reviews,3,1,4
1243730,6,Mostly Positive,43,13,56
1243750,0,4 user reviews,2,2,4
1243770,7,Positive,19,0,19
1243790,7,Positive,13,0,13
1243820,0,2 user reviews,1,1,2
1243930,0,2 user reviews,2,0,2
1243960,7,Positive,12,0,12
1244040,7,Positive,29,3,32
1244160,7,Positive,19,0,19
1244190,0,6 user reviews,6,0,6
1244210,0,1 user reviews,1,0,1
1244230,0,2 user reviews,2,0,2
1244250,0,2 user reviews,2,0,2
1244260,7,Positive,14,0,14
1244270,7,Positive,11,0,11
1244300,0,1 user reviews,1,0,1
1244380,0,5 user reviews,2,3,5
1244390,0,3 user reviews,3,0,3
1244510,0,1 user reviews,1,0,1
1244530,0,9 user reviews,9,0,9
1244560,0,3 user reviews,3,0,3
1244690,0,3 user reviews,3,0,3
1244760,0,3 user reviews,1,2,3
1244781,4,Mostly Negative,26,47,73
1244840,0,1 user reviews,1,0,1
1244850,0,2 user reviews,1,1,2
1244860,0,3 user reviews,3,0,3
1244880,0,2 user reviews,2,0,2
1244890,0,1 user reviews,1,0,1
1244930,7,Positive,24,2,26
1244950,6,Mostly Positive,129,49,178
1245000,0,2 user reviews,2,0,2
1245030,0,1 user reviews,0,1,1
1245090,0,8 user reviews,7,1,8
1245110,0,7 user reviews,7,0,7
1245150,5,Mixed,166,112,278
1245170,0,1 user reviews,0,1,1
1245180,0,1 user reviews,0,1,1
1245230,0,1 user reviews,0,1,1
1245260,7,Positive,8,2,10
1245280,0,4 user reviews,2,2,4
1245300,0,1 user reviews,1,0,1
1245370,0,3 user reviews,3,0,3
1245380,0,2 user reviews,1,1,2
1245430,8,Very Positive,121,5,126
1245470,0,2 user reviews,0,2,2
1245500,0,4 user reviews,2,2,4
1245510,0,1 user reviews,1,0,1
1245540,7,Positive,18,0,18
1245600,0,3 user reviews,2,1,3
1245630,0,2 user reviews,1,1,2
1245660,0,3 user reviews,2,1,3
1245670,5,Mixed,11,7,18
1245730,0,1 user reviews,1,0,1
1245780,5,Mixed,36,16,52
1245810,0,3 user reviews,3,0,3
1245820,0,3 user reviews,3,0,3
1245900,0,4 user reviews,4,0,4
1245910,0,5 user reviews,1,4,5
1245930,0,1 user reviews,0,1,1
1245950,6,Mostly Positive,47,18,65
1245980,0,1 user reviews,0,1,1
1246030,0,1 user reviews,1,0,1
1246031,0,4 user reviews,3,1,4
1246032,0,2 user reviews,2,0,2
1246040,0,2 user reviews,2,0,2
1246140,0,3 user reviews,0,3,3
1246170,0,1 user reviews,1,0,1
1246230,0,1 user reviews,0,1,1
1246320,0,1 user reviews,1,0,1
1246400,0,5 user reviews,4,1,5
1246420,0,5 user reviews,4,1,5
1246490,7,Positive,9,2,11
1246520,5,Mixed,15,21,36
1246540,0,1 user reviews,1,0,1
1246570,0,4 user reviews,4,0,4
1246600,0,1 user reviews,1,0,1
1246610,0,1 user reviews,0,1,1
1246710,0,5 user reviews,4,1,5
1246780,0,4 user reviews,2,2,4
1246930,0,1 user reviews,1,0,1
1246950,6,Mostly Positive,10,4,14
1247010,0,5 user reviews,3,2,5
1247020,7,Positive,27,2,29
1247030,0,2 user reviews,2,0,2
1247040,0,4 user reviews,0,4,4
1247070,0,9 user reviews,7,2,9
1247110,0,1 user reviews,1,0,1
1247130,0,8 user reviews,7,1,8
1247140,0,3 user reviews,2,1,3
1247150,0,2 user reviews,1,1,2
1247170,7,Positive,19,2,21
1247190,6,Mostly Positive,10,3,13
1247210,0,1 user reviews,1,0,1
1247250,0,2 user reviews,0,2,2
1247270,0,7 user reviews,7,0,7
1247300,0,1 user reviews,1,0,1
1247340,0,8 user reviews,6,2,8
1247370,7,Positive,26,6,32
1247400,0,2 user reviews,2,0,2
1247612,0,1 user reviews,1,0,1
1247620,0,1 user reviews,1,0,1
1247640,7,Positive,22,4,26
1247720,7,Positive,32,3,35
1247730,0,2 user reviews,1,1,2
1247750,4,Mostly Negative,6,20,26
1247760,0,7 user reviews,7,0,7
1247830,0,4 user reviews,3,1,4
1247910,0,4 user reviews,3,1,4
1247920,0,2 user reviews,2,0,2
1247930,0,2 user reviews,1,1,2
1247940,7,Positive,28,1,29
1247950,0,2 user reviews,0,2,2
1248030,0,2 user reviews,2,0,2
1248100,0,1 user reviews,1,0,1
1248140,7,Positive,12,1,13
1248180,0,3 user reviews,2,1,3
1248330,0,5 user reviews,5,0,5
1248331,0,2 user reviews,1,1,2
1248332,0,1 user reviews,1,0,1
1248335,0,9 user reviews,4,5,9
1248370,0,1 user reviews,1,0,1
1248380,8,Very Positive,85,11,96
1248430,8,Very Positive,58,5,63
1248431,7,Positive,16,0,16
1248434,7,Positive,35,1,36
1248460,7,Positive,14,0,14
1248490,0,1 user reviews,1,0,1
1248570,0,1 user reviews,1,0,1
1248590,0,8 user reviews,2,6,8
1248680,0,1 user reviews,1,0,1
1248710,0,3 user reviews,2,1,3
1248800,0,6 user reviews,6,0,6
1248860,0,3 user reviews,3,0,3
1248880,0,1 user reviews,1,0,1
1248910,0,1 user reviews,1,0,1
1248960,0,2 user reviews,2,0,2
1248970,0,8 user reviews,7,1,8
1248990,0,5 user reviews,2,3,5
1249000,0,9 user reviews,5,4,9
1249010,0,5 user reviews,4,1,5
1249050,0,2 user reviews,2,0,2
1249060,0,3 user reviews,2,1,3
1249070,0,6 user reviews,6,0,6
1249110,0,6 user reviews,5,1,6
1249130,8,Very Positive,151,17,168
1249140,0,1 user reviews,1,0,1
1249170,7,Positive,10,0,10
1249260,7,Positive,35,3,38
1249280,0,2 user reviews,2,0,2
1249290,0,2 user reviews,2,0,2
1249310,0,2 user reviews,2,0,2
1249340,0,1 user reviews,1,0,1
1249410,0,5 user reviews,4,1,5
1249450,0,1 user reviews,1,0,1
1249500,0,8 user reviews,5,3,8
1249510,0,8 user reviews,8,0,8
1249620,0,1 user reviews,0,1,1
1249760,0,1 user reviews,1,0,1
1249800,7,Positive,42,5,47
1249810,0,1 user reviews,1,0,1
1249850,0,6 user reviews,4,2,6
1249890,0,2 user reviews,2,0,2
1250030,0,4 user reviews,4,0,4
1250070,0,3 user reviews,2,1,3
1250100,7,Positive,14,1,15
1250170,0,1 user reviews,1,0,1
1250180,0,5 user reviews,5,0,5
1250220,5,Mixed,16,15,31
1250250,7,Positive,11,0,11
1250300,7,Positive,9,1,10
1250410,6,Mostly Positive,7821,2673,10494
1250490,0,1 user reviews,1,0,1
1250520,7,Positive,39,2,41
1250550,0,3 user reviews,2,1,3
1250560,8,Very Positive,65,2,67
1250640,0,2 user reviews,1,1,2
1250650,6,Mostly Positive,182,72,254
1250690,7,Positive,12,1,13
1250720,0,5 user reviews,4,1,5
1250730,0,2 user reviews,1,1,2
1250740,0,2 user reviews,2,0,2
1250770,0,1 user reviews,1,0,1
1250830,0,1 user reviews,1,0,1
1250890,0,3 user reviews,3,0,3
1250910,0,4 user reviews,3,1,4
1250990,0,1 user reviews,1,0,1
1251000,6,Mostly Positive,124,33,157
1251290,0,2 user reviews,0,2,2
1251300,6,Mostly Positive,19,7,26
1251350,0,3 user reviews,3,0,3
1251380,0,1 user reviews,0,1,1
1251410,5,Mixed,11,6,17
1251430,0,5 user reviews,3,2,5
1251520,0,2 user reviews,2,0,2
1251530,0,9 user reviews,8,1,9
1251640,7,Positive,37,1,38
1251680,7,Positive,9,2,11
1251760,0,3 user reviews,1,2,3
1251840,0,2 user reviews,0,2,2
1251910,7,Positive,9,1,10
1251940,0,7 user reviews,7,0,7
1251980,7,Positive,12,3,15
1252010,5,Mixed,20,20,40
1252080,0,5 user reviews,3,2,5
1252100,0,4 user reviews,4,0,4
1252160,0,2 user reviews,2,0,2
1252170,0,4 user reviews,4,0,4
1252200,6,Mostly Positive,99,29,128
1252210,0,3 user reviews,3,0,3
1252290,0,1 user reviews,0,1,1
1252320,7,Positive,19,0,19
1252410,7,Positive,11,0,11
1252450,0,2 user reviews,2,0,2
1252560,7,Positive,25,1,26
1252590,0,1 user reviews,1,0,1
1252700,0,1 user reviews,1,0,1
1252710,8,Very Positive,42,10,52
1252730,0,4 user reviews,3,1,4
1252750,8,Very Positive,57,8,65
1252760,7,Positive,9,1,10
1252870,8,Very Positive,53,12,65
1252920,0,1 user reviews,0,1,1
1252980,0,2 user reviews,2,0,2
1252990,5,Mixed,28,15,43
1253050,0,1 user reviews,1,0,1
1253090,0,1 user reviews,1,0,1
1253091,0,3 user reviews,2,1,3
1253092,7,Positive,8,2,10
1253110,7,Positive,9,1,10
1253180,0,2 user reviews,0,2,2
1253240,0,1 user reviews,1,0,1
1253280,0,7 user reviews,7,0,7
1253390,7,Positive,12,1,13
1253460,0,2 user reviews,0,2,2
1253550,5,Mixed,11,7,18
1253580,0,6 user reviews,6,0,6
1253620,0,3 user reviews,0,3,3
1253680,6,Mostly Positive,19,5,24
1253700,0,4 user reviews,1,3,4
1253720,0,1 user reviews,0,1,1
1253760,0,1 user reviews,1,0,1
1253820,0,2 user reviews,1,1,2
1253870,8,Very Positive,321,42,363
1253900,0,5 user reviews,0,5,5
1253920,6,Mostly Positive,679,177,856
1253940,0,5 user reviews,4,1,5
1253950,7,Positive,16,0,16
1253990,4,Mostly Negative,43,83,126
1254070,0,2 user reviews,2,0,2
1254150,0,5 user reviews,4,1,5
1254160,0,4 user reviews,2,2,4
1254180,7,Positive,11,0,11
1254280,0,2 user reviews,1,1,2
1254350,0,5 user reviews,4,1,5
1254370,8,Very Positive,208,15,223
1254380,5,Mixed,6,4,10
1254400,5,Mixed,55,26,81
1254420,0,1 user reviews,0,1,1
1254480,0,7 user reviews,4,3,7
1254490,0,1 user reviews,0,1,1
1254500,7,Positive,17,3,20
1254570,5,Mixed,44,21,65
1254590,0,1 user reviews,1,0,1
1254620,0,5 user reviews,5,0,5
1254630,0,5 user reviews,3,2,5
1254680,0,2 user reviews,1,1,2
1254820,0,1 user reviews,0,1,1
1254860,0,5 user reviews,4,1,5
1254870,7,Positive,27,0,27
1254890,0,1 user reviews,1,0,1
1254900,0,7 user reviews,5,2,7
1254920,0,4 user reviews,4,0,4
1254921,0,8 user reviews,8,0,8
1254922,0,1 user reviews,1,0,1
1254923,7,Positive,10,2,12
1254930,0,3 user reviews,2,1,3
1255000,7,Positive,24,3,27
1255001,0,8 user reviews,8,0,8
1255040,7,Positive,13,1,14
1255050,0,7 user reviews,7,0,7
1255070,0,2 user reviews,2,0,2
1255071,0,1 user reviews,1,0,1
1255072,0,4 user reviews,4,0,4
1255073,0,1 user reviews,1,0,1
1255074,0,1 user reviews,1,0,1
1255075,0,2 user reviews,2,0,2
1255080,0,7 user reviews,5,2,7
1255081,0,5 user reviews,4,1,5
1255130,0,9 user reviews,8,1,9
1255140,0,3 user reviews,3,0,3
1255150,6,Mostly Positive,24,9,33
1255151,8,Very Positive,58,10,68
1255152,5,Mixed,40,20,60
1255220,4,Mostly Negative,3,7,10
1255250,0,1 user reviews,0,1,1
1255310,5,Mixed,13,11,24
1255311,0,8 user reviews,5,3,8
1255320,0,2 user reviews,1,1,2
1255370,0,1 user reviews,0,1,1
1255490,0,1 user reviews,1,0,1
1255520,0,2 user reviews,2,0,2
1255650,7,Positive,10,0,10
1255680,0,3 user reviews,3,0,3
1255730,0,1 user reviews,0,1,1
1255740,0,7 user reviews,6,1,7
1255830,0,1 user reviews,1,0,1
1255840,0,2 user reviews,2,0,2
1255850,0,1 user reviews,1,0,1
1255870,0,2 user reviews,2,0,2
1255880,0,2 user reviews,2,0,2
1255910,0,2 user reviews,2,0,2
1255950,0,3 user reviews,3,0,3
1255990,6,Mostly Positive,17,5,22
1256030,7,Positive,21,3,24
1256040,0,3 user reviews,3,0,3
1256190,0,8 user reviews,5,3,8
1256240,0,1 user reviews,0,1,1
1256310,0,4 user reviews,2,2,4
1256350,0,1 user reviews,0,1,1
1256360,0,1 user reviews,1,0,1
1256430,0,2 user reviews,2,0,2
1256440,0,1 user reviews,1,0,1
1256480,0,2 user reviews,0,2,2
1256490,0,2 user reviews,2,0,2
1256500,0,2 user reviews,0,2,2
1256510,7,Positive,13,1,14
1256520,7,Positive,16,0,16
1256530,7,Positive,23,1,24
1256610,7,Positive,14,3,17
1256660,7,Positive,11,0,11
1256670,8,Very Positive,465,21,486
1256690,5,Mixed,16,11,27
1256710,0,2 user reviews,1,1,2
1256740,0,8 user reviews,8,0,8
1256750,0,3 user reviews,1,2,3
1256770,0,1 user reviews,1,0,1
1256850,0,5 user reviews,1,4,5
1256910,0,2 user reviews,2,0,2
1256920,7,Positive,9,1,10
1256950,7,Positive,24,5,29
1257170,7,Positive,18,2,20
1257190,0,2 user reviews,2,0,2
1257210,7,Positive,9,1,10
1257250,0,4 user reviews,4,0,4
1257270,0,2 user reviews,1,1,2
1257310,0,3 user reviews,0,3,3
1257350,0,1 user reviews,1,0,1
1257360,8,Very Positive,222,41,263
1257410,7,Positive,47,2,49
1257430,7,Positive,13,1,14
1257440,7,Positive,12,2,14
1257540,0,1 user reviews,1,0,1
1257570,0,4 user reviews,4,0,4
1257600,0,6 user reviews,6,0,6
1257630,0,1 user reviews,1,0,1
1257670,0,3 user reviews,3,0,3
1257720,0,3 user reviews,0,3,3
1257740,0,2 user reviews,2,0,2
1257770,0,1 user reviews,1,0,1
1257810,0,7 user reviews,5,2,7
1257840,0,8 user reviews,4,4,8
1257890,0,3 user reviews,3,0,3
1257900,0,2 user reviews,1,1,2
1257910,0,8 user reviews,7,1,8
1257920,0,1 user reviews,1,0,1
1257930,0,3 user reviews,2,1,3
1258000,0,3 user reviews,3,0,3
1258020,0,6 user reviews,6,0,6
1258040,0,2 user reviews,1,1,2
1258060,0,4 user reviews,1,3,4
1258070,0,2 user reviews,2,0,2
1258140,0,3 user reviews,2,1,3
1258190,7,Positive,19,2,21
1258200,0,6 user reviews,3,3,6
1258280,0,1 user reviews,1,0,1
1258310,8,Very Positive,81,1,82
1258320,6,Mostly Positive,13341,5203,18544
1258340,8,Very Positive,51,3,54
1258440,0,1 user reviews,1,0,1
1258460,5,Mixed,36,18,54
1258480,0,7 user reviews,7,0,7
1258500,6,Mostly Positive,29,10,39
1258510,7,Positive,24,1,25
1258580,0,3 user reviews,3,0,3
1258590,8,Very Positive,87,17,104
1258620,0,1 user reviews,0,1,1
1258640,0,1 user reviews,0,1,1
1258710,7,Positive,18,3,21
1258730,0,9 user reviews,9,0,9
1258740,7,Positive,21,0,21
1258840,0,2 user reviews,2,0,2
1258910,0,2 user reviews,1,1,2
1258980,0,5 user reviews,4,1,5
1259110,0,1 user reviews,1,0,1
1259130,6,Mostly Positive,8,3,11
1259160,0,2 user reviews,0,2,2
1259290,0,1 user reviews,0,1,1
1259310,0,4 user reviews,4,0,4
1259330,0,2 user reviews,2,0,2
1259340,0,1 user reviews,1,0,1
1259360,5,Mixed,252,256,508
1259370,0,2 user reviews,2,0,2
1259380,7,Positive,28,6,34
1259470,0,1 user reviews,1,0,1
1259480,0,1 user reviews,1,0,1
1259510,7,Positive,13,2,15
1259520,0,1 user reviews,0,1,1
1259530,7,Positive,23,2,25
1259560,8,Very Positive,279,41,320
1259570,0,1 user reviews,1,0,1
1259600,7,Positive,9,1,10
1259610,0,9 user reviews,6,3,9
1259650,0,2 user reviews,2,0,2
1259750,5,Mixed,8,8,16
1259840,8,Very Positive,133,14,147
1259860,0,1 user reviews,1,0,1
1259870,0,1 user reviews,1,0,1
1259890,0,3 user reviews,3,0,3
1259930,5,Mixed,43,20,63
1259960,7,Positive,12,0,12
1259970,6,Mostly Positive,793,201,994
1259980,5,Mixed,180,101,281
1260070,0,1 user reviews,1,0,1
1260160,0,1 user reviews,0,1,1
1260170,0,2 user reviews,2,0,2
1260220,0,5 user reviews,5,0,5
1260240,0,3 user reviews,1,2,3
1260250,0,1 user reviews,0,1,1
1260300,0,2 user reviews,1,1,2
1260310,0,7 user reviews,5,2,7
1260390,8,Very Positive,64,16,80
1260440,4,Mostly Negative,4,7,11
1260490,0,3 user reviews,3,0,3
1260510,7,Positive,10,0,10
1260580,7,Positive,10,0,10
1260620,0,2 user reviews,2,0,2
1260670,7,Positive,21,2,23
1260680,0,2 user reviews,2,0,2
1260690,0,2 user reviews,2,0,2
1260700,0,8 user reviews,7,1,8
1260710,7,Positive,21,4,25
1260720,0,1 user reviews,0,1,1
1260770,0,4 user reviews,3,1,4
1260800,6,Mostly Positive,13,4,17
1260810,7,Positive,18,0,18
1260820,8,Very Positive,114,8,122
1260840,0,2 user reviews,1,1,2
1260860,0,4 user reviews,2,2,4
1260910,0,3 user reviews,1,2,3
1261010,0,8 user reviews,7,1,8
1261020,0,2 user reviews,2,0,2
1261040,8,Very Positive,186,39,225
1261060,0,9 user reviews,7,2,9
1261090,0,4 user reviews,3,1,4
1261120,0,3 user reviews,3,0,3
1261130,0,6 user reviews,4,2,6
1261170,0,3 user reviews,3,0,3
1261190,0,2 user reviews,2,0,2
1261250,0,2 user reviews,2,0,2
1261280,0,1 user reviews,1,0,1
1261500,0,2 user reviews,2,0,2
1261510,0,1 user reviews,0,1,1
1261520,0,9 user reviews,3,6,9
1261570,0,5 user reviews,4,1,5
1261630,0,4 user reviews,4,0,4
1261640,0,9 user reviews,8,1,9
1261660,0,1 user reviews,1,0,1
1261670,7,Positive,8,2,10
1261692,0,2 user reviews,2,0,2
1261700,7,Positive,38,0,38
1261750,0,3 user reviews,3,0,3
1261760,7,Positive,31,2,33
1261820,0,1 user reviews,1,0,1
1261860,0,4 user reviews,4,0,4
1261880,5,Mixed,15,11,26
1261900,0,2 user reviews,2,0,2
1261910,7,Positive,14,0,14
1261960,7,Positive,16,1,17
1261970,7,Positive,12,1,13
1261980,0,2 user reviews,2,0,2
1261990,5,Mixed,8,4,12
1262000,0,7 user reviews,6,1,7
1262060,0,6 user reviews,6,0,6
1262070,0,1 user reviews,1,0,1
1262100,0,1 user reviews,0,1,1
1262110,5,Mixed,7,7,14
1262120,0,5 user reviews,3,2,5
1262200,0,2 user reviews,1,1,2
1262220,0,1 user reviews,1,0,1
1262240,6,Mostly Positive,284,109,393
1262260,0,1 user reviews,1,0,1
1262397,0,1 user reviews,0,1,1
1262398,0,1 user reviews,0,1,1
1262410,0,1 user reviews,0,1,1
1262413,0,1 user reviews,0,1,1
1262417,0,1 user reviews,1,0,1
1262423,0,1 user reviews,1,0,1
1262439,0,1 user reviews,1,0,1
1262460,8,Very Positive,104,17,121
1262470,0,4 user reviews,1,3,4
1262540,5,Mixed,590,375,965
1262560,6,Mostly Positive,424,173,597
1262571,0,1 user reviews,1,0,1
1262572,0,1 user reviews,1,0,1
1262580,8,Very Positive,352,54,406
1262600,5,Mixed,200,88,288
1262640,5,Mixed,14,7,21
1262670,5,Mixed,11,8,19
1262770,0,3 user reviews,1,2,3
1262780,0,2 user reviews,2,0,2
1262820,0,1 user reviews,1,0,1
1262830,0,1 user reviews,0,1,1
1262890,0,5 user reviews,5,0,5
1262910,5,Mixed,10,12,22
1263070,6,Mostly Positive,210,82,292
1263080,0,5 user reviews,5,0,5
1263110,0,1 user reviews,0,1,1
1263120,0,3 user reviews,2,1,3
1263130,0,5 user reviews,1,4,5
1263160,8,Very Positive,71,3,74
1263200,0,7 user reviews,6,1,7
1263250,0,1 user reviews,1,0,1
1263370,5,Mixed,21,16,37
1263410,0,3 user reviews,2,1,3
1263490,0,3 user reviews,2,1,3
1263520,0,1 user reviews,1,0,1
1263680,0,2 user reviews,2,0,2
1263700,0,9 user reviews,8,1,9
1263720,0,3 user reviews,3,0,3
1263780,0,4 user reviews,0,4,4
1263820,7,Positive,9,1,10
1263830,7,Positive,46,1,47
1263840,7,Positive,9,2,11
1263920,0,2 user reviews,1,1,2
1264010,0,4 user reviews,4,0,4
1264040,0,2 user reviews,2,0,2
1264080,0,2 user reviews,1,1,2
1264090,0,3 user reviews,3,0,3
1264160,7,Positive,16,3,19
1264170,0,4 user reviews,4,0,4
1264171,0,2 user reviews,1,1,2
1264180,7,Positive,20,2,22
1264190,0,3 user reviews,2,1,3
1264250,5,Mixed,189,103,292
1264310,0,1 user reviews,1,0,1
1264340,5,Mixed,14,10,24
1264410,0,1 user reviews,1,0,1
1264510,0,1 user reviews,0,1,1
1264520,8,Very Positive,110,1,111
1264590,0,2 user reviews,1,1,2
1264630,0,1 user reviews,0,1,1
1264640,0,1 user reviews,0,1,1
1264670,6,Mostly Positive,51,13,64
1264700,0,1 user reviews,0,1,1
1264710,8,Very Positive,56,8,64
1264730,0,5 user reviews,5,0,5
1264760,0,6 user reviews,4,2,6
1264770,7,Positive,12,1,13
1264800,0,3 user reviews,1,2,3
1264820,0,1 user reviews,1,0,1
1264850,0,3 user reviews,3,0,3
1264890,0,1 user reviews,0,1,1
1264900,0,2 user reviews,2,0,2
1264930,0,6 user reviews,5,1,6
1265030,0,8 user reviews,3,5,8
1265070,0,3 user reviews,2,1,3
1265080,0,2 user reviews,2,0,2
1265120,0,6 user reviews,6,0,6
1265140,0,2 user reviews,2,0,2
1265170,0,2 user reviews,0,2,2
1265200,0,5 user reviews,4,1,5
1265220,7,Positive,23,2,25
1265240,0,8 user reviews,7,1,8
1265260,0,1 user reviews,1,0,1
1265360,0,9 user reviews,6,3,9
1265390,0,4 user reviews,2,2,4
1265410,0,6 user reviews,1,5,6
1265460,0,2 user reviews,2,0,2
1265470,0,6 user reviews,4,2,6
1265471,0,1 user reviews,1,0,1
1265472,0,2 user reviews,2,0,2
1265473,0,1 user reviews,1,0,1
1265474,0,1 user reviews,1,0,1
1265475,0,2 user reviews,2,0,2
1265476,0,2 user reviews,2,0,2
1265570,0,1 user reviews,0,1,1
1265580,0,1 user reviews,1,0,1
1265620,0,8 user reviews,6,2,8
1265640,7,Positive,16,2,18
1265690,0,5 user reviews,5,0,5
1265770,0,1 user reviews,1,0,1
1265850,7,Positive,38,1,39
1265860,5,Mixed,95,62,157
1265870,0,4 user reviews,2,2,4
1265960,0,8 user reviews,5,3,8
1265970,0,2 user reviews,2,0,2
1266050,0,1 user reviews,1,0,1
1266130,0,2 user reviews,2,0,2
1266140,6,Mostly Positive,8,3,11
1266220,5,Mixed,40,23,63
1266230,0,2 user reviews,2,0,2
1266370,7,Positive,8,2,10
1266380,0,3 user reviews,3,0,3
1266400,0,6 user reviews,5,1,6
1266410,0,1 user reviews,1,0,1
1266420,7,Positive,13,2,15
1266480,0,2 user reviews,2,0,2
1266580,0,1 user reviews,0,1,1
1266600,7,Positive,13,3,16
1266650,0,2 user reviews,1,1,2
1266670,0,1 user reviews,1,0,1
1266680,5,Mixed,8,4,12
1266800,7,Positive,32,2,34
1266860,7,Positive,11,0,11
1267010,0,6 user reviews,4,2,6
1267130,7,Positive,10,0,10
1267260,0,6 user reviews,6,0,6
1267270,0,2 user reviews,2,0,2
1267310,5,Mixed,15,7,22
1267340,0,2 user reviews,2,0,2
1267370,0,4 user reviews,3,1,4
1267400,0,2 user reviews,2,0,2
1267410,0,2 user reviews,2,0,2
1267470,8,Very Positive,70,4,74
1267500,0,1 user reviews,1,0,1
1267502,0,6 user reviews,6,0,6
1267503,0,4 user reviews,2,2,4
1267504,0,1 user reviews,1,0,1
1267505,0,1 user reviews,1,0,1
1267506,0,3 user reviews,1,2,3
1267507,0,9 user reviews,5,4,9
1267509,7,Positive,13,1,14
1267590,0,8 user reviews,2,6,8
1267591,0,4 user reviews,0,4,4
1267592,0,6 user reviews,2,4,6
1267593,0,4 user reviews,0,4,4
1267594,0,6 user reviews,1,5,6
1267790,0,1 user reviews,1,0,1
1267800,0,1 user reviews,1,0,1
1267801,0,1 user reviews,1,0,1
1267810,8,Very Positive,81,6,87
1267830,0,7 user reviews,5,2,7
1267860,0,6 user reviews,4,2,6
1267870,0,8 user reviews,8,0,8
1267900,0,1 user reviews,0,1,1
1267920,0,1 user reviews,1,0,1
1267940,0,2 user reviews,1,1,2
1267950,0,1 user reviews,1,0,1
1268040,6,Mostly Positive,23,7,30
1268100,0,1 user reviews,1,0,1
1268110,8,Very Positive,111,19,130
1268140,0,1 user reviews,1,0,1
1268150,0,5 user reviews,3,2,5
1268160,0,1 user reviews,0,1,1
1268190,0,1 user reviews,0,1,1
1268250,5,Mixed,10,5,15
1268280,0,1 user reviews,0,1,1
1268290,6,Mostly Positive,9,3,12
1268330,0,2 user reviews,1,1,2
1268350,7,Positive,23,5,28
1268370,7,Positive,31,2,33
1268380,7,Positive,8,2,10
1268400,0,4 user reviews,2,2,4
1268410,0,7 user reviews,2,5,7
1268460,0,1 user reviews,1,0,1
1268530,6,Mostly Positive,9,3,12
1268540,0,1 user reviews,1,0,1
1268570,0,3 user reviews,1,2,3
1268700,0,1 user reviews,1,0,1
1268830,0,1 user reviews,1,0,1
1268850,0,1 user reviews,1,0,1
1268860,0,7 user reviews,7,0,7
1268870,0,7 user reviews,6,1,7
1269010,0,3 user reviews,3,0,3
1269030,0,3 user reviews,3,0,3
1269050,0,1 user reviews,0,1,1
1269120,0,5 user reviews,3,2,5
1269180,0,2 user reviews,2,0,2
1269190,0,3 user reviews,3,0,3
1269220,0,1 user reviews,1,0,1
1269221,0,1 user reviews,1,0,1
1269240,0,3 user reviews,3,0,3
1269320,0,7 user reviews,5,2,7
1269350,7,Positive,9,2,11
1269360,0,1 user reviews,1,0,1
1269440,0,3 user reviews,3,0,3
1269540,0,3 user reviews,2,1,3
1269560,0,3 user reviews,2,1,3
1269590,0,6 user reviews,6,0,6
1269650,0,3 user reviews,1,2,3
1269810,6,Mostly Positive,26,10,36
1269820,7,Positive,18,1,19
1269830,7,Positive,17,4,21
1269840,7,Positive,14,1,15
1269880,0,3 user reviews,3,0,3
1269940,0,1 user reviews,1,0,1
1270000,0,1 user reviews,1,0,1
1270010,5,Mixed,16,12,28
1270100,0,1 user reviews,1,0,1
1270250,0,1 user reviews,1,0,1
1270290,0,6 user reviews,6,0,6
1270340,7,Positive,47,0,47
1270370,0,2 user reviews,1,1,2
1270390,0,9 user reviews,9,0,9
1270540,5,Mixed,20,13,33
1270570,7,Positive,10,0,10
1270590,7,Positive,27,1,28
1270620,7,Positive,11,0,11
1270650,0,2 user reviews,1,1,2
1270780,0,1 user reviews,1,0,1
1270820,0,1 user reviews,0,1,1
1270840,0,2 user reviews,0,2,2
1270850,7,Positive,17,1,18
1270860,0,1 user reviews,1,0,1
1270870,0,3 user reviews,3,0,3
1270930,8,Very Positive,47,3,50
1270950,0,2 user reviews,2,0,2
1271070,0,2 user reviews,1,1,2
1271080,5,Mixed,7,10,17
1271090,0,8 user reviews,8,0,8
1271190,5,Mixed,14,15,29
1271270,0,3 user reviews,3,0,3
1271280,7,Positive,39,2,41
1271300,0,2 user reviews,2,0,2
1271330,0,1 user reviews,1,0,1
1271420,0,1 user reviews,0,1,1
1271460,0,3 user reviews,2,1,3
1271500,0,1 user reviews,0,1,1
1271510,0,1 user reviews,1,0,1
1271530,0,6 user reviews,6,0,6
1271600,0,4 user reviews,3,1,4
1271620,0,4 user reviews,3,1,4
1271630,0,5 user reviews,4,1,5
1271670,0,9 user reviews,9,0,9
1271671,0,7 user reviews,7,0,7
1271680,0,1 user reviews,0,1,1
1271710,8,Very Positive,556,35,591
1271750,6,Mostly Positive,10,4,14
1271760,0,2 user reviews,2,0,2
1271792,7,Positive,11,1,12
1271840,0,1 user reviews,1,0,1
1271870,0,9 user reviews,0,9,9
1271910,0,1 user reviews,1,0,1
1271920,0,2 user reviews,1,1,2
1271980,0,5 user reviews,2,3,5
1271990,0,1 user reviews,1,0,1
1272060,0,2 user reviews,2,0,2
1272100,0,4 user reviews,4,0,4
1272110,0,9 user reviews,7,2,9
1272120,0,3 user reviews,3,0,3
1272130,0,8 user reviews,6,2,8
1272150,0,1 user reviews,1,0,1
1272210,0,1 user reviews,1,0,1
1272240,0,2 user reviews,2,0,2
1272330,0,1 user reviews,1,0,1
1272380,0,1 user reviews,0,1,1
1272381,0,1 user reviews,0,1,1
1272382,0,1 user reviews,1,0,1
1272383,0,1 user reviews,0,1,1
1272384,0,1 user reviews,1,0,1
1272385,0,1 user reviews,1,0,1
1272390,0,1 user reviews,0,1,1
1272440,0,2 user reviews,2,0,2
1272450,0,3 user reviews,2,1,3
1272530,0,2 user reviews,2,0,2
1272657,0,2 user reviews,1,1,2
1272680,0,2 user reviews,2,0,2
1272690,0,8 user reviews,7,1,8
1272790,0,1 user reviews,1,0,1
1272820,0,1 user reviews,0,1,1
1272850,0,1 user reviews,1,0,1
1272860,0,4 user reviews,4,0,4
1272920,0,2 user reviews,2,0,2
1272970,0,6 user reviews,5,1,6
1273020,0,3 user reviews,1,2,3
1273070,0,1 user reviews,1,0,1
1273150,0,1 user reviews,1,0,1
1273180,0,3 user reviews,1,2,3
1273250,7,Positive,27,0,27
1273320,0,6 user reviews,6,0,6
1273380,0,1 user reviews,0,1,1
1273390,6,Mostly Positive,9,3,12
1273430,0,1 user reviews,1,0,1
1273450,6,Mostly Positive,16,6,22
1273520,5,Mixed,8,4,12
1273590,0,7 user reviews,7,0,7
1273620,0,8 user reviews,5,3,8
1273630,0,3 user reviews,3,0,3
1273740,0,1 user reviews,1,0,1
1273780,7,Positive,9,1,10
1273790,6,Mostly Positive,22,9,31
1273800,0,8 user reviews,7,1,8
1273870,0,3 user reviews,1,2,3
1273890,0,1 user reviews,1,0,1
1273920,0,1 user reviews,1,0,1
1273930,0,2 user reviews,1,1,2
1273940,0,1 user reviews,0,1,1
1273970,0,4 user reviews,2,2,4
1273971,6,Mostly Positive,86,35,121
1274150,0,1 user reviews,1,0,1
1274190,0,1 user reviews,1,0,1
1274250,0,1 user reviews,0,1,1
1274300,5,Mixed,19,9,28
1274340,0,1 user reviews,1,0,1
1274400,0,1 user reviews,0,1,1
1274430,0,1 user reviews,1,0,1
1274440,0,3 user reviews,3,0,3
1274490,6,Mostly Positive,120,31,151
1274610,0,5 user reviews,3,2,5
1274630,0,7 user reviews,7,0,7
1274640,0,2 user reviews,2,0,2
1274660,0,1 user reviews,1,0,1
1274820,7,Positive,11,0,11
1274840,5,Mixed,6,4,10
1274910,0,2 user reviews,1,1,2
1274940,7,Positive,33,4,37
1274960,0,3 user reviews,0,3,3
1274970,0,3 user reviews,3,0,3
1274980,0,7 user reviews,6,1,7
1275020,0,3 user reviews,3,0,3
1275060,0,4 user reviews,4,0,4
1275190,0,6 user reviews,6,0,6
1275230,0,1 user reviews,0,1,1
1275250,0,6 user reviews,5,1,6
1275290,5,Mixed,9,4,13
1275320,0,1 user reviews,1,0,1
1275330,0,2 user reviews,2,0,2
1275360,0,1 user reviews,0,1,1
1275390,6,Mostly Positive,7,3,10
1275450,0,5 user reviews,1,4,5
1275500,0,1 user reviews,0,1,1
1275520,0,1 user reviews,1,0,1
1275570,0,3 user reviews,0,3,3
1275580,0,1 user reviews,0,1,1
1275730,0,4 user reviews,4,0,4
1275770,7,Positive,16,2,18
1275860,0,5 user reviews,4,1,5
1275880,0,1 user reviews,0,1,1
1275890,8,Very Positive,406,14,420
1275970,0,5 user reviews,3,2,5
1275980,0,5 user reviews,4,1,5
1276040,7,Positive,22,4,26
1276090,0,1 user reviews,0,1,1
1276140,0,2 user reviews,1,1,2
1276160,0,1 user reviews,1,0,1
1276170,0,1 user reviews,1,0,1
1276180,0,3 user reviews,3,0,3
1276320,0,1 user reviews,1,0,1
1276340,0,1 user reviews,1,0,1
1276350,0,2 user reviews,1,1,2
1276430,0,5 user reviews,5,0,5
1276450,0,6 user reviews,5,1,6
1276470,8,Very Positive,79,18,97
1276490,0,9 user reviews,5,4,9
1276530,0,2 user reviews,2,0,2
1276540,0,6 user reviews,4,2,6
1276590,0,1 user reviews,0,1,1
1276610,6,Mostly Positive,54,22,76
1276720,0,6 user reviews,3,3,6
1276780,0,1 user reviews,1,0,1
1276781,0,1 user reviews,1,0,1
1277090,0,2 user reviews,2,0,2
1277190,0,3 user reviews,3,0,3
1277210,0,8 user reviews,4,4,8
1277320,0,1 user reviews,1,0,1
1277390,0,3 user reviews,1,2,3
1277570,7,Positive,17,0,17
1277600,0,3 user reviews,3,0,3
1277650,0,1 user reviews,1,0,1
1277690,0,1 user reviews,1,0,1
1277710,0,4 user reviews,4,0,4
1277830,0,8 user reviews,7,1,8
1277840,0,3 user reviews,3,0,3
1277900,0,1 user reviews,1,0,1
1277950,0,5 user reviews,3,2,5
1278000,0,1 user reviews,1,0,1
1278040,0,2 user reviews,2,0,2
1278090,0,3 user reviews,2,1,3
1278110,0,1 user reviews,1,0,1
1278133,0,1 user reviews,1,0,1
1278200,0,8 user reviews,6,2,8
1278210,0,6 user reviews,6,0,6
1278230,0,3 user reviews,1,2,3
1278240,0,3 user reviews,3,0,3
1278250,0,1 user reviews,1,0,1
1278270,0,6 user reviews,5,1,6
1278290,0,6 user reviews,6,0,6
1278300,0,2 user reviews,2,0,2
1278350,0,4 user reviews,4,0,4
1278370,7,Positive,20,4,24
1278430,0,2 user reviews,2,0,2
1278472,0,1 user reviews,1,0,1
1278480,0,4 user reviews,1,3,4
1278500,7,Positive,10,2,12
1278590,0,3 user reviews,3,0,3
1278610,0,4 user reviews,4,0,4
1278650,5,Mixed,7,4,11
1278690,0,1 user reviews,0,1,1
1278710,0,2 user reviews,2,0,2
1278770,6,Mostly Positive,19,5,24
1278860,0,2 user reviews,1,1,2
1278930,0,3 user reviews,1,2,3
1278960,0,7 user reviews,7,0,7
1279020,0,4 user reviews,4,0,4
1279210,0,1 user reviews,1,0,1
1279211,0,1 user reviews,1,0,1
1279370,0,4 user reviews,4,0,4
1279380,0,7 user reviews,7,0,7
1279390,0,5 user reviews,3,2,5
1279400,0,5 user reviews,3,2,5
1279410,0,7 user reviews,7,0,7
1279420,0,6 user reviews,6,0,6
1279450,0,3 user reviews,3,0,3
1279480,0,2 user reviews,2,0,2
1279590,0,8 user reviews,5,3,8
1279620,0,3 user reviews,3,0,3
1279630,6,Mostly Positive,143,40,183
1279700,7,Positive,14,2,16
1279740,0,1 user reviews,1,0,1
1279770,0,2 user reviews,2,0,2
1279810,0,7 user reviews,7,0,7
1279970,0,3 user reviews,3,0,3
1280010,5,Mixed,7,4,11
1280090,0,1 user reviews,0,1,1
1280110,0,2 user reviews,1,1,2
1280121,0,1 user reviews,1,0,1
1280124,0,1 user reviews,1,0,1
1280260,7,Positive,22,5,27
1280310,0,1 user reviews,1,0,1
1280330,0,1 user reviews,0,1,1
1280340,0,3 user reviews,1,2,3
1280350,0,1 user reviews,0,1,1
1280360,0,3 user reviews,0,3,3
1280370,6,Mostly Positive,58,24,82
1280420,0,6 user reviews,6,0,6
1280490,0,1 user reviews,1,0,1
1280500,0,8 user reviews,5,3,8
1280510,0,2 user reviews,1,1,2
1280550,0,4 user reviews,1,3,4
1280630,0,5 user reviews,5,0,5
1280640,0,7 user reviews,7,0,7
1280670,0,1 user reviews,1,0,1
1280910,0,2 user reviews,0,2,2
1280940,0,6 user reviews,5,1,6
1280970,0,7 user reviews,7,0,7
1280980,0,1 user reviews,1,0,1
1281010,0,8 user reviews,8,0,8
1281100,0,1 user reviews,0,1,1
1281140,0,3 user reviews,3,0,3
1281170,7,Positive,34,2,36
1281200,8,Very Positive,104,9,113
1281270,7,Positive,47,2,49
1281280,0,3 user reviews,2,1,3
1281310,0,9 user reviews,4,5,9
1281330,0,5 user reviews,5,0,5
1281350,0,5 user reviews,5,0,5
1281360,0,1 user reviews,1,0,1
1281370,0,1 user reviews,1,0,1
1281390,7,Positive,16,0,16
1281410,0,2 user reviews,2,0,2
1281500,0,1 user reviews,1,0,1
1281510,0,1 user reviews,1,0,1
1281530,7,Positive,13,0,13
1281571,0,1 user reviews,1,0,1
1281580,0,5 user reviews,5,0,5
1281600,0,7 user reviews,4,3,7
1281610,0,1 user reviews,1,0,1
1281620,0,3 user reviews,2,1,3
1281630,6,Mostly Positive,58,23,81
1281700,0,3 user reviews,2,1,3
1281710,0,3 user reviews,0,3,3
1281790,7,Positive,35,1,36
1281810,0,3 user reviews,3,0,3
1281880,7,Positive,13,2,15
1281881,0,4 user reviews,3,1,4
1281890,7,Positive,8,2,10
1281980,0,3 user reviews,1,2,3
1282080,0,3 user reviews,3,0,3
1282090,7,Positive,13,1,14
1282140,0,7 user reviews,6,1,7
1282200,9,Overwhelmingly Positive,810,27,837
1282210,8,Very Positive,329,33,362
1282320,0,9 user reviews,9,0,9
1282350,7,Positive,9,2,11
1282370,0,1 user reviews,1,0,1
1282510,0,7 user reviews,7,0,7
1282550,7,Positive,35,1,36
1282590,6,Mostly Positive,340,115,455
1282650,7,Positive,18,1,19
1282690,8,Very Positive,422,85,507
1282710,0,1 user reviews,1,0,1
1282770,0,2 user reviews,0,2,2
1282781,0,2 user reviews,0,2,2
1282840,7,Positive,14,1,15
1282880,0,1 user reviews,1,0,1
1282890,0,6 user reviews,6,0,6
1282900,0,6 user reviews,5,1,6
1282930,0,8 user reviews,7,1,8
1282960,5,Mixed,9,11,20
1283000,7,Positive,16,0,16
1283050,0,3 user reviews,3,0,3
1283070,0,2 user reviews,2,0,2
1283090,8,Very Positive,65,6,71
1283091,8,Very Positive,63,3,66
1283110,0,2 user reviews,2,0,2
1283190,8,Very Positive,81,19,100
1283280,0,3 user reviews,3,0,3
1283320,0,5 user reviews,4,1,5
1283440,0,2 user reviews,2,0,2
1283500,7,Positive,18,0,18
1283520,0,3 user reviews,2,1,3
1283530,0,2 user reviews,2,0,2
1283580,7,Positive,17,0,17
1283680,0,1 user reviews,0,1,1
1283710,4,Mostly Negative,6,12,18
1283720,0,1 user reviews,1,0,1
1283760,0,2 user reviews,0,2,2
1283790,0,1 user reviews,0,1,1
1283800,0,1 user reviews,1,0,1
1283820,0,3 user reviews,3,0,3
1283850,0,3 user reviews,3,0,3
1283890,0,5 user reviews,5,0,5
1283960,0,6 user reviews,6,0,6
1283970,8,Very Positive,67,6,73
1283990,0,2 user reviews,1,1,2
1284050,0,2 user reviews,0,2,2
1284080,0,7 user reviews,7,0,7
1284110,0,7 user reviews,7,0,7
1284150,0,9 user reviews,9,0,9
1284180,0,9 user reviews,9,0,9
1284200,0,1 user reviews,1,0,1
1284260,0,2 user reviews,2,0,2
1284280,7,Positive,16,4,20
1284290,0,1 user reviews,1,0,1
1284300,0,3 user reviews,1,2,3
1284390,0,5 user reviews,2,3,5
1284430,0,1 user reviews,1,0,1
1284480,0,2 user reviews,2,0,2
1284510,0,3 user reviews,3,0,3
1284540,0,8 user reviews,8,0,8
1284550,7,Positive,23,2,25
1284700,0,2 user reviews,1,1,2
1284760,0,6 user reviews,4,2,6
1284790,7,Positive,11,1,12
1284800,0,9 user reviews,8,1,9
1284820,8,Very Positive,123,9,132
1284880,0,3 user reviews,3,0,3
1284890,0,1 user reviews,1,0,1
1284900,0,8 user reviews,8,0,8
1284950,7,Positive,10,0,10
1285000,5,Mixed,11,5,16
1285010,0,3 user reviews,3,0,3
1285020,0,7 user reviews,7,0,7
1285070,0,1 user reviews,1,0,1
1285080,7,Positive,33,0,33
1285090,0,6 user reviews,4,2,6
1285160,7,Positive,49,0,49
1285180,0,3 user reviews,3,0,3
1285310,0,1 user reviews,0,1,1
1285390,0,4 user reviews,3,1,4
1285510,7,Positive,14,0,14
1285530,0,2 user reviews,2,0,2
1285560,6,Mostly Positive,8,3,11
1285600,0,2 user reviews,2,0,2
1285610,0,2 user reviews,2,0,2
1285630,0,7 user reviews,7,0,7
1285660,0,3 user reviews,3,0,3
1285670,9,Overwhelmingly Positive,1146,22,1168
1285700,0,3 user reviews,1,2,3
1285740,0,1 user reviews,1,0,1
1285770,0,8 user reviews,8,0,8
1285810,8,Very Positive,77,5,82
1285850,0,7 user reviews,4,3,7
1285870,7,Positive,14,0,14
1286010,8,Very Positive,51,0,51
1286150,0,1 user reviews,1,0,1
1286160,0,1 user reviews,0,1,1
1286170,0,1 user reviews,0,1,1
1286180,0,6 user reviews,2,4,6
1286210,0,9 user reviews,9,0,9
1286340,0,9 user reviews,9,0,9
1286350,8,Very Positive,1588,148,1736
1286370,7,Positive,16,1,17
1286400,0,3 user reviews,3,0,3
1286470,0,4 user reviews,3,1,4
1286490,0,1 user reviews,0,1,1
1286510,0,1 user reviews,1,0,1
1286570,0,8 user reviews,1,7,8
1286600,0,2 user reviews,2,0,2
1286710,9,Overwhelmingly Positive,546,19,565
1286760,0,8 user reviews,8,0,8
1286800,0,1 user reviews,1,0,1
1286830,7,Positive,46,3,49
1286903,0,1 user reviews,1,0,1
1286950,0,5 user reviews,4,1,5
1286960,0,1 user reviews,1,0,1
1286980,0,4 user reviews,4,0,4
1287000,6,Mostly Positive,13,4,17
1287020,0,3 user reviews,3,0,3
1287050,7,Positive,25,0,25
1287051,0,4 user reviews,4,0,4
1287052,0,4 user reviews,4,0,4
1287053,0,2 user reviews,2,0,2
1287054,0,1 user reviews,1,0,1
1287055,0,2 user reviews,2,0,2
1287056,0,8 user reviews,7,1,8
1287057,0,3 user reviews,2,1,3
1287058,0,7 user reviews,7,0,7
1287059,0,8 user reviews,7,1,8
1287060,7,Positive,13,0,13
1287061,0,3 user reviews,3,0,3
1287062,0,2 user reviews,2,0,2
1287063,0,1 user reviews,1,0,1
1287064,0,2 user reviews,2,0,2
1287065,0,1 user reviews,1,0,1
1287066,0,1 user reviews,1,0,1
1287067,0,2 user reviews,2,0,2
1287068,0,1 user reviews,1,0,1
1287069,0,1 user reviews,1,0,1
1287070,0,2 user reviews,2,0,2
1287071,0,2 user reviews,2,0,2
1287072,0,2 user reviews,2,0,2
1287073,0,1 user reviews,1,0,1
1287074,0,1 user reviews,1,0,1
1287075,0,3 user reviews,1,2,3
1287076,0,1 user reviews,1,0,1
1287081,0,1 user reviews,1,0,1
1287082,0,6 user reviews,6,0,6
1287083,0,5 user reviews,5,0,5
1287180,0,1 user reviews,1,0,1
1287250,0,3 user reviews,1,2,3
1287420,0,1 user reviews,1,0,1
1287450,0,2 user reviews,2,0,2
1287500,0,9 user reviews,9,0,9
1287510,0,6 user reviews,6,0,6
1287590,6,Mostly Positive,10,3,13
1287600,0,7 user reviews,4,3,7
1287601,0,3 user reviews,3,0,3
1287710,0,1 user reviews,0,1,1
1287750,0,9 user reviews,5,4,9
1287770,0,1 user reviews,1,0,1
1287810,0,3 user reviews,3,0,3
1287830,0,4 user reviews,1,3,4
1287860,7,Positive,14,0,14
1287880,0,1 user reviews,0,1,1
1287970,0,1 user reviews,1,0,1
1288000,5,Mixed,26,13,39
1288050,0,1 user reviews,1,0,1
1288070,0,8 user reviews,8,0,8
1288090,0,2 user reviews,2,0,2
1288130,0,5 user reviews,5,0,5
1288240,0,4 user reviews,1,3,4
1288340,0,9 user reviews,3,6,9
1288370,0,1 user reviews,0,1,1
1288380,0,1 user reviews,0,1,1
1288550,0,1 user reviews,1,0,1
1288630,0,1 user reviews,1,0,1
1288670,0,3 user reviews,2,1,3
1289060,0,1 user reviews,1,0,1
1289240,0,1 user reviews,1,0,1
1289310,8,Very Positive,96,1,97
1289330,0,7 user reviews,6,1,7
1289390,7,Positive,10,0,10
1289440,0,7 user reviews,5,2,7
1289490,7,Positive,12,3,15
1289640,8,Very Positive,415,14,429
1289670,0,3 user reviews,2,1,3
1289690,0,1 user reviews,1,0,1
1289750,0,3 user reviews,3,0,3
1289760,0,2 user reviews,2,0,2
1289780,0,4 user reviews,2,2,4
1289850,0,1 user reviews,1,0,1
1289900,0,1 user reviews,0,1,1
1289910,0,2 user reviews,2,0,2
1289950,0,5 user reviews,5,0,5
1289960,0,4 user reviews,4,0,4
1290010,0,1 user reviews,1,0,1
1290040,0,1 user reviews,1,0,1
1290070,6,Mostly Positive,15,5,20
1290110,0,5 user reviews,3,2,5
1290160,0,5 user reviews,3,2,5
1290170,8,Very Positive,77,13,90
1290200,0,7 user reviews,7,0,7
1290220,8,Very Positive,58,0,58
1290250,7,Positive,15,1,16
1290270,8,Very Positive,102,15,117
1290290,7,Positive,8,2,10
1290390,0,1 user reviews,1,0,1
1290460,0,7 user reviews,5,2,7
1290480,0,1 user reviews,1,0,1
1290620,0,1 user reviews,1,0,1
1290670,0,4 user reviews,4,0,4
1290680,0,2 user reviews,2,0,2
1290720,0,5 user reviews,5,0,5
1290770,0,6 user reviews,6,0,6
1290790,0,6 user reviews,6,0,6
1290911,0,1 user reviews,1,0,1
1290913,0,1 user reviews,1,0,1
1290920,0,4 user reviews,4,0,4
1291020,0,4 user reviews,4,0,4
1291050,7,Positive,11,0,11
1291060,0,3 user reviews,3,0,3
1291090,0,3 user reviews,3,0,3
1291110,0,1 user reviews,0,1,1
1291170,7,Positive,31,4,35
1291250,0,1 user reviews,1,0,1
1291310,0,2 user reviews,2,0,2
1291330,6,Mostly Positive,17,6,23
1291340,9,Overwhelmingly Positive,2744,29,2773
1291370,0,1 user reviews,1,0,1
1291400,0,6 user reviews,6,0,6
1291540,7,Positive,19,0,19
1291610,0,3 user reviews,3,0,3
1291640,0,1 user reviews,1,0,1
1291720,0,1 user reviews,1,0,1
1291740,0,1 user reviews,1,0,1
1291830,0,3 user reviews,2,1,3
1292010,8,Very Positive,53,6,59
1292020,8,Very Positive,101,0,101
1292040,8,Very Positive,398,69,467
1292050,0,1 user reviews,1,0,1
1292070,0,2 user reviews,2,0,2
1292100,0,1 user reviews,1,0,1
1292140,0,2 user reviews,2,0,2
1292170,0,9 user reviews,8,1,9
1292180,6,Mostly Positive,21,6,27
1292220,0,1 user reviews,1,0,1
1292250,0,8 user reviews,8,0,8
1292270,0,1 user reviews,1,0,1
1292280,0,4 user reviews,3,1,4
1292290,0,4 user reviews,3,1,4
1292300,0,7 user reviews,7,0,7
1292301,0,3 user reviews,3,0,3
1292302,0,1 user reviews,1,0,1
1292303,0,1 user reviews,1,0,1
1292304,0,1 user reviews,1,0,1
1292490,0,9 user reviews,6,3,9
1292520,0,1 user reviews,1,0,1
1292540,6,Mostly Positive,30,8,38
1292550,0,2 user reviews,2,0,2
1292630,0,1 user reviews,1,0,1
1292690,8,Very Positive,240,4,244
1292750,0,5 user reviews,2,3,5
1292770,7,Positive,10,0,10
1292920,0,2 user reviews,2,0,2
1292940,8,Very Positive,133,0,133
1292960,0,1 user reviews,1,0,1
1293000,0,8 user reviews,8,0,8
1293230,8,Very Positive,262,27,289
1293280,0,9 user reviews,7,2,9
1293400,0,3 user reviews,2,1,3
1293430,0,1 user reviews,0,1,1
1293520,7,Positive,25,0,25
1293530,0,5 user reviews,3,2,5
1293620,0,4 user reviews,4,0,4
1293780,0,2 user reviews,2,0,2
1293820,8,Very Positive,324,10,334
1293850,0,1 user reviews,0,1,1
1293870,0,1 user reviews,1,0,1
1293893,0,1 user reviews,0,1,1
1293900,7,Positive,18,0,18
1293920,0,3 user reviews,2,1,3
1293940,0,4 user reviews,4,0,4
1293980,0,4 user reviews,2,2,4
1293990,7,Positive,14,0,14
1294000,0,1 user reviews,1,0,1
1294020,0,3 user reviews,3,0,3
1294040,0,3 user reviews,2,1,3
1294120,0,2 user reviews,2,0,2
1294230,7,Positive,15,0,15
1294280,0,5 user reviews,5,0,5
1294390,0,1 user reviews,1,0,1
1294460,0,1 user reviews,0,1,1
1294680,4,Mostly Negative,4,11,15
1294750,0,5 user reviews,5,0,5
1294760,6,Mostly Positive,26,10,36
1294780,7,Positive,19,0,19
1294920,0,5 user reviews,2,3,5
1294970,0,4 user reviews,3,1,4
1295030,0,1 user reviews,1,0,1
1295130,0,3 user reviews,3,0,3
1295160,0,2 user reviews,2,0,2
1295180,0,2 user reviews,2,0,2
1295230,0,1 user reviews,0,1,1
1295300,0,2 user reviews,0,2,2
1295330,0,1 user reviews,1,0,1
1295350,7,Positive,13,0,13
1295650,7,Positive,12,3,15
1295760,0,9 user reviews,8,1,9
1295800,0,8 user reviews,7,1,8
1295860,0,2 user reviews,0,2,2
1295880,0,1 user reviews,1,0,1
1295890,0,2 user reviews,2,0,2
1296180,0,1 user reviews,0,1,1
1296200,0,2 user reviews,1,1,2
1296260,0,3 user reviews,1,2,3
1296290,0,9 user reviews,4,5,9
1296370,0,1 user reviews,0,1,1
1296430,0,2 user reviews,2,0,2
1296480,0,1 user reviews,1,0,1
1296510,8,Very Positive,117,17,134
1296690,0,1 user reviews,1,0,1
1296712,0,2 user reviews,2,0,2
1296770,7,Positive,45,1,46
1296840,7,Positive,26,3,29
1296860,0,5 user reviews,5,0,5
1296880,0,1 user reviews,1,0,1
1296900,0,2 user reviews,2,0,2
1297010,0,8 user reviews,7,1,8
1297160,8,Very Positive,286,9,295
1297230,0,9 user reviews,9,0,9
1297370,0,5 user reviews,1,4,5
1297390,5,Mixed,6,4,10
1297460,0,3 user reviews,3,0,3
1297470,0,9 user reviews,5,4,9
1297600,0,4 user reviews,4,0,4
1297650,0,6 user reviews,4,2,6
1297790,7,Positive,30,0,30
1297850,0,1 user reviews,1,0,1
1298050,0,4 user reviews,4,0,4
1298090,0,1 user reviews,1,0,1
1298100,0,2 user reviews,2,0,2
1298180,0,1 user reviews,0,1,1
1298210,0,2 user reviews,2,0,2
1298260,0,7 user reviews,7,0,7
1298280,0,7 user reviews,7,0,7
1298310,0,8 user reviews,8,0,8
1298320,0,3 user reviews,3,0,3
1298340,0,2 user reviews,2,0,2
1298510,0,2 user reviews,2,0,2
1298520,0,1 user reviews,0,1,1
1298590,8,Very Positive,364,2,366
1298660,0,2 user reviews,2,0,2
1298670,0,4 user reviews,4,0,4
1298720,0,1 user reviews,1,0,1
1298820,0,3 user reviews,2,1,3
1298890,0,1 user reviews,1,0,1
1299010,0,1 user reviews,1,0,1
1299090,0,4 user reviews,4,0,4
1299120,8,Very Positive,50,1,51
1299190,0,1 user reviews,1,0,1
1299320,8,Very Positive,190,9,199
1299420,0,4 user reviews,4,0,4
1299530,8,Very Positive,84,14,98
1299600,6,Mostly Positive,10,4,14
1299610,0,1 user reviews,1,0,1
1299710,0,3 user reviews,3,0,3
1299740,0,1 user reviews,1,0,1
1299750,0,7 user reviews,6,1,7
1299770,0,2 user reviews,2,0,2
1299840,0,6 user reviews,4,2,6
1299890,0,1 user reviews,0,1,1
1299980,0,2 user reviews,0,2,2
1300000,0,2 user reviews,1,1,2
1300110,0,1 user reviews,0,1,1
1300160,0,4 user reviews,2,2,4
1300180,0,2 user reviews,2,0,2
1300190,0,7 user reviews,6,1,7
1300200,0,2 user reviews,2,0,2
1300210,7,Positive,11,2,13
1300211,0,6 user reviews,6,0,6
1300270,0,6 user reviews,4,2,6
1300310,0,5 user reviews,4,1,5
1300390,7,Positive,15,2,17
1300430,6,Mostly Positive,67,20,87
1300450,0,8 user reviews,0,8,8
1300490,0,4 user reviews,4,0,4
1300570,0,2 user reviews,1,1,2
1300580,0,1 user reviews,0,1,1
1300670,0,2 user reviews,2,0,2
1300680,0,7 user reviews,2,5,7
1300700,7,Positive,16,2,18
1300710,4,Mostly Negative,81,153,234
1300770,0,2 user reviews,2,0,2
1300790,0,1 user reviews,0,1,1
1300850,0,5 user reviews,5,0,5
1300851,0,4 user reviews,3,1,4
1300960,0,3 user reviews,3,0,3
1301021,5,Mixed,12,7,19
1301100,0,4 user reviews,4,0,4
1301250,0,3 user reviews,2,1,3
1301260,0,1 user reviews,1,0,1
1301370,0,3 user reviews,3,0,3
1301380,0,1 user reviews,1,0,1
1301390,0,5 user reviews,4,1,5
1301410,0,1 user reviews,1,0,1
1301470,0,9 user reviews,9,0,9
1301480,5,Mixed,6,4,10
1301540,0,2 user reviews,2,0,2
1301620,0,3 user reviews,2,1,3
1301730,0,1 user reviews,1,0,1
1301740,5,Mixed,17,18,35
1301870,0,6 user reviews,6,0,6
1301970,0,2 user reviews,2,0,2
1302000,0,2 user reviews,0,2,2
1302050,7,Positive,14,0,14
1302090,0,1 user reviews,0,1,1
1302160,0,3 user reviews,2,1,3
1302180,0,4 user reviews,4,0,4
1302240,0,9 user reviews,9,0,9
1302380,0,1 user reviews,1,0,1
1302400,0,1 user reviews,1,0,1
1302430,4,Mostly Negative,5,8,13
1302440,6,Mostly Positive,14,4,18
1302510,0,2 user reviews,1,1,2
1302550,0,2 user reviews,2,0,2
1302700,0,1 user reviews,0,1,1
1302730,0,1 user reviews,1,0,1
1302750,0,6 user reviews,5,1,6
1302780,6,Mostly Positive,9,3,12
1302800,8,Very Positive,120,5,125
1302810,0,1 user reviews,1,0,1
1302840,0,1 user reviews,1,0,1
1302860,7,Positive,25,1,26
1302930,5,Mixed,23,12,35
1302990,8,Very Positive,90,3,93
1303140,0,3 user reviews,3,0,3
1303191,0,1 user reviews,1,0,1
1303193,0,2 user reviews,2,0,2
1303196,0,1 user reviews,1,0,1
1303198,0,1 user reviews,1,0,1
1303260,0,7 user reviews,5,2,7
1303280,7,Positive,9,2,11
1303350,0,1 user reviews,1,0,1
1303420,0,2 user reviews,2,0,2
1303660,8,Very Positive,54,10,64
1303670,0,5 user reviews,5,0,5
1303740,8,Very Positive,48,3,51
1303790,0,3 user reviews,3,0,3
1303800,5,Mixed,14,8,22
1303820,0,2 user reviews,1,1,2
1303870,0,3 user reviews,2,1,3
1303891,0,6 user reviews,6,0,6
1303900,0,1 user reviews,1,0,1
1303990,7,Positive,37,1,38
1304090,7,Positive,21,1,22
1304100,0,1 user reviews,0,1,1
1304120,0,3 user reviews,3,0,3
1304140,7,Positive,38,2,40
1304150,0,6 user reviews,2,4,6
1304170,0,4 user reviews,4,0,4
1304220,0,4 user reviews,4,0,4
1304290,0,9 user reviews,9,0,9
1304310,0,2 user reviews,2,0,2
1304360,0,1 user reviews,1,0,1
1304411,0,1 user reviews,0,1,1
1304412,0,1 user reviews,0,1,1
1304413,0,1 user reviews,1,0,1
1304417,0,5 user reviews,2,3,5
1304418,0,1 user reviews,0,1,1
1304442,0,5 user reviews,4,1,5
1304444,0,4 user reviews,2,2,4
1304445,0,1 user reviews,1,0,1
1304446,0,1 user reviews,0,1,1
1304447,0,7 user reviews,5,2,7
1304448,0,3 user reviews,3,0,3
1304449,0,1 user reviews,0,1,1
1304460,0,2 user reviews,2,0,2
1304461,0,2 user reviews,2,0,2
1304462,0,1 user reviews,1,0,1
1304464,0,1 user reviews,1,0,1
1304467,5,Mixed,20,22,42
1304468,6,Mostly Positive,8,3,11
1304550,7,Positive,42,0,42
1304600,7,Positive,36,2,38
1304601,7,Positive,33,8,41
1304620,4,Mostly Negative,5,8,13
1304640,7,Positive,11,2,13
1304800,0,1 user reviews,1,0,1
1304870,0,2 user reviews,1,1,2
1304910,0,4 user reviews,4,0,4
1305010,0,1 user reviews,1,0,1
1305040,0,6 user reviews,6,0,6
1305060,0,9 user reviews,9,0,9
1305220,0,1 user reviews,1,0,1
1305310,8,Very Positive,47,5,52
1305370,0,2 user reviews,1,1,2
1305390,0,1 user reviews,1,0,1
1305420,5,Mixed,52,23,75
1305440,7,Positive,11,2,13
1305540,0,4 user reviews,2,2,4
1305590,0,1 user reviews,1,0,1
1305660,0,6 user reviews,6,0,6
1305760,7,Positive,13,1,14
1306020,0,1 user reviews,1,0,1
1306260,7,Positive,10,1,11
1306620,7,Positive,38,3,41
1306730,5,Mixed,14,16,30
1306780,6,Mostly Positive,21,9,30
1306790,7,Positive,12,1,13
1306860,0,3 user reviews,2,1,3
1306900,0,2 user reviews,2,0,2
1307070,7,Positive,14,0,14
1307090,0,6 user reviews,5,1,6
1307220,0,1 user reviews,0,1,1
1307240,0,3 user reviews,2,1,3
1307250,0,2 user reviews,2,0,2
1307380,0,1 user reviews,1,0,1
1307430,0,1 user reviews,1,0,1
1307440,7,Positive,12,1,13
1307450,0,3 user reviews,3,0,3
1307460,0,5 user reviews,4,1,5
1307480,0,7 user reviews,1,6,7
1307530,0,1 user reviews,1,0,1
1307540,0,2 user reviews,0,2,2
1307550,8,Very Positive,2139,279,2418
1307600,5,Mixed,12,11,23
1307640,0,1 user reviews,1,0,1
1307680,8,Very Positive,69,14,83
1307760,0,5 user reviews,3,2,5
1307810,0,1 user reviews,1,0,1
1307850,0,7 user reviews,7,0,7
1307870,7,Positive,28,1,29
1307900,0,4 user reviews,3,1,4
1308040,0,3 user reviews,3,0,3
1308060,0,1 user reviews,0,1,1
1308090,5,Mixed,142,159,301
1308110,0,2 user reviews,2,0,2
1308130,0,8 user reviews,1,7,8
1308140,0,2 user reviews,1,1,2
1308170,0,6 user reviews,4,2,6
1308180,5,Mixed,25,20,45
1308181,5,Mixed,21,25,46
1308182,8,Very Positive,59,9,68
1308183,8,Very Positive,59,4,63
1308240,0,6 user reviews,6,0,6
1308250,0,8 user reviews,8,0,8
1308270,0,1 user reviews,0,1,1
1308350,0,3 user reviews,2,1,3
1308510,0,1 user reviews,1,0,1
1308560,0,3 user reviews,0,3,3
1308670,0,3 user reviews,2,1,3
1308680,0,1 user reviews,1,0,1
1308740,5,Mixed,6,9,15
1308760,0,9 user reviews,8,1,9
1308770,0,1 user reviews,1,0,1
1308780,0,2 user reviews,1,1,2
1308790,0,1 user reviews,0,1,1
1308850,0,4 user reviews,4,0,4
1308910,7,Positive,15,0,15
1308920,0,1 user reviews,0,1,1
1308950,0,2 user reviews,0,2,2
1308980,0,3 user reviews,3,0,3
1309040,0,1 user reviews,1,0,1
1309130,7,Positive,28,0,28
1309170,0,1 user reviews,1,0,1
1309200,7,Positive,11,0,11
1309230,0,2 user reviews,2,0,2
1309290,7,Positive,10,1,11
1309350,0,1 user reviews,1,0,1
1309410,0,8 user reviews,6,2,8
1309430,0,1 user reviews,1,0,1
1309440,0,7 user reviews,6,1,7
1309500,0,1 user reviews,1,0,1
1309690,0,1 user reviews,0,1,1
1309700,0,5 user reviews,2,3,5
1309860,0,5 user reviews,5,0,5
1309890,0,2 user reviews,1,1,2
1309910,0,1 user reviews,1,0,1
1309940,0,9 user reviews,7,2,9
1309980,0,2 user reviews,2,0,2
1310010,5,Mixed,9,4,13
1310050,0,5 user reviews,4,1,5
1310120,0,2 user reviews,2,0,2
1310150,0,3 user reviews,0,3,3
1310210,0,6 user reviews,6,0,6
1310230,0,1 user reviews,1,0,1
1310290,0,9 user reviews,9,0,9
1310460,8,Very Positive,57,5,62
1310470,0,2 user reviews,1,1,2
1310480,0,1 user reviews,1,0,1
1310510,8,Very Positive,109,3,112
1310650,0,5 user reviews,4,1,5
1310690,0,5 user reviews,5,0,5
1310910,8,Very Positive,219,44,263
1311150,0,5 user reviews,3,2,5
1311190,0,3 user reviews,0,3,3
1311220,0,2 user reviews,1,1,2
1311310,6,Mostly Positive,8,3,11
1311400,0,1 user reviews,1,0,1
1311460,0,2 user reviews,2,0,2
1311510,0,8 user reviews,8,0,8
1311540,0,5 user reviews,3,2,5
1311650,0,4 user reviews,2,2,4
1311670,0,3 user reviews,3,0,3
1311740,7,Positive,15,3,18
1311960,0,3 user reviews,3,0,3
1311990,0,1 user reviews,0,1,1
1312010,0,3 user reviews,2,1,3
1312040,7,Positive,13,0,13
1312070,0,1 user reviews,0,1,1
1312250,7,Positive,11,2,13
1312760,0,1 user reviews,1,0,1
1312940,0,4 user reviews,4,0,4
1312950,0,3 user reviews,3,0,3
1312980,0,2 user reviews,1,1,2
1312990,5,Mixed,8,5,13
1313010,0,1 user reviews,1,0,1
1313050,6,Mostly Positive,7,3,10
1313120,0,1 user reviews,1,0,1
1313150,0,2 user reviews,1,1,2
1313310,0,4 user reviews,3,1,4
1313360,0,4 user reviews,0,4,4
1313400,0,2 user reviews,1,1,2
1313470,0,5 user reviews,4,1,5
1313490,7,Positive,14,0,14
1313530,6,Mostly Positive,15,5,20
1313560,0,5 user reviews,5,0,5
1313640,0,3 user reviews,3,0,3
1313700,0,3 user reviews,3,0,3
1313800,0,1 user reviews,0,1,1
1313810,7,Positive,14,0,14
1313860,6,Mostly Positive,956,302,1258
1313970,0,1 user reviews,1,0,1
1314090,0,1 user reviews,1,0,1
1314140,6,Mostly Positive,15,4,19
1314270,0,1 user reviews,1,0,1
1314290,0,9 user reviews,8,1,9
1314300,7,Positive,27,0,27
1314410,7,Positive,18,4,22
1314440,0,1 user reviews,1,0,1
1314470,0,9 user reviews,9,0,9
1314500,0,3 user reviews,3,0,3
1314540,0,1 user reviews,1,0,1
1314590,6,Mostly Positive,12,4,16
1314600,0,1 user reviews,0,1,1
1314620,0,4 user reviews,3,1,4
1314630,0,7 user reviews,5,2,7
1314660,0,2 user reviews,2,0,2
1314680,0,1 user reviews,1,0,1
1314820,7,Positive,8,2,10
1314830,0,2 user reviews,2,0,2
1314870,0,1 user reviews,1,0,1
1314930,6,Mostly Positive,19,7,26
1314980,0,9 user reviews,9,0,9
1315040,0,1 user reviews,1,0,1
1315140,0,2 user reviews,0,2,2
1315200,8,Very Positive,83,15,98
1315250,0,2 user reviews,2,0,2
1315260,0,6 user reviews,6,0,6
1315270,0,4 user reviews,3,1,4
1315300,7,Positive,43,0,43
1315350,0,5 user reviews,5,0,5
1315570,0,1 user reviews,1,0,1
1315630,0,1 user reviews,1,0,1
1315650,0,8 user reviews,5,3,8
1315660,0,3 user reviews,2,1,3
1315710,0,3 user reviews,3,0,3
1315807,0,2 user reviews,2,0,2
1315808,0,1 user reviews,1,0,1
1315809,0,4 user reviews,4,0,4
1315810,0,1 user reviews,1,0,1
1315860,0,5 user reviews,5,0,5
1315870,0,3 user reviews,3,0,3
1315871,0,4 user reviews,4,0,4
1315890,0,2 user reviews,1,1,2
1315900,0,1 user reviews,1,0,1
1315980,0,5 user reviews,5,0,5
1316000,0,7 user reviews,3,4,7
1316020,0,1 user reviews,1,0,1
1316021,0,5 user reviews,5,0,5
1316029,0,1 user reviews,1,0,1
1316050,7,Positive,11,0,11
1316060,0,1 user reviews,0,1,1
1316070,0,1 user reviews,1,0,1
1316075,0,1 user reviews,1,0,1
1316110,0,9 user reviews,9,0,9
1316130,0,1 user reviews,1,0,1
1316141,0,2 user reviews,2,0,2
1316144,0,1 user reviews,0,1,1
1316200,7,Positive,13,1,14
1316241,0,1 user reviews,1,0,1
1316264,0,1 user reviews,1,0,1
1316273,0,1 user reviews,1,0,1
1316274,0,1 user reviews,1,0,1
1316290,0,4 user reviews,4,0,4
1316390,8,Very Positive,63,2,65
1316550,0,2 user reviews,2,0,2
1316570,0,6 user reviews,5,1,6
1316600,0,1 user reviews,1,0,1
1316670,0,5 user reviews,4,1,5
1316700,7,Positive,37,1,38
1316740,7,Positive,19,2,21
1316760,5,Mixed,19,19,38
1316770,0,1 user reviews,1,0,1
1316800,7,Positive,14,1,15
1316830,0,1 user reviews,1,0,1
1316840,5,Mixed,93,48,141
1316870,0,5 user reviews,3,2,5
1316880,0,2 user reviews,2,0,2
1317070,0,2 user reviews,2,0,2
1317080,0,1 user reviews,0,1,1
1317160,7,Positive,41,0,41
1317200,6,Mostly Positive,17,5,22
1317230,5,Mixed,49,33,82
1317250,6,Mostly Positive,35,12,47
1317310,0,3 user reviews,3,0,3
1317800,0,1 user reviews,0,1,1
1317950,0,4 user reviews,4,0,4
1317970,0,5 user reviews,4,1,5
1318000,0,1 user reviews,1,0,1
1318030,0,9 user reviews,8,1,9
1318090,8,Very Positive,249,13,262
1318110,0,3 user reviews,3,0,3
1318130,0,1 user reviews,1,0,1
1318150,0,2 user reviews,0,2,2
1318170,0,1 user reviews,1,0,1
1318290,0,3 user reviews,1,2,3
1318300,0,2 user reviews,2,0,2
1318560,0,7 user reviews,7,0,7
1318690,9,Overwhelmingly Positive,1890,47,1937
1318800,7,Positive,22,0,22
1318870,0,1 user reviews,1,0,1
1319220,0,1 user reviews,1,0,1
1319290,0,5 user reviews,3,2,5
1319690,0,2 user reviews,2,0,2
1319750,0,5 user reviews,4,1,5
1319870,0,1 user reviews,0,1,1
1319880,0,1 user reviews,1,0,1
1320240,0,3 user reviews,3,0,3
1320400,0,2 user reviews,2,0,2
1320510,0,1 user reviews,1,0,1
1320520,0,1 user reviews,1,0,1
1320820,0,4 user reviews,4,0,4
1320830,0,1 user reviews,1,0,1
1320850,0,8 user reviews,7,1,8
1320940,0,1 user reviews,0,1,1
1320950,8,Very Positive,51,8,59
1320990,0,2 user reviews,1,1,2
1321010,0,4 user reviews,4,0,4
1321030,0,5 user reviews,5,0,5
1321070,8,Very Positive,99,18,117
1321110,0,1 user reviews,1,0,1
1321230,7,Positive,25,0,25
1321270,8,Very Positive,56,2,58
1321350,0,1 user reviews,1,0,1
1321400,0,4 user reviews,4,0,4
1321580,0,3 user reviews,3,0,3
1321590,0,1 user reviews,1,0,1
1321760,0,1 user reviews,1,0,1
1321770,0,6 user reviews,6,0,6
1321920,0,7 user reviews,3,4,7
1322010,0,7 user reviews,7,0,7
1322080,0,1 user reviews,1,0,1
1322170,7,Positive,37,2,39
1322180,0,8 user reviews,8,0,8
1322250,7,Positive,10,0,10
1322260,0,8 user reviews,7,1,8
1322270,0,8 user reviews,6,2,8
1322280,0,3 user reviews,1,2,3
1322290,0,1 user reviews,1,0,1
1322310,0,7 user reviews,6,1,7
1322330,0,1 user reviews,1,0,1
1322470,0,2 user reviews,2,0,2
1322490,0,1 user reviews,1,0,1
1322600,7,Positive,13,1,14
1322640,7,Positive,18,3,21
1322650,8,Very Positive,64,5,69
1322730,0,5 user reviews,4,1,5
1322790,0,1 user reviews,1,0,1
1322793,0,1 user reviews,1,0,1
1322794,0,1 user reviews,1,0,1
1322797,0,2 user reviews,1,1,2
1323000,7,Positive,20,0,20
1323210,0,7 user reviews,6,1,7
1323220,0,1 user reviews,1,0,1
1323240,0,3 user reviews,1,2,3
1323320,7,Positive,34,1,35
1323420,8,Very Positive,143,16,159
1323600,0,8 user reviews,8,0,8
1323610,0,5 user reviews,5,0,5
1323620,6,Mostly Positive,40,13,53
1323770,0,4 user reviews,4,0,4
1323860,0,2 user reviews,1,1,2
1323910,0,1 user reviews,1,0,1
1324000,7,Positive,15,0,15
1324010,0,3 user reviews,0,3,3
1324030,0,7 user reviews,7,0,7
1324040,0,1 user reviews,1,0,1
1324060,0,3 user reviews,2,1,3
1324140,5,Mixed,7,8,15
1324160,6,Mostly Positive,7,3,10
1324270,0,2 user reviews,1,1,2
1324360,0,7 user reviews,5,2,7
1324420,0,9 user reviews,7,2,9
1324470,7,Positive,9,1,10
1324490,0,1 user reviews,1,0,1
1324730,0,1 user reviews,0,1,1
1324870,0,8 user reviews,8,0,8
1324970,8,Very Positive,278,48,326
1325030,0,1 user reviews,0,1,1
1325370,0,1 user reviews,1,0,1
1325380,0,1 user reviews,1,0,1
1325400,0,2 user reviews,2,0,2
1325470,0,3 user reviews,3,0,3
1325520,0,1 user reviews,1,0,1
1325700,0,1 user reviews,1,0,1
1325730,0,2 user reviews,2,0,2
1325790,0,4 user reviews,4,0,4
1325800,5,Mixed,28,21,49
1325870,0,3 user reviews,3,0,3
1325960,0,4 user reviews,0,4,4
1325970,0,4 user reviews,3,1,4
1326000,7,Positive,19,4,23
1326660,0,4 user reviews,4,0,4
1326870,0,3 user reviews,3,0,3
1326920,0,1 user reviews,1,0,1
1327100,0,1 user reviews,1,0,1
1327260,0,3 user reviews,1,2,3
1327341,7,Positive,17,2,19
1327370,0,4 user reviews,4,0,4
1327390,0,3 user reviews,2,1,3
1327450,0,2 user reviews,0,2,2
1327540,0,3 user reviews,3,0,3
1327720,0,2 user reviews,2,0,2
1327810,0,3 user reviews,3,0,3
1327820,7,Positive,19,0,19
1327870,0,4 user reviews,4,0,4
1328170,0,8 user reviews,7,1,8
1328410,0,4 user reviews,4,0,4
1328421,0,1 user reviews,0,1,1
1328470,0,1 user reviews,1,0,1
1328500,0,1 user reviews,1,0,1
1328560,0,5 user reviews,5,0,5
1328570,7,Positive,15,0,15
1328750,0,2 user reviews,2,0,2
1328810,0,5 user reviews,5,0,5
1328830,0,2 user reviews,2,0,2
1328890,7,Positive,27,0,27
1328910,6,Mostly Positive,8,3,11
1328920,5,Mixed,8,5,13
1329080,0,4 user reviews,4,0,4
1329190,0,3 user reviews,3,0,3
1329320,0,3 user reviews,2,1,3
1329420,0,1 user reviews,1,0,1
1329440,0,1 user reviews,1,0,1
1329450,0,1 user reviews,0,1,1
1329470,0,2 user reviews,2,0,2
1329510,5,Mixed,46,28,74
1329530,0,4 user reviews,1,3,4
1329540,8,Very Positive,58,5,63
1329560,5,Mixed,11,11,22
1329573,0,3 user reviews,2,1,3
1329590,0,2 user reviews,2,0,2
1329600,7,Positive,24,5,29
1329630,0,1 user reviews,1,0,1
1329830,0,1 user reviews,0,1,1
1329850,0,2 user reviews,0,2,2
1329990,0,1 user reviews,0,1,1
1330010,0,2 user reviews,2,0,2
1330040,5,Mixed,144,90,234
1330130,0,1 user reviews,1,0,1
1330140,0,1 user reviews,1,0,1
1330150,0,1 user reviews,1,0,1
1330160,0,2 user reviews,2,0,2
1330170,0,4 user reviews,3,1,4
1330180,0,2 user reviews,1,1,2
1330190,7,Positive,20,1,21
1330212,0,1 user reviews,1,0,1
1330216,0,1 user reviews,1,0,1
1330300,0,1 user reviews,1,0,1
1330330,0,5 user reviews,5,0,5
1330380,0,4 user reviews,4,0,4
1330420,0,9 user reviews,9,0,9
1330480,7,Positive,12,1,13
1330550,7,Positive,25,0,25
1330570,0,2 user reviews,2,0,2
1330610,0,4 user reviews,3,1,4
1330630,0,6 user reviews,6,0,6
1330710,0,1 user reviews,0,1,1
1330720,0,1 user reviews,1,0,1
1330730,5,Mixed,13,6,19
1330760,0,1 user reviews,1,0,1
1330800,0,2 user reviews,1,1,2
1330890,8,Very Positive,50,2,52
1330920,0,1 user reviews,1,0,1
1330940,0,1 user reviews,1,0,1
1331000,0,1 user reviews,1,0,1
1331011,0,2 user reviews,2,0,2
1331020,0,2 user reviews,2,0,2
1331090,0,3 user reviews,3,0,3
1331220,0,1 user reviews,1,0,1
1331221,0,3 user reviews,0,3,3
1331270,7,Positive,10,0,10
1331330,0,8 user reviews,6,2,8
1331620,0,2 user reviews,2,0,2
1331650,0,3 user reviews,3,0,3
1331821,0,1 user reviews,1,0,1
1332120,0,2 user reviews,2,0,2
1332420,0,1 user reviews,0,1,1
1332540,0,1 user reviews,1,0,1
1332570,0,4 user reviews,3,1,4
1332590,0,6 user reviews,4,2,6
1332610,0,2 user reviews,0,2,2
1332620,6,Mostly Positive,8,3,11
1332630,0,2 user reviews,2,0,2
1332800,0,2 user reviews,2,0,2
1332860,7,Positive,22,1,23
1332890,7,Positive,9,1,10
1332940,0,1 user reviews,1,0,1
1332970,7,Positive,24,0,24
1333020,0,5 user reviews,5,0,5
1333173,0,4 user reviews,4,0,4
1333190,0,5 user reviews,5,0,5
1333220,5,Mixed,59,86,145
1333330,6,Mostly Positive,9,3,12
1333360,7,Positive,21,4,25
1333390,0,2 user reviews,2,0,2
1333460,7,Positive,13,0,13
1333510,0,2 user reviews,1,1,2
1333540,0,1 user reviews,0,1,1
1333570,0,1 user reviews,1,0,1
1333850,8,Very Positive,65,2,67
1333860,0,2 user reviews,2,0,2
1333890,7,Positive,15,0,15
1333900,0,1 user reviews,1,0,1
1334000,8,Very Positive,67,10,77
1334010,6,Mostly Positive,50,14,64
1334020,0,3 user reviews,2,1,3
1334040,6,Mostly Positive,17,5,22
1334070,0,6 user reviews,3,3,6
1334300,0,9 user reviews,9,0,9
1334330,0,3 user reviews,3,0,3
1334490,0,2 user reviews,2,0,2
1334510,0,2 user reviews,2,0,2
1334590,8,Very Positive,219,30,249
1334610,0,4 user reviews,4,0,4
1334700,7,Positive,17,0,17
1334750,0,1 user reviews,0,1,1
1334830,0,2 user reviews,2,0,2
1334840,5,Mixed,6,7,13
1334970,0,1 user reviews,1,0,1
1335070,0,1 user reviews,1,0,1
1335080,0,3 user reviews,3,0,3
1335090,0,8 user reviews,7,1,8
1335100,0,4 user reviews,4,0,4
1335110,0,7 user reviews,7,0,7
1335140,0,2 user reviews,2,0,2
1335150,0,1 user reviews,1,0,1
1335160,0,3 user reviews,3,0,3
1335170,0,2 user reviews,2,0,2
1335240,0,3 user reviews,2,1,3
1335290,0,9 user reviews,9,0,9
1335300,0,2 user reviews,1,1,2
1335350,0,1 user reviews,1,0,1
1335400,0,2 user reviews,1,1,2
1335410,0,2 user reviews,0,2,2
1335430,0,1 user reviews,1,0,1
1335440,7,Positive,10,1,11
1335510,0,2 user reviews,1,1,2
1335600,0,2 user reviews,2,0,2
1335810,7,Positive,16,2,18
1335820,0,8 user reviews,8,0,8
1335840,0,7 user reviews,7,0,7
1335880,0,4 user reviews,3,1,4
1335970,0,3 user reviews,2,1,3
1336040,0,1 user reviews,1,0,1
1336060,7,Positive,37,0,37
1336100,0,1 user reviews,1,0,1
1336130,0,1 user reviews,0,1,1
1336160,0,2 user reviews,2,0,2
1336170,0,1 user reviews,1,0,1
1336230,0,1 user reviews,1,0,1
1336340,7,Positive,23,0,23
1336420,0,1 user reviews,1,0,1
1336430,7,Positive,22,3,25
1336440,0,1 user reviews,1,0,1
1336460,0,1 user reviews,1,0,1
1336481,0,1 user reviews,1,0,1
1336482,0,4 user reviews,4,0,4
1336484,0,1 user reviews,1,0,1
1336560,5,Mixed,23,11,34
1336830,0,1 user reviews,1,0,1
1336950,0,2 user reviews,1,1,2
1336960,0,1 user reviews,1,0,1
1336970,0,2 user reviews,2,0,2
1337070,0,1 user reviews,1,0,1
1337080,0,3 user reviews,3,0,3
1337170,0,1 user reviews,1,0,1
1337270,7,Positive,15,1,16
1337280,7,Positive,12,0,12
1337330,0,3 user reviews,3,0,3
1337430,5,Mixed,10,5,15
1337460,0,1 user reviews,0,1,1
1337660,0,2 user reviews,2,0,2
1337860,8,Very Positive,109,7,116
1337870,0,1 user reviews,0,1,1
1338090,0,2 user reviews,2,0,2
1338130,0,6 user reviews,5,1,6
1338180,0,1 user reviews,1,0,1
1338390,0,6 user reviews,6,0,6
1338470,7,Positive,19,2,21
1338560,0,1 user reviews,0,1,1
1338570,0,2 user reviews,2,0,2
1338630,6,Mostly Positive,8,3,11
1338640,7,Positive,35,1,36
1338700,0,3 user reviews,3,0,3
1338790,0,1 user reviews,1,0,1
1338910,0,2 user reviews,1,1,2
1338980,7,Positive,34,2,36
1339030,0,1 user reviews,0,1,1
1339080,0,2 user reviews,1,1,2
1339170,0,1 user reviews,1,0,1
1339180,0,7 user reviews,7,0,7
1339350,0,1 user reviews,0,1,1
1339370,0,1 user reviews,1,0,1
1339380,0,5 user reviews,5,0,5
1339420,0,6 user reviews,5,1,6
1339430,0,1 user reviews,1,0,1
1339620,0,6 user reviews,6,0,6
1339650,0,3 user reviews,1,2,3
1339660,0,1 user reviews,0,1,1
1339670,0,1 user reviews,1,0,1
1339790,0,5 user reviews,3,2,5
1339820,0,1 user reviews,0,1,1
1339850,0,5 user reviews,5,0,5
1339880,0,1 user reviews,0,1,1
1339890,5,Mixed,13,7,20
1339900,7,Positive,39,1,40
1339920,7,Positive,19,1,20
1340020,0,1 user reviews,1,0,1
1340080,0,1 user reviews,1,0,1
1340120,8,Very Positive,50,2,52
1340300,0,6 user reviews,5,1,6
1340310,0,1 user reviews,1,0,1
1340320,0,3 user reviews,3,0,3
1340400,0,1 user reviews,0,1,1
1340420,0,2 user reviews,2,0,2
1340440,0,1 user reviews,0,1,1
1340490,0,1 user reviews,0,1,1
1340540,0,1 user reviews,1,0,1
1340570,0,8 user reviews,7,1,8
1340600,0,4 user reviews,2,2,4
1340610,0,1 user reviews,1,0,1
1340770,0,1 user reviews,1,0,1
1340850,0,1 user reviews,0,1,1
1340870,0,4 user reviews,4,0,4
1340940,0,2 user reviews,2,0,2
1340980,0,3 user reviews,3,0,3
1341080,0,3 user reviews,1,2,3
1341100,0,1 user reviews,1,0,1
1341160,7,Positive,17,3,20
1341190,7,Positive,10,1,11
1341220,7,Positive,34,1,35
1341240,0,1 user reviews,1,0,1
1341250,0,1 user reviews,1,0,1
1341470,0,3 user reviews,3,0,3
1341520,6,Mostly Positive,51,20,71
1341550,0,6 user reviews,2,4,6
1341580,0,1 user reviews,1,0,1
1341620,0,2 user reviews,1,1,2
1341630,0,1 user reviews,1,0,1
1341640,0,4 user reviews,4,0,4
1341660,0,2 user reviews,1,1,2
1341720,0,2 user reviews,0,2,2
1341780,0,1 user reviews,1,0,1
1341790,0,1 user reviews,1,0,1
1341930,7,Positive,10,1,11
1341960,0,8 user reviews,7,1,8
1342130,0,2 user reviews,1,1,2
1342270,0,1 user reviews,1,0,1
1342290,7,Positive,11,0,11
1342480,0,7 user reviews,6,1,7
1342500,0,4 user reviews,3,1,4
1342600,0,2 user reviews,2,0,2
1342620,8,Very Positive,118,13,131
1342730,0,4 user reviews,4,0,4
1342740,7,Positive,42,0,42
1342850,7,Positive,15,1,16
1343090,7,Positive,17,0,17
1343130,0,8 user reviews,8,0,8
1343150,7,Positive,12,3,15
1343220,0,6 user reviews,6,0,6
1343250,0,2 user reviews,2,0,2
1343260,7,Positive,11,0,11
1343310,0,1 user reviews,1,0,1
1343320,0,6 user reviews,6,0,6
1343330,0,1 user reviews,0,1,1
1343390,0,2 user reviews,2,0,2
1343400,7,Positive,9,2,11
1343410,0,1 user reviews,1,0,1
1343500,6,Mostly Positive,263,88,351
1343550,0,3 user reviews,3,0,3
1343580,0,1 user reviews,0,1,1
1343612,5,Mixed,253,145,398
1343660,0,1 user reviews,1,0,1
1343700,0,3 user reviews,3,0,3
1343770,7,Positive,16,4,20
1343850,0,2 user reviews,1,1,2
1343920,7,Positive,14,3,17
1343990,0,3 user reviews,3,0,3
1344050,0,2 user reviews,2,0,2
1344070,0,4 user reviews,3,1,4
1344110,0,2 user reviews,1,1,2
1344140,0,1 user reviews,1,0,1
1344310,0,6 user reviews,4,2,6
1344440,0,4 user reviews,4,0,4
1344450,0,2 user reviews,2,0,2
1344520,0,2 user reviews,1,1,2
1344530,8,Very Positive,56,9,65
1344580,0,1 user reviews,0,1,1
1344600,0,1 user reviews,1,0,1
1344620,0,1 user reviews,1,0,1
1344630,0,1 user reviews,0,1,1
1344680,6,Mostly Positive,176,61,237
1344740,8,Very Positive,79,3,82
1344760,0,1 user reviews,1,0,1
1344830,0,1 user reviews,1,0,1
1344870,0,3 user reviews,1,2,3
1345040,7,Positive,14,1,15
1345120,0,4 user reviews,3,1,4
1345150,0,2 user reviews,1,1,2
1345190,0,3 user reviews,3,0,3
1345200,0,1 user reviews,1,0,1
1345220,0,3 user reviews,3,0,3
1345240,0,1 user reviews,1,0,1
1345350,0,6 user reviews,6,0,6
1345360,0,5 user reviews,3,2,5
1345370,7,Positive,18,2,20
1345380,5,Mixed,12,8,20
1345470,7,Positive,25,0,25
1345610,0,2 user reviews,2,0,2
1345750,0,1 user reviews,1,0,1
1345770,0,3 user reviews,1,2,3
1345800,7,Positive,13,0,13
1345830,0,1 user reviews,0,1,1
1345950,0,9 user reviews,9,0,9
1345960,0,2 user reviews,2,0,2
1345980,0,1 user reviews,1,0,1
1345990,5,Mixed,87,67,154
1346070,5,Mixed,57,50,107
1346090,7,Positive,17,4,21
1346110,0,3 user reviews,3,0,3
1346120,0,3 user reviews,1,2,3
1346130,0,1 user reviews,0,1,1
1346170,0,2 user reviews,1,1,2
1346240,7,Positive,19,2,21
1346250,0,7 user reviews,7,0,7
1346260,0,6 user reviews,4,2,6
1346270,0,7 user reviews,5,2,7
1346400,0,9 user reviews,7,2,9
1346500,0,1 user reviews,1,0,1
1346510,0,1 user reviews,1,0,1
1346520,0,2 user reviews,2,0,2
1346540,0,1 user reviews,1,0,1
1346541,0,4 user reviews,3,1,4
1346590,0,2 user reviews,2,0,2
1346600,0,5 user reviews,5,0,5
1346630,0,7 user reviews,7,0,7
1346680,0,2 user reviews,1,1,2
1346800,0,7 user reviews,6,1,7
1346860,0,1 user reviews,0,1,1
1346870,0,1 user reviews,0,1,1
1346890,0,8 user reviews,5,3,8
1346930,0,1 user reviews,1,0,1
1346960,7,Positive,19,3,22
1346970,6,Mostly Positive,16,6,22
1346980,7,Positive,33,1,34
1347090,6,Mostly Positive,8,3,11
1347170,0,2 user reviews,2,0,2
1347270,0,1 user reviews,1,0,1
1347350,0,3 user reviews,2,1,3
1347420,7,Positive,17,3,20
1347430,8,Very Positive,172,34,206
1347450,0,1 user reviews,1,0,1
1347460,0,1 user reviews,1,0,1
1347610,0,4 user reviews,4,0,4
1347611,0,2 user reviews,1,1,2
1347640,0,3 user reviews,3,0,3
1347720,0,4 user reviews,3,1,4
1347750,5,Mixed,64,48,112
1347751,7,Positive,43,3,46
1347780,8,Very Positive,293,11,304
1347800,5,Mixed,24,21,45
1347880,0,8 user reviews,8,0,8
1348030,0,2 user reviews,1,1,2
1348140,0,7 user reviews,7,0,7
1348160,7,Positive,14,0,14
1348240,0,3 user reviews,3,0,3
1348270,7,Positive,16,1,17
1348300,0,4 user reviews,3,1,4
1348380,0,2 user reviews,1,1,2
1348390,6,Mostly Positive,8,3,11
1348400,0,4 user reviews,4,0,4
1348430,0,1 user reviews,1,0,1
1348470,0,1 user reviews,1,0,1
1348660,5,Mixed,258,272,530
1348670,5,Mixed,6,6,12
1348880,0,7 user reviews,0,7,7
1348920,6,Mostly Positive,14,4,18
1348960,0,1 user reviews,1,0,1
1348980,0,5 user reviews,5,0,5
1349000,0,4 user reviews,4,0,4
1349010,0,5 user reviews,5,0,5
1349060,7,Positive,21,0,21
1349130,0,4 user reviews,4,0,4
1349230,9,Overwhelmingly Positive,973,37,1010
1349390,0,4 user reviews,4,0,4
1349400,5,Mixed,42,21,63
1349491,0,1 user reviews,1,0,1
1349710,7,Positive,19,1,20
1349720,0,2 user reviews,0,2,2
1349740,0,3 user reviews,0,3,3
1349790,0,1 user reviews,1,0,1
1349940,0,4 user reviews,4,0,4
1349960,7,Positive,27,5,32
1350010,0,1 user reviews,0,1,1
1350040,0,1 user reviews,1,0,1
1350060,0,1 user reviews,0,1,1
1350170,0,1 user reviews,0,1,1
1350280,0,3 user reviews,3,0,3
1350300,0,1 user reviews,1,0,1
1350340,7,Positive,22,3,25
1350480,0,2 user reviews,1,1,2
1350540,0,3 user reviews,3,0,3
1350560,0,1 user reviews,1,0,1
1350570,0,5 user reviews,5,0,5
1350660,0,1 user reviews,1,0,1
1350800,0,1 user reviews,0,1,1
1350850,0,1 user reviews,1,0,1
1350920,0,1 user reviews,1,0,1
1350990,0,3 user reviews,2,1,3
1351010,0,8 user reviews,6,2,8
1351020,0,3 user reviews,2,1,3
1351030,0,3 user reviews,2,1,3
1351060,8,Very Positive,55,7,62
1351100,0,1 user reviews,1,0,1
1351220,0,2 user reviews,1,1,2
1351260,0,6 user reviews,5,1,6
1351261,5,Mixed,18,12,30
1351270,0,1 user reviews,0,1,1
1351271,0,1 user reviews,0,1,1
1351290,0,1 user reviews,0,1,1
1351300,0,1 user reviews,1,0,1
1351310,0,1 user reviews,1,0,1
1351350,0,4 user reviews,4,0,4
1351360,7,Positive,12,1,13
1351370,0,4 user reviews,2,2,4
1351390,0,8 user reviews,8,0,8
1351400,7,Positive,11,0,11
1351450,5,Mixed,18,8,26
1351550,0,3 user reviews,3,0,3
1351560,0,3 user reviews,3,0,3
1351650,0,1 user reviews,1,0,1
1351720,0,1 user reviews,1,0,1
1351810,0,7 user reviews,7,0,7
1351820,0,6 user reviews,6,0,6
1351830,7,Positive,9,2,11
1351860,0,9 user reviews,8,1,9
1351861,0,2 user reviews,2,0,2
1351880,0,4 user reviews,1,3,4
1351900,7,Positive,17,0,17
1351950,7,Positive,18,4,22
1351960,0,2 user reviews,2,0,2
1351970,0,6 user reviews,5,1,6
1351980,0,1 user reviews,1,0,1
1351990,0,1 user reviews,0,1,1
1352000,0,1 user reviews,0,1,1
1352010,0,1 user reviews,0,1,1
1352020,7,Positive,24,0,24
1352030,0,8 user reviews,8,0,8
1352130,0,2 user reviews,2,0,2
1352581,0,7 user reviews,5,2,7
1352582,0,5 user reviews,5,0,5
1352583,0,9 user reviews,2,7,9
1352584,0,5 user reviews,5,0,5
1352590,0,1 user reviews,1,0,1
1352680,7,Positive,10,2,12
1352930,7,Positive,16,1,17
1352940,0,1 user reviews,1,0,1
1353050,0,1 user reviews,1,0,1
1353060,8,Very Positive,217,9,226
1353070,0,1 user reviews,1,0,1
1353080,7,Positive,12,2,14
1353120,7,Positive,14,0,14
1353130,0,1 user reviews,0,1,1
1353170,7,Positive,16,1,17
1353180,0,2 user reviews,1,1,2
1353300,5,Mixed,18,8,26
1353420,8,Very Positive,62,9,71
1353470,0,1 user reviews,1,0,1
1353520,7,Positive,29,0,29
1353521,8,Very Positive,46,4,50
1353550,0,2 user reviews,2,0,2
1353560,0,2 user reviews,2,0,2
1353690,0,1 user reviews,1,0,1
1353710,0,1 user reviews,1,0,1
1353770,0,1 user reviews,1,0,1
1353870,0,1 user reviews,0,1,1
1353880,0,1 user reviews,0,1,1
1353900,0,9 user reviews,7,2,9
1353980,0,3 user reviews,3,0,3
1353990,0,1 user reviews,1,0,1
1354000,0,1 user reviews,0,1,1
1354010,0,4 user reviews,4,0,4
1354080,0,2 user reviews,1,1,2
1354100,0,6 user reviews,6,0,6
1354110,0,1 user reviews,0,1,1
1354120,0,1 user reviews,1,0,1
1354250,0,1 user reviews,1,0,1
1354410,0,1 user reviews,0,1,1
1354510,0,2 user reviews,2,0,2
1354520,0,5 user reviews,3,2,5
1354580,0,1 user reviews,1,0,1
1354600,0,1 user reviews,1,0,1
1354750,0,2 user reviews,2,0,2
1354760,7,Positive,21,4,25
1354790,0,1 user reviews,1,0,1
1354816,0,1 user reviews,1,0,1
1354819,0,1 user reviews,1,0,1
1354960,6,Mostly Positive,19,7,26
1355010,0,2 user reviews,1,1,2
1355140,7,Positive,8,2,10
1355151,0,2 user reviews,2,0,2
1355300,0,2 user reviews,1,1,2
1355310,0,6 user reviews,6,0,6
1355370,0,7 user reviews,6,1,7
1355410,0,1 user reviews,1,0,1
1355420,0,3 user reviews,3,0,3
1355450,0,2 user reviews,1,1,2
1355510,0,4 user reviews,3,1,4
1355570,0,8 user reviews,8,0,8
1355610,0,1 user reviews,1,0,1
1355620,0,3 user reviews,3,0,3
1355630,0,1 user reviews,1,0,1
1355810,0,1 user reviews,1,0,1
1355910,0,1 user reviews,0,1,1
1355980,0,9 user reviews,9,0,9
1356180,6,Mostly Positive,25,7,32
1356190,5,Mixed,6,6,12
1356220,7,Positive,17,3,20
1356221,6,Mostly Positive,24,7,31
1356240,0,8 user reviews,3,5,8
1356360,0,1 user reviews,0,1,1
1356380,0,2 user reviews,1,1,2
1356410,0,3 user reviews,3,0,3
1356411,0,5 user reviews,5,0,5
1356440,4,Mostly Negative,6,10,16
1356480,7,Positive,31,1,32
1356530,0,5 user reviews,5,0,5
1356610,0,1 user reviews,1,0,1
1356710,0,5 user reviews,5,0,5
1356730,0,1 user reviews,1,0,1
1356731,0,1 user reviews,1,0,1
1356732,0,2 user reviews,2,0,2
1356733,0,1 user reviews,1,0,1
1356760,0,4 user reviews,4,0,4
1356890,0,1 user reviews,0,1,1
1356920,0,1 user reviews,1,0,1
1356930,0,2 user reviews,1,1,2
1357070,5,Mixed,6,6,12
1357190,0,1 user reviews,0,1,1
1357200,0,1 user reviews,1,0,1
1357270,0,1 user reviews,0,1,1
1357280,0,1 user reviews,1,0,1
1357330,0,6 user reviews,2,4,6
1357410,0,4 user reviews,4,0,4
1357490,0,1 user reviews,1,0,1
1357610,7,Positive,40,7,47
1357670,8,Very Positive,57,13,70
1357690,0,1 user reviews,1,0,1
1357740,0,2 user reviews,1,1,2
1357750,0,5 user reviews,5,0,5
1357830,7,Positive,15,0,15
1357840,0,4 user reviews,4,0,4
1357870,0,3 user reviews,3,0,3
1357900,0,1 user reviews,1,0,1
1357910,0,2 user reviews,2,0,2
1357930,0,4 user reviews,4,0,4
1357940,4,Mostly Negative,5,9,14
1358030,7,Positive,15,0,15
1358070,0,1 user reviews,1,0,1
1358090,7,Positive,47,0,47
1358250,8,Very Positive,289,11,300
1358270,0,8 user reviews,3,5,8
1358430,0,1 user reviews,1,0,1
1358540,0,1 user reviews,1,0,1
1358570,0,3 user reviews,3,0,3
1358640,0,2 user reviews,2,0,2
1358650,0,2 user reviews,1,1,2
1358990,0,1 user reviews,1,0,1
1359090,6,Mostly Positive,601,210,811
1359120,7,Positive,17,2,19
1359160,0,1 user reviews,0,1,1
1359170,0,2 user reviews,2,0,2
1359280,0,3 user reviews,1,2,3
1359310,7,Positive,11,0,11
1359340,0,1 user reviews,1,0,1
1359470,0,3 user reviews,1,2,3
1359520,5,Mixed,17,15,32
1359590,0,3 user reviews,3,0,3
1359610,0,1 user reviews,0,1,1
1359650,8,Very Positive,171,33,204
1359660,0,2 user reviews,2,0,2
1359760,0,7 user reviews,7,0,7
1359820,0,3 user reviews,2,1,3
1359840,0,1 user reviews,0,1,1
1359850,0,1 user reviews,1,0,1
1359870,0,7 user reviews,1,6,7
1359910,0,1 user reviews,0,1,1
1360000,8,Very Positive,338,42,380
1360080,0,4 user reviews,4,0,4
1360260,0,1 user reviews,1,0,1
1360290,0,2 user reviews,2,0,2
1360360,0,1 user reviews,0,1,1
1360510,0,2 user reviews,2,0,2
1360530,0,6 user reviews,4,2,6
1360560,0,1 user reviews,0,1,1
1360670,0,4 user reviews,3,1,4
1360870,0,1 user reviews,1,0,1
1360980,8,Very Positive,125,22,147
1361000,8,Very Positive,516,87,603
1361020,0,4 user reviews,4,0,4
1361110,8,Very Positive,75,5,80
1361120,0,3 user reviews,3,0,3
1361150,0,1 user reviews,1,0,1
1361180,0,1 user reviews,1,0,1
1361190,0,3 user reviews,3,0,3
1361260,0,2 user reviews,2,0,2
1361280,8,Very Positive,120,18,138
1361390,0,2 user reviews,2,0,2
1361430,0,1 user reviews,1,0,1
1361440,0,1 user reviews,1,0,1
1361470,0,1 user reviews,1,0,1
1361520,0,6 user reviews,6,0,6
1361540,0,1 user reviews,1,0,1
1361560,0,1 user reviews,0,1,1
1361591,0,1 user reviews,0,1,1
1361700,8,Very Positive,458,19,477
1361740,0,2 user reviews,2,0,2
1361760,0,7 user reviews,6,1,7
1361860,7,Positive,14,3,17
1361920,7,Positive,17,2,19
1361950,0,1 user reviews,1,0,1
1362116,0,1 user reviews,0,1,1
1362117,0,1 user reviews,1,0,1
1362118,0,1 user reviews,1,0,1
1362130,0,4 user reviews,3,1,4
1362150,0,1 user reviews,0,1,1
1362162,0,1 user reviews,0,1,1
1362180,0,1 user reviews,1,0,1
1362190,0,1 user reviews,1,0,1
1362270,0,1 user reviews,1,0,1
1362330,0,4 user reviews,4,0,4
1362430,5,Mixed,10,6,16
1362450,0,1 user reviews,0,1,1
1362460,0,3 user reviews,2,1,3
1362600,0,1 user reviews,1,0,1
1362601,0,1 user reviews,1,0,1
1362660,8,Very Positive,247,58,305
1362670,0,1 user reviews,1,0,1
1362700,0,2 user reviews,0,2,2
1362720,0,1 user reviews,1,0,1
1362750,0,1 user reviews,1,0,1
1362860,0,2 user reviews,2,0,2
1362980,0,1 user reviews,0,1,1
1362990,0,3 user reviews,0,3,3
1363020,0,1 user reviews,1,0,1
1363090,0,1 user reviews,1,0,1
1363140,0,8 user reviews,7,1,8
1363170,0,1 user reviews,1,0,1
1363200,0,2 user reviews,2,0,2
1363250,0,1 user reviews,0,1,1
1363290,0,4 user reviews,0,4,4
1363390,0,1 user reviews,0,1,1
1363450,0,3 user reviews,1,2,3
1363560,0,4 user reviews,4,0,4
1363600,0,7 user reviews,7,0,7
1363660,0,6 user reviews,3,3,6
1363690,0,3 user reviews,2,1,3
1363770,6,Mostly Positive,34,10,44
1363850,7,Positive,12,0,12
1363880,0,1 user reviews,1,0,1
1363980,0,4 user reviews,4,0,4
1364000,0,2 user reviews,2,0,2
1364010,0,9 user reviews,8,1,9
1364030,0,1 user reviews,1,0,1
1364032,0,1 user reviews,1,0,1
1364033,4,Mostly Negative,15,41,56
1364034,7,Positive,11,2,13
1364035,0,1 user reviews,1,0,1
1364110,0,3 user reviews,1,2,3
1364111,0,4 user reviews,3,1,4
1364130,7,Positive,14,3,17
1364140,5,Mixed,34,35,69
1364190,0,1 user reviews,1,0,1
1364330,0,1 user reviews,1,0,1
1364400,0,1 user reviews,1,0,1
1364430,0,1 user reviews,1,0,1
1364470,0,2 user reviews,2,0,2
1364730,7,Positive,17,0,17
1364840,0,5 user reviews,2,3,5
1364950,0,7 user reviews,6,1,7
1364971,0,3 user reviews,2,1,3
1364980,0,9 user reviews,8,1,9
1365010,7,Positive,19,0,19
1365020,0,1 user reviews,1,0,1
1365030,7,Positive,21,0,21
1365060,0,1 user reviews,1,0,1
1365390,0,3 user reviews,2,1,3
1365420,0,2 user reviews,1,1,2
1365490,0,5 user reviews,5,0,5
1365550,0,2 user reviews,2,0,2
1365560,0,5 user reviews,2,3,5
1365620,0,4 user reviews,2,2,4
1365630,0,2 user reviews,2,0,2
1365660,0,1 user reviews,0,1,1
1365700,0,1 user reviews,0,1,1
1365930,7,Positive,25,0,25
1365950,0,1 user reviews,1,0,1
1366090,0,5 user reviews,5,0,5
1366091,8,Very Positive,116,5,121
1366150,0,7 user reviews,7,0,7
1366360,7,Positive,12,0,12
1366420,0,4 user reviews,3,1,4
1366550,0,2 user reviews,1,1,2
1366570,0,2 user reviews,2,0,2
1366610,0,3 user reviews,3,0,3
1366700,0,1 user reviews,1,0,1
1366710,0,1 user reviews,1,0,1
1366750,0,1 user reviews,1,0,1
1366810,0,3 user reviews,3,0,3
1366900,5,Mixed,40,21,61
1367110,0,2 user reviews,2,0,2
1367130,0,1 user reviews,1,0,1
1367230,0,1 user reviews,1,0,1
1367250,0,3 user reviews,3,0,3
1367320,0,1 user reviews,1,0,1
1367340,0,1 user reviews,0,1,1
1367350,0,1 user reviews,1,0,1
1367430,0,4 user reviews,3,1,4
1367480,0,1 user reviews,1,0,1
1367520,0,6 user reviews,6,0,6
1367550,8,Very Positive,228,17,245
1367620,0,1 user reviews,0,1,1
1367690,6,Mostly Positive,39,10,49
1367750,0,8 user reviews,6,2,8
1367770,0,1 user reviews,1,0,1
1367930,0,1 user reviews,1,0,1
1367950,0,2 user reviews,0,2,2
1367970,0,2 user reviews,1,1,2
1368060,0,3 user reviews,1,2,3
1368110,0,1 user reviews,0,1,1
1368120,0,2 user reviews,2,0,2
1368210,7,Positive,18,1,19
1368560,0,1 user reviews,1,0,1
1368570,0,1 user reviews,1,0,1
1368630,0,1 user reviews,1,0,1
1368640,0,1 user reviews,1,0,1
1368740,0,2 user reviews,2,0,2
1368750,0,2 user reviews,2,0,2
1368770,0,5 user reviews,2,3,5
1368800,0,3 user reviews,1,2,3
1368801,0,1 user reviews,1,0,1
1368810,5,Mixed,8,5,13
1368820,8,Very Positive,67,13,80
1369340,8,Very Positive,65,2,67
1369370,8,Very Positive,102,23,125
1369453,0,1 user reviews,0,1,1
1369456,0,2 user reviews,0,2,2
1369560,0,2 user reviews,2,0,2
1369740,0,1 user reviews,1,0,1
1369950,0,2 user reviews,2,0,2
1370080,0,1 user reviews,0,1,1
1370230,0,1 user reviews,0,1,1
1370250,0,1 user reviews,1,0,1
1370260,0,1 user reviews,1,0,1
1370300,0,2 user reviews,2,0,2
1370390,0,9 user reviews,9,0,9
1370470,0,2 user reviews,0,2,2
1370550,0,2 user reviews,2,0,2
1370580,0,1 user reviews,0,1,1
1370610,0,2 user reviews,1,1,2
1370620,0,3 user reviews,3,0,3
1370630,0,4 user reviews,4,0,4
1370640,0,6 user reviews,6,0,6
1370650,0,2 user reviews,1,1,2
1370660,0,3 user reviews,2,1,3
1370720,0,4 user reviews,3,1,4
1370850,0,2 user reviews,2,0,2
1370950,0,5 user reviews,3,2,5
1371040,0,1 user reviews,1,0,1
1371090,0,2 user reviews,1,1,2
1371110,0,2 user reviews,2,0,2
1371160,0,1 user reviews,1,0,1
1371220,0,3 user reviews,2,1,3
1371340,0,5 user reviews,1,4,5
1371400,7,Positive,13,0,13
1371401,0,1 user reviews,1,0,1
1371402,0,2 user reviews,2,0,2
1371403,0,2 user reviews,2,0,2
1371404,7,Positive,10,0,10
1371407,0,5 user reviews,5,0,5
1371408,0,2 user reviews,2,0,2
1371409,0,1 user reviews,1,0,1
1371420,0,2 user reviews,1,1,2
1371421,0,1 user reviews,1,0,1
1371422,0,1 user reviews,1,0,1
1371423,0,1 user reviews,1,0,1
1371424,0,1 user reviews,1,0,1
1371425,0,2 user reviews,2,0,2
1371426,0,1 user reviews,1,0,1
1371427,0,2 user reviews,2,0,2
1371428,0,1 user reviews,1,0,1
1371429,0,1 user reviews,1,0,1
1371510,0,1 user reviews,0,1,1
1371540,0,1 user reviews,1,0,1
1371600,0,1 user reviews,0,1,1
1371710,0,2 user reviews,2,0,2
1371730,0,2 user reviews,1,1,2
1371770,0,6 user reviews,6,0,6
1371800,0,1 user reviews,1,0,1
1371910,0,1 user reviews,1,0,1
1371940,0,2 user reviews,2,0,2
1372010,0,2 user reviews,2,0,2
1372090,0,8 user reviews,3,5,8
1372180,0,3 user reviews,3,0,3
1372300,7,Positive,11,0,11
1372310,0,4 user reviews,3,1,4
1372320,8,Very Positive,251,3,254
1372380,0,1 user reviews,1,0,1
1372490,0,1 user reviews,1,0,1
1372550,0,6 user reviews,2,4,6
1372570,0,4 user reviews,4,0,4
1372630,0,2 user reviews,2,0,2
1372990,0,4 user reviews,3,1,4
1373080,0,2 user reviews,2,0,2
1373170,0,3 user reviews,3,0,3
1373180,0,2 user reviews,2,0,2
1373220,5,Mixed,39,17,56
1373340,0,1 user reviews,1,0,1
1373380,0,2 user reviews,2,0,2
1373430,6,Mostly Positive,31,8,39
1373440,0,5 user reviews,5,0,5
1373630,0,3 user reviews,3,0,3
1373700,0,2 user reviews,2,0,2
1373740,0,4 user reviews,2,2,4
1373760,0,1 user reviews,1,0,1
1373780,0,4 user reviews,3,1,4
1373810,0,1 user reviews,0,1,1
1373820,0,3 user reviews,3,0,3
1373870,0,7 user reviews,6,1,7
1374050,7,Positive,10,0,10
1374200,0,6 user reviews,6,0,6
1374290,7,Positive,23,1,24
1374340,6,Mostly Positive,7,3,10
1374470,0,5 user reviews,4,1,5
1374500,0,1 user reviews,1,0,1
1374630,0,1 user reviews,1,0,1
1374720,7,Positive,34,6,40
1374740,0,3 user reviews,0,3,3
1374820,0,4 user reviews,2,2,4
1374900,0,3 user reviews,3,0,3
1374940,0,2 user reviews,2,0,2
1375190,0,1 user reviews,0,1,1
1375250,0,2 user reviews,2,0,2
1375270,0,3 user reviews,3,0,3
1375360,5,Mixed,7,6,13
1375361,0,4 user reviews,2,2,4
1375362,0,6 user reviews,3,3,6
1375363,5,Mixed,5,7,12
1375364,0,6 user reviews,4,2,6
1375365,0,2 user reviews,2,0,2
1375366,0,4 user reviews,3,1,4
1375367,0,2 user reviews,2,0,2
1375368,0,5 user reviews,1,4,5
1375369,0,5 user reviews,2,3,5
1375370,0,8 user reviews,3,5,8
1375450,0,5 user reviews,5,0,5
1375510,0,1 user reviews,1,0,1
1375520,0,1 user reviews,0,1,1
1375560,0,3 user reviews,3,0,3
1375610,0,3 user reviews,3,0,3
1375650,0,4 user reviews,4,0,4
1375690,0,2 user reviews,2,0,2
1375810,0,1 user reviews,1,0,1
1375870,6,Mostly Positive,13,4,17
1375880,0,3 user reviews,3,0,3
1375920,0,1 user reviews,1,0,1
1375930,0,3 user reviews,2,1,3
1376010,0,2 user reviews,1,1,2
1376040,0,5 user reviews,3,2,5
1376060,0,2 user reviews,2,0,2
1376220,0,2 user reviews,2,0,2
1376270,0,1 user reviews,1,0,1
1376300,0,2 user reviews,2,0,2
1376350,0,1 user reviews,1,0,1
1376360,0,3 user reviews,2,1,3
1376470,0,2 user reviews,0,2,2
1376520,0,6 user reviews,6,0,6
1376570,0,1 user reviews,1,0,1
1376640,0,5 user reviews,5,0,5
1376690,0,2 user reviews,2,0,2
1376820,0,1 user reviews,1,0,1
1376830,0,7 user reviews,6,1,7
1376920,0,2 user reviews,0,2,2
1376940,0,3 user reviews,3,0,3
1377080,0,4 user reviews,4,0,4
1377100,0,2 user reviews,2,0,2
1377140,0,2 user reviews,0,2,2
1377240,0,3 user reviews,3,0,3
1377260,7,Positive,45,2,47
1377280,0,2 user reviews,1,1,2
1377330,0,3 user reviews,3,0,3
1377360,7,Positive,37,1,38
1377380,8,Very Positive,797,120,917
1377420,0,1 user reviews,1,0,1
1377530,0,7 user reviews,7,0,7
1377540,7,Positive,35,5,40
1377590,0,3 user reviews,2,1,3
1377650,0,6 user reviews,6,0,6
1377680,0,2 user reviews,2,0,2
1377690,0,2 user reviews,2,0,2
1377850,0,3 user reviews,2,1,3
1377900,0,3 user reviews,3,0,3
1377920,0,2 user reviews,2,0,2
1377930,0,3 user reviews,3,0,3
1377970,0,1 user reviews,1,0,1
1378120,0,1 user reviews,1,0,1
1378140,0,7 user reviews,6,1,7
1378170,0,8 user reviews,5,3,8
1378195,0,1 user reviews,1,0,1
1378250,0,1 user reviews,1,0,1
1378290,8,Very Positive,116,16,132
1378320,0,1 user reviews,0,1,1
1378330,0,6 user reviews,6,0,6
1378560,0,2 user reviews,2,0,2
1378650,0,5 user reviews,4,1,5
1378700,0,3 user reviews,1,2,3
1378760,0,1 user reviews,1,0,1
1378810,0,1 user reviews,0,1,1
1378820,0,1 user reviews,1,0,1
1378840,0,1 user reviews,1,0,1
1378850,0,1 user reviews,0,1,1
1378860,6,Mostly Positive,9,3,12
1378940,0,5 user reviews,5,0,5
1379020,8,Very Positive,166,9,175
1379110,7,Positive,15,3,18
1379150,0,1 user reviews,0,1,1
1379170,0,3 user reviews,3,0,3
1379200,7,Positive,9,2,11
1379222,0,1 user reviews,1,0,1
1379330,0,1 user reviews,1,0,1
1379370,0,2 user reviews,2,0,2
1379380,7,Positive,12,0,12
1379420,0,1 user reviews,1,0,1
1379450,0,1 user reviews,1,0,1
1379470,0,1 user reviews,1,0,1
1379570,0,1 user reviews,1,0,1
1379660,0,9 user reviews,9,0,9
1379930,5,Mixed,21,12,33
1379970,5,Mixed,10,8,18
1380010,7,Positive,22,1,23
1380030,0,1 user reviews,1,0,1
1380040,0,3 user reviews,3,0,3
1380110,0,1 user reviews,0,1,1
1380170,0,2 user reviews,2,0,2
1380250,0,1 user reviews,0,1,1
1380260,0,2 user reviews,2,0,2
1380360,0,2 user reviews,2,0,2
1380390,8,Very Positive,133,4,137
1380620,0,7 user reviews,2,5,7
1380820,0,1 user reviews,1,0,1
1380840,0,4 user reviews,4,0,4
1381070,0,8 user reviews,7,1,8
1381150,0,1 user reviews,0,1,1
1381280,0,1 user reviews,1,0,1
1381290,0,8 user reviews,7,1,8
1381480,0,3 user reviews,1,2,3
1381500,0,4 user reviews,4,0,4
1381610,0,2 user reviews,0,2,2
1381640,0,4 user reviews,4,0,4
1381690,0,1 user reviews,0,1,1
1381770,0,1 user reviews,1,0,1
1381790,0,1 user reviews,1,0,1
1381791,0,1 user reviews,1,0,1
1381800,0,1 user reviews,1,0,1
1381860,0,1 user reviews,1,0,1
1381880,0,5 user reviews,5,0,5
1381980,7,Positive,40,5,45
1382040,0,2 user reviews,0,2,2
1382140,7,Positive,10,0,10
1382180,0,1 user reviews,1,0,1
1382210,5,Mixed,11,5,16
1382220,6,Mostly Positive,10,3,13
1382241,5,Mixed,11,7,18
1382370,0,4 user reviews,4,0,4
1382530,0,7 user reviews,4,3,7
1382560,0,4 user reviews,4,0,4
1382700,0,1 user reviews,1,0,1
1382730,0,4 user reviews,4,0,4
1382840,0,7 user reviews,4,3,7
1382920,0,1 user reviews,0,1,1
1382940,0,9 user reviews,7,2,9
1383010,0,1 user reviews,1,0,1
1383030,0,6 user reviews,1,5,6
1383050,7,Positive,31,2,33
1383120,0,1 user reviews,0,1,1
1383170,0,1 user reviews,1,0,1
1383180,0,6 user reviews,6,0,6
1383230,0,4 user reviews,3,1,4
1383340,0,3 user reviews,2,1,3
1383410,0,2 user reviews,2,0,2
1383450,0,2 user reviews,1,1,2
1383630,7,Positive,18,1,19
1383720,7,Positive,19,0,19
1383740,0,6 user reviews,5,1,6
1383780,0,2 user reviews,0,2,2
1383830,0,1 user reviews,1,0,1
1383850,0,1 user reviews,1,0,1
1383880,7,Positive,11,0,11
1383900,0,1 user reviews,1,0,1
1383920,0,3 user reviews,3,0,3
1383990,0,6 user reviews,1,5,6
1384090,0,1 user reviews,1,0,1
1384380,0,1 user reviews,1,0,1
1384390,0,4 user reviews,2,2,4
1384440,0,1 user reviews,0,1,1
1384480,0,1 user reviews,1,0,1
1384500,0,1 user reviews,1,0,1
1384540,0,7 user reviews,4,3,7
1384630,5,Mixed,37,23,60
1384670,0,1 user reviews,1,0,1
1384700,7,Positive,9,2,11
1384770,8,Very Positive,275,34,309
1384780,0,7 user reviews,7,0,7
1384790,0,8 user reviews,4,4,8
1384960,7,Positive,13,1,14
1385050,0,1 user reviews,1,0,1
1385090,0,1 user reviews,0,1,1
1385110,4,Mostly Negative,6,10,16
1385480,0,1 user reviews,0,1,1
1385570,0,1 user reviews,1,0,1
1385670,0,3 user reviews,3,0,3
1385730,7,Positive,19,0,19
1385760,0,1 user reviews,0,1,1
1385780,0,4 user reviews,3,1,4
1385810,0,3 user reviews,3,0,3
1385850,0,3 user reviews,3,0,3
1385930,0,2 user reviews,0,2,2
1385960,0,5 user reviews,5,0,5
1385970,0,3 user reviews,2,1,3
1385990,0,1 user reviews,1,0,1
1386190,0,2 user reviews,2,0,2
1386200,0,5 user reviews,5,0,5
1386330,0,2 user reviews,1,1,2
1386440,7,Positive,15,2,17
1386540,0,3 user reviews,3,0,3
1386600,7,Positive,11,0,11
1386610,0,1 user reviews,1,0,1
1386611,0,2 user reviews,2,0,2
1386612,0,4 user reviews,4,0,4
1386700,0,1 user reviews,1,0,1
1386710,0,2 user reviews,2,0,2
1386730,7,Positive,29,1,30
1386810,0,1 user reviews,1,0,1
1386840,0,2 user reviews,1,1,2
1386910,0,2 user reviews,1,1,2
1386930,0,1 user reviews,1,0,1
1386980,5,Mixed,17,17,34
1386990,0,5 user reviews,4,1,5
1387010,0,5 user reviews,5,0,5
1387030,0,4 user reviews,4,0,4
1387060,0,4 user reviews,3,1,4
1387150,0,3 user reviews,2,1,3
1387170,0,5 user reviews,3,2,5
1387250,0,1 user reviews,1,0,1
1387290,5,Mixed,10,8,18
1387340,0,1 user reviews,1,0,1
1387560,0,1 user reviews,1,0,1
1387610,0,5 user reviews,4,1,5
1387620,0,1 user reviews,1,0,1
1387830,0,2 user reviews,0,2,2
1387850,0,1 user reviews,0,1,1
1387980,0,1 user reviews,1,0,1
1388030,0,2 user reviews,1,1,2
1388090,0,2 user reviews,2,0,2
1388130,0,1 user reviews,0,1,1
1388160,0,6 user reviews,6,0,6
1388230,0,4 user reviews,4,0,4
1388310,0,2 user reviews,2,0,2
1388370,5,Mixed,6,4,10
1388380,0,2 user reviews,0,2,2
1388390,0,1 user reviews,1,0,1
1388490,0,1 user reviews,0,1,1
1388730,0,1 user reviews,1,0,1
1388760,0,1 user reviews,1,0,1
1388860,0,2 user reviews,2,0,2
1389010,0,2 user reviews,2,0,2
1389070,0,4 user reviews,4,0,4
1389270,0,3 user reviews,3,0,3
1389290,0,1 user reviews,1,0,1
1389470,0,1 user reviews,0,1,1
1389560,7,Positive,14,0,14
1389610,7,Positive,11,0,11
1389680,6,Mostly Positive,13,5,18
1389700,0,5 user reviews,5,0,5
1389750,0,3 user reviews,3,0,3
1389890,7,Positive,19,0,19
1389911,0,1 user reviews,1,0,1
1390010,8,Very Positive,73,12,85
1390040,0,1 user reviews,1,0,1
1390110,0,6 user reviews,6,0,6
1390130,0,3 user reviews,3,0,3
1390131,0,1 user reviews,1,0,1
1390132,0,1 user reviews,1,0,1
1390211,0,3 user reviews,3,0,3
1390300,7,Positive,15,0,15
1390340,0,4 user reviews,1,3,4
1390490,7,Positive,11,1,12
1390710,0,1 user reviews,0,1,1
1390740,7,Positive,33,8,41
1390770,7,Positive,14,0,14
1390840,7,Positive,35,2,37
1391280,4,Mostly Negative,4,7,11
1391400,0,4 user reviews,2,2,4
1391450,0,7 user reviews,6,1,7
1391630,0,1 user reviews,1,0,1
1391790,0,3 user reviews,2,1,3
1391800,0,5 user reviews,3,2,5
1391960,0,2 user reviews,2,0,2
1392030,0,6 user reviews,4,2,6
1392080,0,1 user reviews,1,0,1
1392130,0,2 user reviews,2,0,2
1392170,6,Mostly Positive,7,3,10
1392190,0,2 user reviews,0,2,2
1392430,0,1 user reviews,0,1,1
1392490,0,3 user reviews,3,0,3
1392600,0,9 user reviews,8,1,9
1392700,5,Mixed,12,8,20
1392760,0,5 user reviews,3,2,5
1392790,0,1 user reviews,1,0,1
1392820,8,Very Positive,145,4,149
1393080,0,1 user reviews,1,0,1
1393110,0,5 user reviews,4,1,5
1393120,0,8 user reviews,8,0,8
1393220,0,1 user reviews,0,1,1
1393350,0,5 user reviews,5,0,5
1393410,7,Positive,16,4,20
1393480,0,2 user reviews,2,0,2
1393500,7,Positive,17,1,18
1393780,0,1 user reviews,1,0,1
1393790,0,1 user reviews,1,0,1
1393800,0,4 user reviews,2,2,4
1393820,7,Positive,18,0,18
1393850,0,1 user reviews,0,1,1
1393930,0,1 user reviews,0,1,1
1393970,0,1 user reviews,1,0,1
1394060,0,2 user reviews,0,2,2
1394140,0,4 user reviews,3,1,4
1394160,7,Positive,12,1,13
1394210,0,1 user reviews,0,1,1
1394410,0,1 user reviews,1,0,1
1394520,7,Positive,17,1,18
1394600,0,5 user reviews,5,0,5
1394680,0,1 user reviews,1,0,1
1394700,0,1 user reviews,1,0,1
1394800,5,Mixed,53,37,90
1394830,0,7 user reviews,7,0,7
1394880,0,2 user reviews,2,0,2
1394890,7,Positive,10,1,11
1394950,0,8 user reviews,5,3,8
1394980,0,1 user reviews,1,0,1
1395000,0,1 user reviews,0,1,1
1395080,0,1 user reviews,1,0,1
1395100,0,3 user reviews,3,0,3
1395170,0,3 user reviews,2,1,3
1395280,0,2 user reviews,1,1,2
1395420,0,2 user reviews,1,1,2
1395470,0,1 user reviews,1,0,1
1395540,7,Positive,19,1,20
1395560,7,Positive,27,4,31
1395590,0,1 user reviews,1,0,1
1395720,0,1 user reviews,1,0,1
1395730,0,8 user reviews,8,0,8
1395850,0,1 user reviews,1,0,1
1395950,0,3 user reviews,2,1,3
1396260,7,Positive,11,2,13
1396350,0,1 user reviews,1,0,1
1396380,0,2 user reviews,1,1,2
1396420,0,1 user reviews,0,1,1
1396570,0,1 user reviews,1,0,1
1396580,0,1 user reviews,0,1,1
1396610,0,1 user reviews,1,0,1
1396930,0,1 user reviews,0,1,1
1397030,8,Very Positive,83,2,85
1397050,0,1 user reviews,1,0,1
1397110,0,6 user reviews,6,0,6
1397170,5,Mixed,6,4,10
1397230,0,1 user reviews,1,0,1
1397240,0,9 user reviews,9,0,9
1397250,0,1 user reviews,1,0,1
1397280,0,4 user reviews,4,0,4
1397350,0,4 user reviews,4,0,4
1397470,0,6 user reviews,6,0,6
1397490,5,Mixed,9,5,14
1397540,0,4 user reviews,4,0,4
1397690,0,1 user reviews,0,1,1
1397720,0,2 user reviews,2,0,2
1397810,0,1 user reviews,1,0,1
1397960,0,1 user reviews,1,0,1
1398050,0,2 user reviews,2,0,2
1398120,0,1 user reviews,0,1,1
1398180,0,7 user reviews,6,1,7
1398270,0,5 user reviews,5,0,5
1398320,0,1 user reviews,0,1,1
1398390,0,1 user reviews,1,0,1
1398570,0,7 user reviews,6,1,7
1398750,0,1 user reviews,1,0,1
1398770,0,6 user reviews,6,0,6
1398790,0,2 user reviews,2,0,2
1398820,0,2 user reviews,2,0,2
1399020,0,1 user reviews,1,0,1
1399040,0,1 user reviews,1,0,1
1399140,0,9 user reviews,7,2,9
1399150,0,1 user reviews,1,0,1
1399300,0,2 user reviews,2,0,2
1399370,6,Mostly Positive,33,10,43
1399380,0,6 user reviews,6,0,6
1399400,0,1 user reviews,1,0,1
1399420,0,2 user reviews,2,0,2
1399460,0,1 user reviews,0,1,1
1399480,0,3 user reviews,2,1,3
1399490,0,1 user reviews,1,0,1
1399500,0,3 user reviews,3,0,3
1399590,0,4 user reviews,3,1,4
1399610,0,1 user reviews,1,0,1
1399660,7,Positive,24,0,24
1399790,0,2 user reviews,2,0,2
1399850,0,3 user reviews,3,0,3
1399910,0,2 user reviews,2,0,2
1399960,7,Positive,14,2,16
1400051,0,1 user reviews,0,1,1
1400100,0,2 user reviews,0,2,2
1400150,0,3 user reviews,2,1,3
1400180,0,6 user reviews,4,2,6
1400190,0,4 user reviews,4,0,4
1400200,0,3 user reviews,2,1,3
1400210,0,4 user reviews,4,0,4
1400260,0,7 user reviews,7,0,7
1400300,0,7 user reviews,6,1,7
1400301,7,Positive,10,0,10
1400302,0,5 user reviews,5,0,5
1400360,0,1 user reviews,0,1,1
1400510,0,1 user reviews,1,0,1
1400590,0,1 user reviews,1,0,1
1400650,0,1 user reviews,0,1,1
1400680,0,1 user reviews,1,0,1
1400720,0,2 user reviews,2,0,2
1400900,0,4 user reviews,3,1,4
1400920,0,1 user reviews,1,0,1
1401150,6,Mostly Positive,7,3,10
1401360,0,1 user reviews,1,0,1
1401450,0,8 user reviews,8,0,8
1401451,0,6 user reviews,5,1,6
1401452,7,Positive,12,1,13
1401490,5,Mixed,13,12,25
1401670,0,1 user reviews,1,0,1
1401840,6,Mostly Positive,9,3,12
1401860,8,Very Positive,82,5,87
1401880,0,5 user reviews,5,0,5
1402090,7,Positive,9,2,11
1402170,0,1 user reviews,1,0,1
1402380,0,1 user reviews,1,0,1
1402410,0,8 user reviews,6,2,8
1402630,0,4 user reviews,4,0,4
1402640,0,2 user reviews,2,0,2
1402790,0,1 user reviews,1,0,1
1402920,0,7 user reviews,3,4,7
1402930,0,3 user reviews,2,1,3
1403010,0,1 user reviews,1,0,1
1403090,0,3 user reviews,3,0,3
1403110,0,3 user reviews,3,0,3
1403130,0,1 user reviews,1,0,1
1403190,7,Positive,17,1,18
1403350,0,3 user reviews,3,0,3
1403540,0,1 user reviews,0,1,1
1403630,0,1 user reviews,1,0,1
1403680,0,1 user reviews,0,1,1
1403830,0,8 user reviews,8,0,8
1403840,0,1 user reviews,1,0,1
1403890,0,5 user reviews,5,0,5
1404050,0,4 user reviews,4,0,4
1404070,0,2 user reviews,2,0,2
1404090,0,7 user reviews,7,0,7
1404130,0,9 user reviews,9,0,9
1404150,0,9 user reviews,9,0,9
1404190,7,Positive,10,0,10
1404360,7,Positive,15,0,15
1404530,7,Positive,17,0,17
1404550,0,1 user reviews,0,1,1
1404950,0,8 user reviews,8,0,8
1404970,0,2 user reviews,2,0,2
1404980,7,Positive,13,0,13
1405170,0,1 user reviews,1,0,1
1405220,0,2 user reviews,2,0,2
1405240,0,2 user reviews,0,2,2
1405241,7,Positive,8,2,10
1405440,7,Positive,15,0,15
1405610,0,1 user reviews,1,0,1
1405650,0,3 user reviews,3,0,3
1405660,7,Positive,8,2,10
1405875,0,1 user reviews,1,0,1
1405960,0,1 user reviews,1,0,1
1405980,0,1 user reviews,0,1,1
1405990,0,1 user reviews,1,0,1
1406010,0,2 user reviews,2,0,2
1406110,0,1 user reviews,1,0,1
1406140,0,8 user reviews,8,0,8
1406270,0,6 user reviews,6,0,6
1406350,0,2 user reviews,2,0,2
1406610,0,4 user reviews,1,3,4
1406690,0,7 user reviews,7,0,7
1406840,0,1 user reviews,1,0,1
1406900,0,1 user reviews,1,0,1
1407060,0,5 user reviews,4,1,5
1407240,0,1 user reviews,1,0,1
1407290,0,1 user reviews,1,0,1
1407530,0,1 user reviews,0,1,1
1407870,0,1 user reviews,1,0,1
1408000,0,1 user reviews,0,1,1
1408020,6,Mostly Positive,118,38,156
1408060,0,8 user reviews,8,0,8
1408200,0,2 user reviews,0,2,2
1408260,0,8 user reviews,8,0,8
1408350,0,1 user reviews,1,0,1
1408410,0,2 user reviews,2,0,2
1408630,0,3 user reviews,2,1,3
1408640,0,1 user reviews,1,0,1
1408700,0,1 user reviews,1,0,1
1408950,0,4 user reviews,4,0,4
1408960,0,1 user reviews,1,0,1
1409000,7,Positive,8,2,10
1409140,7,Positive,21,3,24
1409141,7,Positive,16,0,16
1409142,7,Positive,36,2,38
1409143,7,Positive,32,7,39
1409250,0,1 user reviews,1,0,1
1409310,0,1 user reviews,1,0,1
1409320,0,1 user reviews,1,0,1
1409330,0,1 user reviews,1,0,1
1409640,0,4 user reviews,4,0,4
1409680,0,2 user reviews,2,0,2
1409721,0,1 user reviews,1,0,1
1409730,7,Positive,15,3,18
1409740,7,Positive,12,3,15
1409930,0,1 user reviews,0,1,1
1410080,0,3 user reviews,2,1,3
1410210,0,1 user reviews,0,1,1
1410380,0,1 user reviews,1,0,1
1410500,0,1 user reviews,1,0,1
1410580,0,3 user reviews,2,1,3
1410710,8,Very Positive,218,50,268
1410790,0,1 user reviews,1,0,1
1411080,0,1 user reviews,1,0,1
1411170,0,2 user reviews,1,1,2
1411410,0,1 user reviews,1,0,1
1411420,0,2 user reviews,2,0,2
1411490,0,1 user reviews,0,1,1
1411840,0,1 user reviews,1,0,1
1411860,0,3 user reviews,2,1,3
1411880,0,1 user reviews,0,1,1
1412000,0,4 user reviews,1,3,4
1412040,0,5 user reviews,4,1,5
1412300,0,1 user reviews,1,0,1
1412450,0,2 user reviews,2,0,2
1412520,0,4 user reviews,4,0,4
1412530,0,9 user reviews,7,2,9
1412610,0,2 user reviews,2,0,2
1412630,0,2 user reviews,2,0,2
1412660,0,9 user reviews,9,0,9
1412690,0,1 user reviews,1,0,1
1412780,6,Mostly Positive,60,16,76
1412900,0,1 user reviews,1,0,1
1412980,0,4 user reviews,4,0,4
1413010,0,7 user reviews,5,2,7
1413020,7,Positive,20,2,22
1413070,0,9 user reviews,6,3,9
1413170,0,1 user reviews,1,0,1
1413210,0,3 user reviews,3,0,3
1413230,0,1 user reviews,1,0,1
1413240,0,2 user reviews,2,0,2
1413300,0,2 user reviews,2,0,2
1413350,0,1 user reviews,1,0,1
1413450,7,Positive,19,3,22
1413500,0,1 user reviews,1,0,1
1413520,0,1 user reviews,1,0,1
1413560,0,1 user reviews,1,0,1
1413630,0,2 user reviews,2,0,2
1413790,0,6 user reviews,5,1,6
1413800,0,1 user reviews,1,0,1
1413890,0,1 user reviews,0,1,1
1414050,5,Mixed,6,5,11
1414060,0,1 user reviews,1,0,1
1414480,0,1 user reviews,1,0,1
1414500,0,1 user reviews,0,1,1
1414680,0,1 user reviews,1,0,1
1414690,0,1 user reviews,1,0,1
1414720,0,4 user reviews,4,0,4
1414820,0,2 user reviews,1,1,2
1414840,0,3 user reviews,3,0,3
1414990,0,4 user reviews,4,0,4
1415110,0,1 user reviews,1,0,1
1415140,0,7 user reviews,6,1,7
1415250,0,7 user reviews,7,0,7
1415370,0,3 user reviews,2,1,3
1415420,0,3 user reviews,3,0,3
1415480,0,2 user reviews,1,1,2
1415510,7,Positive,10,0,10
1415530,0,3 user reviews,0,3,3
1415630,0,2 user reviews,2,0,2
1415691,7,Positive,45,4,49
1415700,7,Positive,16,0,16
1415750,0,4 user reviews,4,0,4
1415830,0,2 user reviews,1,1,2
1416000,0,6 user reviews,6,0,6
1416090,0,1 user reviews,1,0,1
1416210,0,1 user reviews,1,0,1
1416230,7,Positive,14,1,15
1416430,0,1 user reviews,1,0,1
1416450,0,3 user reviews,2,1,3
1416690,0,3 user reviews,3,0,3
1416710,0,1 user reviews,0,1,1
1416850,0,1 user reviews,1,0,1
1417230,0,1 user reviews,1,0,1
1417250,0,1 user reviews,0,1,1
1417260,7,Positive,23,0,23
1417270,0,1 user reviews,1,0,1
1417340,0,1 user reviews,1,0,1
1417420,0,4 user reviews,3,1,4
1417500,6,Mostly Positive,12,4,16
1417540,0,8 user reviews,8,0,8
1417580,0,1 user reviews,1,0,1
1417600,7,Positive,16,4,20
1417610,0,4 user reviews,3,1,4
1417640,0,1 user reviews,1,0,1
1417670,0,7 user reviews,6,1,7
1417680,0,1 user reviews,0,1,1
1417720,7,Positive,16,0,16
1417770,0,1 user reviews,1,0,1
1418010,0,4 user reviews,4,0,4
1418090,0,4 user reviews,4,0,4
1418170,0,4 user reviews,2,2,4
1418300,0,1 user reviews,1,0,1
1418310,7,Positive,10,1,11
1418330,0,1 user reviews,1,0,1
1418400,0,1 user reviews,1,0,1
1418460,0,4 user reviews,4,0,4
1418490,0,1 user reviews,1,0,1
1418570,7,Positive,10,0,10
1418680,0,3 user reviews,3,0,3
1418720,7,Positive,16,1,17
1418860,0,2 user reviews,2,0,2
1418980,7,Positive,16,0,16
1419110,0,1 user reviews,1,0,1
1419190,0,3 user reviews,2,1,3
1419200,0,1 user reviews,0,1,1
1419370,0,1 user reviews,1,0,1
1419480,0,3 user reviews,3,0,3
1419730,7,Positive,23,3,26
1419900,0,1 user reviews,0,1,1
1420330,0,2 user reviews,2,0,2
1420390,0,1 user reviews,1,0,1
1420690,0,1 user reviews,1,0,1
1420740,7,Positive,21,4,25
1420830,7,Positive,32,1,33
1420890,0,1 user reviews,0,1,1
1420950,0,4 user reviews,4,0,4
1420960,0,1 user reviews,1,0,1
1421020,0,3 user reviews,3,0,3
1421120,0,1 user reviews,1,0,1
1421310,0,1 user reviews,0,1,1
1421320,0,1 user reviews,1,0,1
1421480,0,7 user reviews,7,0,7
1421580,0,1 user reviews,1,0,1
1422080,0,2 user reviews,1,1,2
1422090,0,4 user reviews,4,0,4
1422200,0,4 user reviews,4,0,4
1422210,7,Positive,12,0,12
1422240,0,3 user reviews,3,0,3
1422680,0,1 user reviews,1,0,1
1422740,0,1 user reviews,1,0,1
1422750,7,Positive,16,3,19
1422810,0,2 user reviews,1,1,2
1423200,0,2 user reviews,1,1,2
1423360,0,1 user reviews,1,0,1
1423440,0,1 user reviews,1,0,1
1423500,0,1 user reviews,0,1,1
1423540,0,1 user reviews,1,0,1
1423610,0,1 user reviews,0,1,1
1423680,0,1 user reviews,1,0,1
1423780,0,1 user reviews,1,0,1
1423830,0,1 user reviews,1,0,1
1423900,0,8 user reviews,7,1,8
1424020,0,1 user reviews,1,0,1
1424120,0,1 user reviews,1,0,1
1424270,0,2 user reviews,2,0,2
1424310,0,1 user reviews,0,1,1
1424350,0,9 user reviews,9,0,9
1424380,0,2 user reviews,2,0,2
1424500,0,3 user reviews,3,0,3
1424630,0,5 user reviews,5,0,5
1424700,0,1 user reviews,0,1,1
1424770,0,9 user reviews,7,2,9
1424830,0,1 user reviews,1,0,1
1424980,8,Very Positive,261,23,284
1425110,0,2 user reviews,1,1,2
1425120,0,2 user reviews,2,0,2
1425140,0,4 user reviews,4,0,4
1425250,0,1 user reviews,1,0,1
1425280,0,5 user reviews,5,0,5
1425290,0,1 user reviews,1,0,1
1425300,0,3 user reviews,1,2,3
1425380,7,Positive,21,0,21
1425390,0,1 user reviews,1,0,1
1425430,0,4 user reviews,3,1,4
1425450,0,2 user reviews,2,0,2
1425720,0,1 user reviews,0,1,1
1426090,0,7 user reviews,5,2,7
1426160,0,2 user reviews,2,0,2
1426190,0,1 user reviews,1,0,1
1426240,6,Mostly Positive,98,41,139
1426280,6,Mostly Positive,7,3,10
1426880,0,2 user reviews,0,2,2
1426910,5,Mixed,186,117,303
1427290,0,2 user reviews,1,1,2
1427750,0,2 user reviews,2,0,2
1428110,0,5 user reviews,1,4,5
1428160,0,1 user reviews,0,1,1
1428220,0,4 user reviews,4,0,4
1428310,8,Very Positive,239,8,247
1428330,0,1 user reviews,1,0,1
1428460,7,Positive,32,0,32
1428580,0,2 user reviews,1,1,2
1428820,7,Positive,39,5,44
1428840,0,4 user reviews,4,0,4
1428980,0,4 user reviews,4,0,4
1429010,0,1 user reviews,1,0,1
1429270,0,1 user reviews,1,0,1
1429300,0,1 user reviews,0,1,1
1429400,0,1 user reviews,1,0,1
1429480,7,Positive,10,0,10
1430040,0,1 user reviews,1,0,1
1430070,0,3 user reviews,1,2,3
1430120,0,2 user reviews,2,0,2
1430140,0,1 user reviews,1,0,1
1430200,0,1 user reviews,1,0,1
1430420,8,Very Positive,94,1,95
1430610,8,Very Positive,66,0,66
1430740,0,3 user reviews,1,2,3
1430820,0,1 user reviews,1,0,1
1430940,7,Positive,14,1,15
1430980,0,2 user reviews,0,2,2
1430990,7,Positive,12,0,12
1431030,7,Positive,14,2,16
1431190,7,Positive,10,0,10
1431210,0,1 user reviews,1,0,1
1431220,0,5 user reviews,5,0,5
1431420,0,6 user reviews,6,0,6
1431620,0,1 user reviews,0,1,1
1431702,0,1 user reviews,1,0,1
1431710,0,1 user reviews,1,0,1
1431780,0,9 user reviews,9,0,9
1431840,0,1 user reviews,1,0,1
1432270,7,Positive,28,2,30
1432400,0,2 user reviews,2,0,2
1432470,0,7 user reviews,7,0,7
1432650,0,7 user reviews,7,0,7
1432750,7,Positive,10,0,10
1432940,0,1 user reviews,0,1,1
1433320,0,5 user reviews,5,0,5
1433430,0,7 user reviews,7,0,7
1433890,7,Positive,13,0,13
1433930,0,1 user reviews,1,0,1
1433950,0,2 user reviews,2,0,2
1434620,0,1 user reviews,0,1,1
1434720,0,3 user reviews,2,1,3
1434880,0,2 user reviews,2,0,2
1435420,0,1 user reviews,0,1,1
1435480,0,6 user reviews,3,3,6
1435510,0,1 user reviews,1,0,1
1435650,0,3 user reviews,3,0,3
1435660,0,2 user reviews,2,0,2
1435680,0,2 user reviews,2,0,2
1435690,0,3 user reviews,2,1,3
1436190,0,3 user reviews,3,0,3
1436490,0,7 user reviews,7,0,7
1436570,0,2 user reviews,1,1,2
1436710,0,1 user reviews,1,0,1
1436850,0,2 user reviews,2,0,2
1436930,0,1 user reviews,1,0,1
1437170,0,3 user reviews,2,1,3
1437410,0,4 user reviews,4,0,4
1437420,0,7 user reviews,7,0,7
1437480,0,1 user reviews,1,0,1
1437500,8,Very Positive,53,2,55
1437650,0,1 user reviews,1,0,1
1437700,0,1 user reviews,1,0,1
1437810,0,1 user reviews,1,0,1
1438000,0,1 user reviews,0,1,1
1438020,0,6 user reviews,6,0,6
1438050,0,2 user reviews,2,0,2
1438260,6,Mostly Positive,12,4,16
1438980,0,4 user reviews,4,0,4
1439000,0,3 user reviews,2,1,3
1439060,0,2 user reviews,2,0,2
1439090,0,1 user reviews,0,1,1
1439430,7,Positive,10,0,10
1440130,0,9 user reviews,8,1,9
1440280,0,1 user reviews,1,0,1
1440780,0,2 user reviews,2,0,2
1440870,6,Mostly Positive,9,3,12
1441180,0,8 user reviews,7,1,8
1441590,0,1 user reviews,1,0,1
1442390,0,2 user reviews,1,1,2
1442810,0,1 user reviews,1,0,1
1443160,0,2 user reviews,2,0,2
1443260,0,4 user reviews,4,0,4
1443360,0,5 user reviews,3,2,5
1443430,8,Very Positive,76,3,79
1443640,0,1 user reviews,1,0,1
1443770,0,1 user reviews,1,0,1
1443900,0,1 user reviews,0,1,1
1443970,0,2 user reviews,1,1,2
1444090,7,Positive,27,0,27
1444140,0,1 user reviews,0,1,1
1444320,7,Positive,16,0,16
1444730,0,4 user reviews,4,0,4
1444890,0,5 user reviews,5,0,5
1444950,0,1 user reviews,0,1,1
1445120,0,3 user reviews,2,1,3
1445180,0,2 user reviews,2,0,2
1445400,0,3 user reviews,3,0,3
1445800,0,7 user reviews,7,0,7
1446000,0,1 user reviews,1,0,1
1446490,0,1 user reviews,1,0,1
1447060,0,2 user reviews,2,0,2
1447070,0,1 user reviews,1,0,1
1448680,0,1 user reviews,1,0,1
1450220,5,Mixed,11,6,17
1450700,0,3 user reviews,3,0,3
1452150,0,3 user reviews,3,0,3
1454920,0,3 user reviews,3,0,3
2028850,5,Mixed,19,10,29
